TGTCCAGATT	GAAACACAGGTGGCAATTCGATCTGAGTGGGGTTAGAGCTAGAAATAGCA	2
CCGTTAACAC	GAAACACCGGTTGGCTTTACTCCTTTGTGGGGTTAGAGCTATAAATAGCA	2
CATTCACAAA	GAAACACCGGTGGCAATTCGATCTGAGTGGGGTTAGAGCTAGAAATAGCA	2
GACAACCTCC	GAAACACCGGTAATCTAAAGATCCCCGTGGGGATAGAGCTAGAAATAGCA	2
GTAATATATA	GAAACACCGGTGAGCATGATAACGTAGCAATATAACTCAAAGCTTAACCG	1
TAATTAATCA	GAAACACCGGTTGGGTTAATAACAAAGGGTGGAACTGGTAAAAGCAGCTT	1
CGTTCATCAA	GAAACACCGGTGCTAGCGGGTTCGAGCTAGTGGGGTTAGAGCTAGAAATA	1
AAACCCATGA	GAAACACCGGTTTAGTATGGAGGGAAGTGGGGTTGGAGCCAGAAATAGCA	1
GACTGCGTAA	GAAACACCGGTTCTAGATACTTAGGGGAGGGGATAGAGCTCGATAAACAA	1
GACTATGTAA	GAAACACCGGTACTAGTTACTTCCGGGGGGGGTTAGAGTAAGAAATGGCA	1
AACTGGGCGA	GAAACACCGGTTGGAGAGAACAAGGTGCGGGAGAAATAGCCAGTTAACCT	1
CTGACCGTAG	GAAACACCGGTCCTAGTAGCTGCGTTGTGGGGTTAGAGCTAGAAATAGCA	1
TTGCCAGAGT	GAAACACCGGTCTGGCTAGAATTAAAGATGGCAAGATCAAGTAAGGCTAG	1
GAATCAGCCG	GAAACACCGGTCTTAGAAATTGGCCGGGTTGGAGATAGCTATAAATAGTA	1
GGCACTTCCC	GAAACACCGGTTGCCTTTAGCTCGTAGTGGGGTTAGAGCTAGAAATAGCA	1
AACTATGTAA	GAACCACCGGTGCTAGTTGCTTGAGGGTGGGGTTAGAGATAGAAATAGCA	1
CCTTCACAAC	GAAACACCGGTTGCCTTTAGTCCTTTGTGGGGTTAGAGCTAGAAATAGCA	1
GAATTAACCC	GAAACACCGGTTTTAATAATTAGCGCGTGGGGTTAGAGCTAGAAATAGCA	1
GAATCAGCCG	GAAACACCGGTTTTAGTGAATGGTGAGTGGGGGTAGAGCTAGAAATAGCA	1
TAAAACTAAG	GAAACACCGGTGGCATTAATTCACTTGTGGGGTTAGAGCTAGAAATAGCA	1
TAAGCCCAAT	GAAACACCGGTACTCGTAGCTAACTGGTGGGGTTAGAGCTAGAAATAGCA	1
CCCCGTTGCT	GAAACACCGGTAGAATGGATCTCCGGGTGGGGTTAGAGCTAGAAATAGCA	1
AAATCAGCCG	GAAACACCGGTTGTGGGAGATGGGGTGTGGGGTTAGTGCCAGAAATAGCA	1
CGCCGGGCTG	GAAACACCGGTGGGCGTTCGTGTGGATAGAGCTAGAAATAGCAAGTTAAC	1
GTGGGCGAGA	GAAACACCGGTGAGATGCGTCAAGTGCTTGAGATAGAACGTTAACTTGAG	1
GACTACCAAA	GAAACACCGGTGGCAATCCGATATGAGTGGGGTTAGAGCTAGAAATAGCA	1
TCATCGCACC	GAAACACCGGTGCCCTTGGCGCCAGTTGGGGGGTATTAGCAAAAAGAACC	1
CAACCCATGA	GAAACACCGGTTTAGTATGGACGGAAGAGGGCATGGTGCTCGAAATCGCA	1
GCAGCAACAA	GAAACACCGGCGGGGTTAGTGCAAGAAAGGGCATAGTAAGCTAACGCAAG	1
CATTTAACAC	GAAACACCGGTGGGCTTTACTCCTTTGTGGGGTTAGAGCTATAAATAGCA	1
TAAGCAGCAA	GAAACACCGGTGCGGTTAGAGCAAGAGATGGTATATTAATAGAAAGCGAG	1
GAATCATCCG	GAAACACCGGTTTTAGTAAATGGGGGGGTTAGAGCTAGAAATAGCAAGTT	1
AATCCATCAC	GAAACACCGGTGACCATGGTAAGGCAGCGGGGGTATAGAGCTAGATATAG	1
CGGCGTGTTG	GAAACACCGGTCGTCGTTAGTAGGGCGTGGGGTTAGAGATAGAAATATAA	1
CATTCACAAA	GAAACACCGGTGGCAATTCGGTTTGAATGGGGTTGGAGATCGAAATAGAA	1
ATCTAACCGG	GAAACACCGGTGTGCGGAGAGTATGCGTGAGAAATAGAAAGTAACGTAAG	1
GGCAACTACG	GAAACACCGGTGGCTAGAAATAGCAAGTTAACCTAAGGCTGGTCCGTTAT	1
AACATGCTAG	GAAACACCGGTTCTCGATCATAGGTTAGAGCTATAAATAGCTAGATAACC	1
GACAACCTCA	GAAACACCGGTAATCTAGAACTCCGCGTGGGGATAGAACTAGAAATAGCA	1
GAATTAAAAA	GAAGCACAGGTGCTAATAGTTAGCTCGTGGGGTTAGAGCTAGAAATAGCA	1
GTGGGCGAGA	GAAACACCGGTGAGATGCCTTAAGTGCTAGAAATAGCAAGTTAACCTAAG	1
TGCACTGCCG	GAAACACCGGTTTCAGTTAATTGGGAGGGGGGGTTGAGCTAAGAATTAGA	1
AAACCCATGA	GAAACACCGGTTTAGTATGGAGGGAAAGTTGGGTTAGAGCTAGAAATAGC	1
AAACCCATAA	GAAACACCGGTTTTGTTTGTGGGGTTGGGGGTAGAGATAGCGAGATAGCC	1
TCAGCAAAAA	GAAACACCGGTTCGGGTAGACTCGGAAAGGGGAAAGAGATAGAAGTAGAA	1
GACTCGCACG	GAAACACCGGTTTTAGCGGATTGTTCGTGGGGGTAACGCTAGGAATAACA	1
GAATGAGCAG	GAAACACCGGTTGTAGGAAACGCGGGGGGGAGGACATAGCAAGGTAACTT	1
TCAGCAAAAA	GAAACACCGGTGGGGTTAGAGCTAGAAATAGCAAGTTAACCTAAGGCTAG	1
CCCCCGCACC	GAAACACCGGTTCAACCGGCGTCTTTTGTGGGGTTAGAGCTAGAAATAGC	1
CATTCACAAA	GAAACACCGGTTGCCGTTAGCTCGTAGTGGGGGTAAAAGCAGGAAAAGCA	1
AGCAACTACG	GAAACACCGGTGGCAGCCAGCCACTTGTGGGGTTAGAGCTAGAAATAGCA	1
TATTTATCAC	GAAACACCGGTGACGAAAGTATGTTTGGGGGTAGAGATAGAAAAAGCGAG	1
CGTTCATCAA	GAAACACCGGTGCTAGCGGTTTCGAACTAGTGGGAGTAGCACTAGAAATA	1
GTGGGCGAGA	GAAACACCGGTGGGAAGAATCAACAAGTTAAAATAACAAGGTAACGTAAG	1
TTATTAAACA	CTAAACACCGGTCGCAATAGTGTGCCCGTGGGGTTAGAGCTAGAAATAGC	1
TCAGGAGAAA	GAAACACCGGTGGGGTTAGAGCTAGAAATAGCAAGTTAACCTAATGCTAG	1
CCCCGACGCC	GAAACACCGGTATTATGATAGAGCTAGGTGTGGCTAGTTAAACTAAGACC	1
TGCACGTCCT	GAAACACCGGTTCCCGTTAGCTCTTAGTGGGGTTAGAGCTAGAAATAGCA	1
GTGCCCCACT	GAAACACCGGTTGGCTTCGATGTATAGTGGGGTTAGTGCTAGAAATAGCA	1
GTAATATATA	GAAACACCGGTCAGAACGGCTGATTAAAGGTTGGAATTGGCAGGTAACCT	1
GTCTCACACC	GAAACACCGGTGAACCGGGCGTCTTCGGGGGAGATAGAGCTAGAAATAAG	1
ATGACCGTCG	GAAACACCGGTCCTAGAAGCTGAGTTGTGGGGTTAGAGCTAGAAATAGCA	1
TGCACTTTCT	GAAACACCGGTTCCCGTTAGCTCGTAGTGGGGTTAGAGCTAGAAATAGCA	1
ATACCCCTGA	GAAACACCGGTTTTAGGGGGTGTATTGCTGGAATTGGGCTATTAACCTCA	1
CTGTTAACAC	GAAACACCGGTCGGGATAAAGCAAGTTAAGGTATAGCGCTAGAAATATCA	1
GACACCATAC	GAAACACCGGTAATCTAACGATCCCAGAGGGGATAGTGATATAAATCGAA	1
CCAGCAAAAA	GAAACACAGGTGGGGTTAGAGCTAGAAATAGCAAGTTAACCTAAGGCTAG	1
TCAGCCAAAT	GAAACACCGGTTTACTTAGATCTCTAGATAGGTTGTTGCCCGAAAGATCG	1
ATAGCAACGA	GAAACACCGGTGGGCGGAGAGTAAGAGATAGCAAGAGAACGTAAGGTTAG	1
CACACCCAAT	GAAACACCGGTTTACTTAGTTAACTAGTGCGAATGCAACTAGAAATACAA	1
CCAACAATAC	GAAACACCGGTGTTAGTAGATAGTTCGTGGGGTTAGAGCTAGAAATAGCA	1
TACAACTCCC	GAAACACCGGTAATCGAAAGATCCCAGTGGGGGTAGAGCTAGAAATAGCA	1
CAATCCATTC	GAAACACCGGTTTAGTATGTGGGGTTAGAGCTAGAAATAGCAAGTTAACC	1
TCAACCCTCT	GAAACACCGGTGACGCGAGGACGTTAGAGCTAGAAATAGCAAGTTAACCT	1
GACAACCTCC	GAAACACCGGTTATCTTTACACCTTTGTGGGGTTAGAGCTAGAAATAGCA	1
TCAACCCTCT	GAAACACCGGTGACGCGAGGACGGGGTTAGAGCTAGAAATAGCAAGTTAA	1
TGCACTTCCT	GAAACACCGGTTCCCGTTAGCTCGTGGGGTTAGAGCTAGAAATAGCAAGT	1
CCGTTAACAC	GAAACACCGGTTGGCTTTAACTCTTTGTGGGGTTAGAGCTATAAATAGCA	1
AACACGCTCG	GAAACACCGGTTTACGATCATATGTCGTGGGGTTAGAGCTAGAAATAGCA	1
AATTGGCCAA	GAAACACCGGTTGTCGTCAACGCTGTGTGGGCGAAAAAGCACGATTACCT	1
CCCCGCCGCC	GAAACACCGGCTAGAAATAGCAAGTTAACCTAAGGCTAGTCCGTTATAAA	1
CCACGCCGCC	GAAACACCGGTAGAATGTTAGAGTTAGAGATAGCAAGCTAACCTATGGCT	1
AATAAAACCC	GAAACACCGGTGCGCTTAGGGGGGCTTGGGGTTAGAGCTAGAAATAGCAA	1
ATGAACGTCG	GAAACACCGGTGCTAGTAGCTGAGGTGGTGGTATAAATACCGAGATAACA	1
GACTATGTAA	GAAACACCGGTACTAGTTACTTACGGGTGGGGTTAGAGCTAGAAATAGCA	1
AACTGGCTAA	GAAACACCGGTTTTAGATAGTAGGTCGTGGGGTTAATAGTATGTATACCA	1
AATAATGCCG	GAAACACCGGTGCCCTTTATGGGACCGTGGGGTTAGAGCTAGAAATAGCA	1
AAAACCATGG	GAAACACCGGTTTAGTATGTAGGGAAGTGGGGTTAGAGCTAGAAATAGCA	1
GAATTAGAAA	GAAACACCGGTGCTAATAGTTAACTGGTGGGGTTAGAGCTAGAAATAGCA	1
TAAGTAATCC	GAAACACCGGTTGAGATAATCAAAAGGAGGGGTAGAGCTAGAAATAGCAA	1
GTATATCAAG	GAAACACCTGTATTAGTTACTCAAGGGTGGGGTTAGAGCTAGAAATAGCA	1
ATGACCGACG	GAAACACCGGTCCTAGTAGCTGTGTTGAGTGGGGGTAGAGCTAGAAATAG	1
ATCTAACCGA	GAAACCCCGGTGTGTGGAGATTATGCGTGAGAAATAGCAAGTAACCTACG	1
AACACTCTCT	GAAACACCGGTTTCCGATCATAGGTCGTGGGGTTAGAGCTAGAAATAGCA	1
GAACGAGATA	GAAACACCGGTGATAGTTGTTTCGAAGGGGGTTTAGCGCTAGAAATAGCA	1
CCCACCCACC	GAAACACCGGTACAATCGGCGTCTTTTGTGGGGCTAGAGCTAGAAATAGC	1
GCCTTAGTAA	GAAACACCGGTAGTCTTTACTTATGTGAGGGGCTAGATAACGTAATGGCA	1
AGACAGCAAC	GAAACACCGGTTGTGGTGAACTCGGTGTGGGAGAACTAGCAAGTTAACCT	1
GCAACCCGCG	GAAACACCGGTTATGGTAAGGTAATAGCGGGGTTAGAGCTAGAAATAGAA	1
CCGTTAACAC	GAAACACCGGTTGTCTTTGCTCCTTTGTGGGGTTAGAGCTATAAATAGCA	1
ATTCCATCTA	GAAACACCGGTGACCAGCGTATGTCCGTGGGGTTTAGGAAGTAACCAGAA	1
GATAAACTCC	GAAACACCGGTAATCAAACGATCCGCGTGGGGATAGAGCTAGAAATAGCA	1
GTGGGCGAGA	GAAACACCGGTGGGGTTAGAGCTAGAAATAGCAAGTTAACCTAAGGCTAG	1
GAAATATATA	GAAACACCGGTGAGGACGTGGGGGGAGAGGTAGAAATAGCAAGTTAACCT	1
ATAATATATA	GAAACACCGGTGAGCATGGAAACGTAGCAAGTTAACCTAAGGATAGTCCG	1
ATCTAACCGA	GAAACACCGGTGTGCGGAGATTATGCGTGAGAAATAGCAAGTAACCTAAG	1
AAGTATGTCG	GAAACACCGGTACTAGTTGCTTACGGGTGGGGGTAGAGCTAGAAATAGCA	1
GGGCGTGTTG	GAAACACCGGTCATCGTTACGGATGCGTGGGGTTATAGATCTAGATATAG	1
CGGCGGGTCG	GAAACACCGGTCGTCGTACGGGGGGATAGAGCTAGAAATAGCAAGGTAAG	1
TGTCCAGATT	GAAACACCGGTTTACTTGGATAAGTGTTGGAAATAGCAAGATAACCTAAG	1
GAATATGTAA	GAAACACCGGTAATCGTTACTTATGGGTGGGGTTAAAGCTAGAAATAGCA	1
GACATGCTAG	GAAACACCGGTGTTCTTTCATAGGCCGTGGGGTTAGAGCTATAAATAGCA	1
AACATGCTAG	GAAACACCGGTTTTCGATCATAGGTCGTGGGGTTAGAGCTAGAAATAGCA	1
TTCTTCTCAC	GAAACACCGGTCGCGAAAATGTGCAAGTGGGGTTAGAGCTATAAATCTCG	1
TAATTAATCC	GAAACACCGGTTAAGATAATCAAAAAGTGGGGTAGAGCTAGAAATAGCAA	1
GTAATATACA	GAAACACCGGTTGTCGGCGGTGGTTTGTTGGGTTAGAGCTACAAATTACA	1
GAATCCGTAA	GAAACACCGGTCCTAGAAGCTGATCGAGGGGTTTGGGCATAGAAAAACAA	1
AGACAGCAAC	GAAACACCGGTGTTGTTTGCTCGAGGGTGGGGTTAGAGCTGGAAATGGCA	1
AATAATGCCG	GAAACACCGGTAGACTGGATCCACGGGTGGGGTTAGAGCTAGAAATAGCA	1
AAAATGCTAG	GAAACACCGGTTTTCGATCCTCGGTTGGGGCTAGAGATCGAGAGATAACA	1
ATAACCTCCA	GAAACACCGGTTGCGAAGATGGGGTTGAGGGGTAAGAGCTCAAAATAACC	1
GAATGATAAA	GAAACACCGGTGGCAGCCAGCCACTTGTGGGGTTAGAGCTAGAAATAGCA	1
GGCAACTACC	GAAACACCGGTGGCTAAAAAAAGCCAGTTAGCCTAGGGCTAGTAAGATAA	1
AGACCGCAAC	GAAACACCGGTGTTCTTTGCTCGAGGGTGGGGTTAGAGCTAGAAATAGCA	1
TAAACCCAAT	GAAACACCGGTTGAGATAGCTAGAAATAGGGAGTTAACCTAGGGATAGTC	1
TACTCAATCC	GAAACACCGGTTATCTAAGGATACACGTGGGGATAGAGCTAGAAATAGCA	1
GAGACACTCG	GAAACACCGGTTACAGCTGGACGTAGCTAGTTATAGTGATGGTAATAGGA	1
AAAACCGTCT	GAAACACCGGTTTTAGTAGCTGACTAGTGGGGTTAGAGCTAGAAATAGCA	1
GAATTAAAAA	GAAACACCTGTTTTAGTAGATGGCGCTTGGGGTTAGAGCTAGAAATAGCA	1
GAATTAGACA	GAAACACCGGTTAGCACGAGGGGTTAGAGGGAGTAATAGTAGGTATAGCA	1
AATCCATCAC	GAAACACCGGTGACAAACGTATGTCAGTGGGGTTAGAGCTAGAAATAGCA	1
AAACCCATGA	GAAACACCGGTTTAGTATGTAGGGTTAGTGCTGTTAGTGCTAGAATAACC	1
GAATTAAAAA	GAAACACCGGTGCTAATAGTTAGCTCGTGGGGTTAGAGCTAGAAATAGAA	1
ACCCGCCGCC	GAAACACCGGTCGAATGTTATGGCTTGAAATAGTAGATTAACATATAGCA	1
AATCCATCAC	GAAACACCGGTTGAGATAATCAAAAAGTGGTTAGAGCTAGAAATAGCAAG	1
GGCAAATACG	GAAACACCGGTGACAACCAGCCACTTGTGGGGTTAGAGCTGGAAATAGCA	1
GAGACAAGCG	GAAACACCGGTTATCGAGCTATAAATAGCAAGTTAACCTAAGGCTAGTCC	1
TGCACTTCCT	GAAACACCGGTTCCCGTTAGCTCGTAGTGGGGTTAGAGCTAGAAATAGCA	1
AACATGAACA	GAAACACCGGTTTTGTTTTAGATTGAGTGGGGTAAGTGATATAAGTATCA	1
AAACCCATGA	GAAACACCGGTTTAGTATGAGGGGTTAGAGCTAGAAATAGCAAGTTAACC	1
GAACCCATGT	GAAACACCGGTTTTAGAAGAAGGGGAGGGGGGTTAGAGGTAGAAATAGCA	1
ATCTCAACAA	GAAACACCGGTGGGCTTTAATCATGCGTGGGGAAATACCAGTAAATAGAG	1
ATACCCGACT	GTACCCCCGGTCGTAGTCGCTGAGTTATTGCGATAGATATCTATCTACCC	1
AGCAATCCAC	GAAACACCGGTGCTCTTTACTCCGGAGTGGGGTTAGAGCTAGAAATAGCA	1
CGTTCATCAA	GAAACACCGGTGAGGACAGAACGTTTTGGGGTTAGAGCTAGAAATAGCAA	1
CTGTCCTGCA	GAAACACCGGTGAGAGGACTCAATTTGGGGGTTAGAGCTAGAAATAGCAA	1
GATAATGCCG	GAAACACCGGTACTATTTACTGAACGGTGGGGTTAGAGCTAGAAATAGCA	1
AATCCATCAC	GAAACACCGGTGACAAACGTATGTCAGTGGGGTTAAAGCTAGAAATAGCA	1
GAGTGTGTAA	GAAACACCGGTAGTGGTAGCGTTCGGGATGGGATAGAGCTATAAATAGCA	1
ATATAACCGA	GAAACACCGGTGTGCGGAGATTATGCGTGAGAAATAGCAAGTAACCTAAG	1
GAAACATAAA	GAAACACCGGTGAGCAAAGTTAATTAGAGGGAGAAGAGCTAGAAAAAGCA	1
CTCTCATCAC	GAAACACCGGTTGCCATTCGATCTTCGTGGGGTTAGAGCTATAAATAGCA	1
TAATTAATCC	GAAACACCGGTTGAGATAATCAAAAAGTGGGGTAGAGCTAGAAATAGCAA	1
CATTCGCAAA	GAAACACCGGTTGCGGTTAGATCTGTGTGGGGGTAGTACCAAGATTACCT	1
CCATCGAAAA	GAAACACCGGTGAGATCAGAGCGTTTTGTGGCGAGAGAGCGAAATACAAG	1
AGAACGCAAT	GATACACCGGTGTACTTAGTTAGATGGTGGGGTTAGAGCTAGAAATAGCA	1
GAATAGCAAC	GAAACACCGGTGCTATTTGCTCGCGGGTGGGGTTAGAGCTAGAAATAGCA	1
AATCCATCAC	GAAACACCGGTGACAAACGTATGTCAGTGGGGTTAGTGCTAGAAATAGCA	1
ATGACCGTCG	GAAACACCGGTCCTAGAAGCTGAGTTTGTGGGGTTAGAGCTAGAAATATC	1
GCGCCAAGCC	GAAACACCGGTAAACTGTATCCACGGGTGGGGTTAGAGCTAGAAATAGCA	1
CCATCCCCCA	GAAACACCGGTGACGCGAGGACGGGGTTAGAGCTAGAAATAGCAAGTTAA	1
CGTCCAGATT	GAAACACCGGTCTTCCTGGCATAGCTGGAGATTGCAAGTTAACCTAAGAC	1
GGCTACTAAA	GAAACACCGGTAGCAGCCAGCCACTTGTGGGGTTAGAGCTAGAAATAGCA	1
TGAACCCAAT	GAAACACCGGTGTTAGTAGTTAACTAGTGGGGTTAGAGCTAGAAATAGCA	1
TCATCAGCCG	ACAGTACGAAACACCGGTGGGGTTAGATCTAGAAATAGCAAGTTAACCTA	1
CCCCCGGACC	GAAACACCGGTGAGAACAGAACGTTTTTGGGGTTAGAGCTAGAAATAGCA	1
AAAAGGCCAC	GAAACACCGGTAGTGTGAAAATCAGCGTGGGAGTAAAACTAGGAATACCA	1
TGCTCAAGCT	GAAACACCGGTTCCCGTTAGCTCGTAGTGGGGTTAGAGCTAGAAATAGCA	1
CGACGGGTTG	GAAACACCGGTCGTTGTTCGTGGGGTTAGAGCTAGAAATAGCAAGTTAAC	1
