ATCTAACCGA	GAAACACCGGTGTGCGGAGATTATGCGTGAGAAATAGCAAGTAACCTAAG	2
GTCTAAGAGA	GAAAAACCGGTGTGGGGGGTTAATGGGTTTAAAGCTCGAAATAACAAATG	1
ACCTACCGCC	GAAACACCGGTAGACGGGAACCATGCGTGGGAACTAACAAAGAAATTGCA	1
CATTCACAAA	GAAACACCGGTGGCAATTCGATCTGAGTGGGGTTAGAGCTAGAAATAGCA	1
CGGCAACCAC	GAAACACCGGTGGTCTTTGATCCTGTGTGGGGTTAGAGCTAGAAATAGCA	1
TCAGCAAAAA	GAAACACCGGTGGGGTTAGAGCTAGAAATAGCAAGTTAACCTAAGGCTAG	1
ATGACCGTCG	GAAACACCGGTGGGGTTAGAGCTAGAGATGGCAAGTTGCCATAAGGCTCG	1
GTAATATACA	GAAACACCGGTGAGCATGATAACGTCTCGTGGGGTTAGAGCTAGAAATAG	1
ATATACCTGA	GAAACACCGGTGTGCGGAGATTATGTGGGATAAGTAGCAAGAAACCAAAG	1
CCGTTCACAC	GAAACACCGGCTGGCTTTACTAATTTGTGGGGTTAGAGCTATAAATAGCA	1
TGTGCAAATT	GAAACACCGGTCGGGCTAGAGTCTACGATAGCAAGAGCTCGTAATGCTAG	1
TGAGGGAGAG	GAAACACCGGTGAGATTAGAGATAGAAGTAGTAGGTTAAGCTAAGGCAAG	1
ATACCACACT	GAAACACCGGTTGTAAGCGATGGTTTGTGGGGTTAGAGCTAGAAATAGCA	1
GGAACATCTT	GAAACACCGGTTGCCGTTCGCAGGGGGGGGGGTAGAGCTAGAAATAGCAA	1
AAGTCAGTCG	GAAACACCGGTTATAGTTGCTGAGTTGTGGGGTTAGAGCAAGAAATAGCA	1
TTCTAAGCGA	GAAACACCGGTGTGCGTAGATTATGCGTGAGAAATAGCAAGTAACCTAAG	1
ATATAACCCA	GAAACACCGGTGTGCGGAGATTATACGTGGGGAATAGCAAGTAACCTAGG	1
GAGTCAAGCG	GAAACACCGGTTATCGTTACGGATTTGTGGGGTTAGAGATAGAAATAGCA	1
TGGCCAGGTT	ATGATGAAACACCGGTATTATGGAAATCTAGGGGGGGTTGAGATAGGAAA	1
GACATCCTCC	GAAACACCGGTAGTCTAAGGACTACAGAGAGCATAGTACCCTAAGGCTAG	1
TCAGCAGACA	GAAACACCGGTGGGCTTTTAGATAGCGTGGGGTTGTTACCATAAATAGCA	1
AGACAGCAAC	GAAACACCGGTGTTCTTTGCTCGAGGGTGGGGTTAGAGCTAGAAATAGCA	1
TGCACTTCCT	GAAGCACCGGTTCCCGTTAGCTCGTAGTGGGGTTAGAGCTAGAAATAGCA	1
TAAACCCCCG	GAAACACCGGTGACACAAGGATGTCAGTGGGGTTAGAGCTAGAAATAGCA	1
ATCTAGCCGA	GAAACACCGGTGTGCGGAGATTATGCGCGAGATATAGTAAGTAACCTAAG	1
AACATGCTAG	GAAACACCGGTTTTCGATCATAGGTAGTGGGGTTAGAGCTAGAAATAGCA	1
TAATCCCAAA	GAAACACCTGTGTACTTAGTTAACTAGTGGGGTTAGAGCTAGAAATAGCA	1
ATACTAATCC	GAAACACTAGAAATAAGAGATTAATTTAAGGCTTGGCGGTTATCAACTCA	1
TATCCACTTC	GAAACACCGGTCTTCCTGGGATCTACGTGGGGAAGAGCTAGGAATAGCAA	1
ATCTAACCGA	GAAACACCGGTGTGCGGTGATTATGCGTGGGGATTAGCAAGGAAACAACG	1
GTAATATATA	GAAACACCGGTGATCATGCTAACGTCTCGGGGGTATAGCTCGAAATAGAG	1
CACTCATCCA	GAAACACCGGTTCCCATTCGCTCTTAGTGGGGTTAGAGCTAGAAATAGCA	1
GAATTACTCT	GAAACACCGGTGACGATAGTAAGCTGGTGGGGTTAGAGCTAGAAATAGCA	1
TACCGCCGAT	GAAACACCGGCTAGATATGCTAACTAGAGCTATTGCTGCTCGGTAATGAA	1
TTATACTCCC	GAAACACCGGTCGCGAGAAATGTGGGGTTAGAGCTAGAAATAGCAAGTTA	1
GGCAACTACG	GAAACACCGGTGGCAGCCAGCCACTTGTGGGGTTAGAGCTAGAAATAGCA	1
CCTTTCACAC	GAAACACGGGGTGGCTTTGCTCGTTTGTGCGATTTAACCTATAAATCGCA	1
CAGTTAACAA	GAAACACCGGTTGAGATAATTACTTTGTGGGGTAAGGGTAGAAAAAGCCA	1
ATGACCGTCG	GAAACACCGGTCCCAGAAGCTGAAGAGTGGGTAGAAGTAGAAATAGCAAG	1
CGTTCATCAA	GAAACACCGGTGGGGACAGAGCGATTTGGGGTTAGAGAAAGTAATACCAA	1
AATCCATCAC	GAAACACAGGTGACAAACGTATGTCAGTGGGGTTAGAGCTAGAAATAGCA	1
