ATCTAACCGA	GAAACACCGGTGTGCGGAGATTATGCGTGAGAAATAGCAAGTAACCTAAG	3
GACAACCTCC	GAAACACCGGTAATCTAAAGATCCCCGTGGGGATAGAGCTAGGAATAGCA	2
AGACACCAAC	GCAACACCGGTTTTCTTAGCTCGCGGGTGGGGATAGAGCTAGAAATAGCA	1
ATGACCGTCG	GAAACACCGGTAGAATGGATCCACGGGTGGGGTTAGAGCTAGAAATAGCA	1
AACTCAGCCG	GAAACACCGGTGTTAATAGATTGTTAGTGGGGTTAGAGCTAGAAATAGCA	1
GAATCAGCCG	GAAACACCGGTTTTAGTAAATGGGGAGTGGGGTTAGAAGCAGAATTAGCA	1
GACAAAAACC	GAAACACCGGTAATCTAAAGACCCCCAAGGGCATAGAGCCATAAATAGAA	1
CACCCAGAAT	GAAACACCGGTTGTAATTGTTTCCGAGGGGGGTTAGAGCTAGAAATAGCA	1
CCCAAGCAAC	GAAACACCGGTGGAATTGGCCCGTGGGGGGGGTTAGAGCTAGAAATAGCA	1
CAACGCATTA	GAAACACCGGTTTTGTATGGAGAGCCGTGGGGTTCAAGCTAACCATAGCC	1
GACAACCTCC	GAAGCACCGGTAATCTATATATCCCCGTGGGGATAGAGCTAGAAATAGCA	1
GACAACGTAA	GAAACACCGGTACTAGGTACTTATTAGAGGGGTTAGAGCTAGGTAAACCT	1
TACAACCTCC	GAAACACCGGTAATCTAAAGATCCCCGTGGGGATAGAGCTAGAAATAGCA	1
TCAGCAAAAC	GAAACACCGGTGGGTTAGAGCTAGAAATAGCAAGTTAACCTAAGGCTAGT	1
TGATCACTAA	GAAACGCCGGTGAGGCGGGGGCTAGATGTGGATATAGCTAGTTAACCTAA	1
CCCTCGCACC	GAAACACCGGTTCAACCGGCGTCTTTTGTGGGGTTAGAGCTAGAACTAGC	1
TCAATCCTCT	GAAACACCGGTGACGCGAGGACGTTAGATCTAGAAATAGCAAGATAACCT	1
CCTTTTACAC	GAAACACCGGTTGCCTTTATTCGTTCGTGGGGTTAGAGCTATAAATAGCA	1
CACATGCTAG	GAAACACCGGTAGTCGATCATCACGGGTGGGGTTAGAGCTAGAAATAGCA	1
GTCTAACCTA	GAAACACCGGTGAGCATGATAACGTCGTGGGGTTAGAGCTAGAAACAGCA	1
GGCACCTACG	GAAACACCGGTTGCCGTTAGCTCTAAGTGGGGTTAGAGCTAGAAATAGCA	1
TTATTAACCC	GAAACACCGGTCGCGAAAGTTATCCGGTGGGGTTAGAGCTATAAATAGCA	1
CCGTTCACAC	GAAACACCGGTCGGCTTAACTCCTTTGTGGCTATAGATAGATAAATAGCC	1
AACCCCATGC	GAAACACCGGTTTCGTATAGAGGGGTTAGGGCTTGGAGTTACAAATTGCA	1
AATAATGCCG	GAAACACCGGTGCCCTTTATGGGACCGTGGGGTTAGAGCTAGTAATAGCA	1
AAATTAAAAC	GAAACACCGGTGCTAATAGTTAGCTCTCGTGGGGATAGAGCTAGAAATAG	1
GTAGCATATA	GAAACACCGGTGAGCTTAGGCCAAAAAGTAACATATTATCCTACGACTCC	1
AATCGTGCCC	GAAACACCGGTTGTAAGGGACGCGGTGTGGGGTTAATAGCAGATTAACCT	1
GATATATATA	GAAACACCGGTGACAAACGTTAGACCTATGGATTGCAACTTAACCTATCA	1
TCGCCAACTT	CTAAACACCGGTATGCTTGGTTCCCTTGTGGGGATAGCGCTATAAACTGG	1
CATTCACAAA	GAAACACCGGTGGTAATTCGATCTGAGTGGGGTTAGAGCTAGAAATAGCA	1
CCCTCGCACC	GAAACACCGGTTCAACCGGCGTCTTTTGTGGGGTTAGAGCTAGAAATAGC	1
AGCCATCACC	GAAACACCGGTGTCCTTTATTCGAGGGTGGGGTTAGAGCTAGAAATAGCA	1
GAATCACACG	GAAACACCGGTTTCAGTTAGTGGTGAGTTGGGTTAGAGCTAGAAATAGCA	1
AAACCCATGA	GAAACAACGGTTTAGTATGGAGGGAAGTGGGGTTAGAGCTAGAAATAGCA	1
CATAATGCCG	GAAACACCGGTGCCCTTTATGGTACCGTGGGGTTAGAGCTAGAAATCGCA	1
AATCCGTCAC	GAAACACCGGTTCAACACGTGTGTTTGTGGGGTTAGAGCTAGAAATAGCA	1
GAATTAAAAA	GAAACACCGGTGCTAATAGTTAGCTCTCGTGGGGTTAGAGCTAGAAATAG	1
GAATTAAAAA	GAAACACCGGTGCTAATAGTTAGCTCGTGGGGTTAGAGCTAGAAATAGCA	1
AACATGCTAG	GAAACACCGGTTTTCGATCATAGGTCGTGGGGTTAGAGCTAGAAATAGCA	1
AATAACTCAC	GAAACACCGGTGACCTACGTATGCCCGGGGGGGTAGAGCTTAGAATTACC	1
AAGACCCTAG	GAAACACCGGTGTTAGATCATAGTTCGTGGGGTTAGAGCTAGAAATAGCA	1
AAAATAGTCC	GAAACACCGGTTGGGGGGAAAACGAGGGGGGGGATATAGCTAGAAAACGT	1
TACAACGAAA	GAAACACCGGTATAAGTAACTAACGGGTGGGGTTAGAGCTAGAAATAGCA	1
AAGCGGGTTG	GAAACACCGGTCGTCGTTCGTAGGGCGTGGGGTTAGAGCTAGAAATAGCA	1
TACACTTTCC	GAAACACCGGTAATCGTTAGATCCCCGGGGGGGTTGAAGTTAGAATTAGA	1
AACATGCTAC	GAAACACCGGTGTTCTTTCCTCGAGGGTGGGGTTAGGGCTAGAAATAGCA	1
TAAGCAACAA	GAAACACCGGTGACGATAGAGCTACAGATAGCATGTTAACCTAAATCTAG	1
AAAACAGCCG	GAAACACCGGTCTTAGAAAATGTAGAGAGGGCTTAGTGCCAGAAATATCA	1
TAATTAATCC	GAAACACCGGTTGAGATAGCTAGAAATAGCAAGTTAACCTAAGGCCAGTC	1
CGCCCCCGCC	GAAACACCGGTGAGAAGAGTCCGCTTTGGGGTTAGAGCTTGAAATTGCCA	1
GGCAACTACG	GAAACACCGGTGGCAGCCAGCCACTTGTGGGGTTAGAGCTAGAAATAGCA	1
GCCCAAAGCT	GAAACACCGGTGGTCGCCGTGGAGTTAGAGCTAGAAATAGCAAGTGGGGT	1
TGACATTACT	GAAACACCTGTGCCCTTTGCTTGAGTGTGGGGTTATAGCTAGAAATAGCA	1
TAATTAACCG	GAAACACCGGTTGTGGTAATCGAAAAGTGGGGGAGAGCGAGAGATAGCAA	1
