ATCTAACCGA	GAAACACCGGTGTGCGGAGATTATGCGTGAGAAATAGCAAGTAACCTAAG	7
TGCACTTCCT	GAAACACCGGTTCCCGTTAGCTCGTAAGTGGGGTTAGAGCTAGAAATAGC	3
CCAGCAAAAA	GAAACACCGGTGGGGTTAGAGCTAGAAATAGCAAGTTAACCTAAGGCTAG	2
AAACCCATGA	GAAACACCTGTTTAGTATGGAGGGAAGTGGGGTTAGAGCTAGAAGTAGCA	2
GAATTAACAA	GAAACACCGGTGGTAAGAGTTAGGTCGTGGGGTTAGAGGTAGAAATAGCA	1
AATAATGCCG	GAAACACCGGTGCCCTTTATGGGACCGTGGGGTTAGAGCTAGAAATAGCA	1
CGTTCATCAA	GAAACACCGGTGAGAACAGAACGTTTTGGGGTTAGAGCTAGAAATAGCAA	1
AAACCCATGA	GAAACACCGGTTTAGTATGGAGGGAAGTGGGGTTAGAGCTAGAAATAGCA	1
TTCTTCTCCC	GGAACACCGGTCGCGAAAATGTGCCGGTGGGGTTAGAGCTAGAAATAGCA	1
ATCTAACCGA	GAAACACCGGTGTGCGGAGATTATGAGTGAGAAATAGCAAGTAACCTAAG	1
AACAATGTCG	GAAACACCGGTGCTAGTTACTTGATCGTGGGGTTAGAGCTAGAAATGGCA	1
CATTCACAAA	GAAACACCGGTGGCAATTCGATCTGAGTGGGGTTAGAGCTAGAAATAGCA	1
TGCACATCCT	GAAACACCGGTTTAGTATGGAGGGAAGTGGGGTTAGAGCTAGAAATAGCA	1
AGACGGCAAC	GAAACACCGGTGTTCTTTGCTCGAGGGTGGGGTTAGAGCTAGAAATAGCA	1
AATCCATCAC	GAAACACCGGTGACAAACGTATGTCAGTGGGGTTAGAGCTAGAAATAGCA	1
TTCTTCTCCC	GAAACACCCGTGGCAATTCGATCTGAGTGGGGTTAGAGCTAGAAATAGCA	1
CGTCCACCAC	GAAACACCGGTGATAAACGTACGTTTGTGGGGTTGAAGCTGGAATTGCCA	1
CATTCACAAA	GAGACACCGGTGGCAATTCGATCTGAGTGGGGTTAGAGCTAGAAATAGCA	1
CCGTTAACAC	GAAACACCGGTTGGCTTTACTCCTTTGTGGGGTTAGAGCTATTAATAGCA	1
CGGCGGGTCG	GAAACACCGGTCCTCGTTCTTGGGCCTAGGGCTTAGAGCTACAAGTAACA	1
GACAACCTCC	GAAACACCGGTAATCTAAAGATCCCAGTGGGGATAGAGCTAGAAATAGCA	1
CGGTTAACAC	GAAACACCGGTTGGCTTTACTCCATTGTGGGGTTAGAGCTATAAATAGCA	1
ATACCAGCCT	GAAACACCGGTTTTAAGCGATGGTTAGTGGGGTTAGAGCTAGAAATAGCA	1
CAACGAGATT	GAAACACCGGTACTAGTTACTTACGGGTGGGGTTAGAGCTAGAAATAGCA	1
TCCTTAATCC	GAAACACAGGTTCAACCGGCGTCTTTGGGTCTAGAAATAGCAAGTTAACC	1
GACAACCTCC	GAAACACCGGTAATCTAACGATCCCCGTGGGGTTAGAGCTAGAAATAGCA	1
TTCTTCTCCC	GAAACACCGGTCGCGAAAATGTGCCGGTTGGGTTAGAGCTAGAAATAGCA	1
CCCTCGCACC	GGAACACCGGTTCAACCTGCGTCTTTTGTGGGGTTAGAGCTAGAAATAGC	1
TGCACTTCCT	GAAACACCGGTACTCGTTACTTACGGGTGGGGTTAGAGCTAGAAATAGCA	1
AGACAGCAAC	GAAACACCGGTGTTCTTTGCTCGAAGGTGTGGTTAGAGCTAGAAATAGCA	1
AATTGGGCAA	GAAACACCGGTTGTGGGGAACTCGGTGTGGGAGAAATAGCAAGTTAACCT	1
TCCTTAATCC	GAAACACAGGTTCAACTGGTGTCTTTTGGTCTTGAAACAGCAAGTTAACC	1
TTCTTGTCCC	GAAACACCGGTCGCGAAAATGTGCCGGTGGGGTTAGAACTAGAAATGGCA	1
TGCACTTCCT	GAAACACCGGTTCCCGTTAGCTCGTAAGTGGGGTTAGAGCTAGCCATAGC	1
TGCACTTACT	GAAACACCGGTTCCCGTTAGCTCGTAAGTGGGGTTAGAGCTAGAAATAGC	1
CCTTGAACAC	GAAACACCGGTTGGCTTTACCTCTTTGTGGGGTTAGAGCTAAAAATAGCT	1
ATACCACACT	GAAACACCTGTTGCAACCGGCCACTTGTGGGGTTAGAGCTAGAAATAGCA	1
GTAATATATA	GAAACACCGGTGAGCATGATAACGTCGTGGGGTTAGAGCTAGAAATAGCA	1
AATACTGCCG	GAAACACCGGTTATCTTTATGGGGTTAGAGCTATAAATATCAAATTACCC	1
AGACAAGATT	GAAACACCGGTCTTCCTGGAATCTACGTGGGGTAGAGCTAGAAATAGCAA	1
TCAGCAAAAA	GAAACACCGGTGGGGTTAGAGCTAGAAATATCAAGTTAACCTAAGGCTAG	1
TGCACTTCCT	GAAACACCGGTGCCAAACGGCTGTTACCGGTTTTGGGGATATGAACTAGA	1
AATCTATAAA	GAAACACCGGTGACAAACGTATGGCAGTGGGGTTAGAGCAAGAAATAGAA	1
CCCCGCCGCC	GAAACACCGGTAGAATGGATCCACGGTTAGAGCTAGAAATAGCAAGTTAA	1
TTCTAACAGT	GAAACACCGGTTCCCGGTGGCTATGCGTGAGAAATAACAAATAACCAAAA	1
AGACAGCAAC	GAAACACCGGTGTTCTTTGCTCGAGGGTGTGGTTAGAGCTAGAAATAGCA	1
AATTGGTCAA	GAAACACCGGTTGTGGGGAACTCGGTGTGGGAGAAATAGCAAGTTAACCT	1
TAATTAATCC	GAAACACCGGTTGAGATAATCAAAAGTGGGGAAGAGCTAGAAATAGCAAG	1
AAACCATCAA	GAAACACCGGTTACATAAATAGGAAGTTAACCTAGAGCTAGACCGAGAAC	1
TCAACCCTCT	GAAACACCGGTGACGCGAGGACGGGTTAGAGCTAGAAATAGCAAGTTAAC	1
CCACTCAACC	GAAACACCGGCGAGAATTGTTAACTCCACCGGGTTCGAGTTCGATATCAC	1
GAGTCAAGCG	GAAACACCGGTTATCGTTACGGATTTGTGGGGTTAGAGCTAGAAATAGCA	1
AATTGCGCAC	GAAACACCGGTTGCGGGGAAATCAGGTTGGCCGAAGGAGCGTGTTATCTT	1
AGACAACAAC	GAAACACCGGTTTAGTATGCGGGGTTAGAGGTAGAAATAGCAAGTTAACA	1
ATCTAGCCGA	GAAACACCGGTGTGCGAAGATTATGCGTGAAAAATAGCAAGGAACCTAAG	1
TGCACTACCT	GAAACACCGGTGCCCGTTAGCTCATAAAGGGGATGGTAATCGAAAGATAG	1
