ATACCACACT	GAAACACCGGTTGTAAGCGATGGTTTGTGGGGTTAGAGCTAGAAATAGCA	3
CATTCACAAA	GAAACACCGGTGGCAATTCGATCTGAGTGGGGTTAGAGCTAGAAATAGCA	2
GACAGCCACC	GAAACACCGGTAATCTATAGACGCGCGTGGGGATAGAGCTAGAAATAGCA	1
TGAACATAAA	GAAACACCGGTGGGAAGGGGTAGGGATAGGGATAGAAAGATAAAGAGAAA	1
TTCTTCTCCC	GAAACACCGGTCGCTAAAATGTGCCGGTGGGGTTAGAGCTAGAAATAGCA	1
GGACAAAAAA	GAAACACCGGTGTTCTTAGCTCGATGGTGGGGTTAGAGCTAGAAATAGCA	1
ACGCAAACAC	GAAACACCGGTTGTCTTTGCTCGTTGGTGGTGTTAGAGCTATAAATAGCA	1
AATTGGGCAA	GAAACACCGGTTGTGGGGAACTCGGTGTGGGAGAAGTAGCAAGTTAACCT	1
AGACAGCAAC	GAAACACCGGTGTTCGATGCTGGAGTGTGGGGTTAGAGCTAGAAATAGCA	1
AGACAGGAAC	GAAACACCGGTGTTCTTTGCACAGGTGGGGGGTTAAAGCTAGAAATAGCA	1
TCAGCCAACA	GAAACACCGTGGGGTTAGAGCTTGAAATAGCAAGTTAACCTAAGGCTAGT	1
GATTTAAAAA	GAAACACCGGTGCTGGTGGATTCCTCGTGGGAGAAGAGCTAGGTTAAGCT	1
GCGTCAAGCG	GAAACACCGGTTGTCGTTACGGATTTGTTGGGTTAGAGCTAGAAATAGCA	1
ACGTTACCAC	GAAACACCGGTTGGCTTTAATCATTCGTGAGAATTGGGATGTAACTTGAA	1
GAGGGCGAGA	GAAACACCGGTGGGGATACAGTTAGAGATAGGAAAGAGACAGAAGGCTAA	1
CCAGCAAACA	GAAACACCGGTTCGGCTAGAGCTAGAAATAGCAAGTTAACCGAAGGCTAG	1
CCCCGGCGCC	GAAACACCGGTACAATGGATCCACGGGTGGGGTTAGAGCTAGAAATAGCA	1
ATCTAACCGA	GAAACACCGGTGGGAAGAGATTATGTGTGGGGATTAGCAAGGAAATAGAA	1
CGATCATCAA	GAAACACCGGTGTTCGATCTGGGGGTAGCGGTTTAACCTAGAACTAGTCC	1
ATGACCGTCG	GAAACACCGGTCATAGAGGCTGAGCGGGGTTAGAGCTAGAAATAGCAAGT	1
CCCTTCTCCC	GAAACACCGGTATTGTTGGAATATAGAAATAGAAAGTAAACTAAAGGCAG	1
CCCTCGCACC	GAAACACCGGTGACGCGAGGGTTAGAGCTAGAAATAGCAAGTTAACCTAA	1
ATGGGCGTCG	GAAACACCGGGGGGTTAGAGCTAGAACTAGCAAGTTAAACTTAAGCTAGT	1
TAAACCCAAT	GAAACACAGGTTTACTTAGTTAACTAGTGGGGTTAGAGCTAGAAATAGCA	1
ATGACCGTCG	GAAACACCGGGAGAGTAGGGCTAGAAATAGCAAGAGAACGTAAGGCTAGT	1
CAACGCGTTT	GAAACACCGGTGCTAGAAGCTTAGTTGGGGGGTTAGAGATCGAAATAGCA	1
GAATTGCAAC	GAAACACCGGTGAAAATGGTAACGTCGCGGGGGTAGAGGCAAGAAATGCA	1
GTGATATATA	GAAACACCGGTGAGATTCCTCAAGTGCGAGAAGTAGCAAGTTTACCTAAG	1
GAATCAGCCG	GAAACACCTGTTTTAGTAGATGGTGAGAGGGGTTAGAGCTAGAAATCGCA	1
ACAACCATCA	GAAACACCGGTGAAGTGAGGACGGAGGTGGGGTTAGAGCTAGAAATAGCA	1
AACATGCTAG	GAAACACCGGTTTTCGATCATATGTCGTGGGGTTAGAGCTAGAAATAGCG	1
GAGTCATGCC	GAAACACCGGTTACCGTTAGCTCGTAGTGGGGTTAGAGCTAGAAATAGCA	1
AATTGAGACA	GAAACACCGGTTGTGATGGATACGGTGTGGGGTTAGAGCCAGAAATACCA	1
AAACCACAAC	GAAACACCGGTGTCCTTCGTTAGATAGTGGGGTTAGAGCTAGAAATAGCA	1
TCAGCAAAAA	ACAGGCCGAAACACCGGTGGGGTTAGAGCTAGAAATAGCACGTTAACCTC	1
CGTTCCTCAA	GAAACACCGGGGGGGGGACTAGTAGTATTAGCTTAACCTCCTGCTACTCC	1
AATCCCTCAC	GAAACACCGGTGACAAACGTATGTCAGTGGGGATAGAGCTAGAAATAGCA	1
CCCCTCCTCC	GAAACACCGGTTGAGTTGATCAAAGGGTGGGGTTGGGGCAGAAAATGTCA	1
GAGTCAAGCG	CTAAACACCGGTTATCGTTACGGATTTGTGGGGTTAGAGCTAGAAATAGC	1
TCCAGCCAAT	GAAACACCTGGAGAGTGGGGGTAGAGCTAGAACTAGCAAGTTCACCTAAG	1
AACATGCAAG	GAAACACCGGTTTACTTAGATAAGTCGTGGGGTTAGAGCTAGAAATAGCA	1
GTAATATATA	GAAACACCGGTGAGTGGGGTTAGAGCTAGAGATAGCAAGTTAACATAAGG	1
ACTCCCTCAC	GAAACACCGGTGACGCACGTATGTCAGTGGGGATAGACATAGAAATAGCA	1
GAATCAGCCG	GAAACACCGGTTTTAGTAAATGGTGAGTGGGGTTAGAGCTAGAAATAGCA	1
CGATAACCAA	GAAACACCGGTGAGCTTTGCACGTTTGTGGGGTTAGGGTAGGAAAAACAA	1
ACCATACTAG	GAAACACCGGTTTGCGATAATTATTCGTGGGGTTAGAGCTATAAATAGCA	1
AAAACAGAAG	GAAACACCGGCGGTCATTGAGGGAGAAAGAGGATAGAGATCGAAATAGAA	1
CCCTAGGACC	GAAACACCGGTTCAACCGGCGTGGGGGTAGAGCTAGAAATGGCAAGTTAA	1
GCAACAGGCT	GAAACACCTGTTGTAGCAGAGGGGTTGGGGGGTGAAAACGAGAAATAACC	1
ATGACACTCT	GAAACACCGGTCATAGGTGATAATTTGTGGGTTTACAGCTGCTAATCGCA	1
CAATCAGACA	GAAACACCGGTGGCAGTTAGTTCTGAGTGGGGTTAGAGCTAGAAATAGCA	1
GTCTGAGAGA	GAAACACCGGTGGGGTGAGATCTAGCAAGAGCAATTGCACGTAACGTAAG	1
TTCTTCTCCA	GAAACACCGGTCCCGAAGATGTGCCGGGGTGGCTAGAGCTTGAACTGGTA	1
CATACACAAC	GAAACACCGGTGGCATATCGATCTGAGTGGGGATAGAGCTAGAAATAGCA	1
CCCTCGAACG	GAAACACCGGTTAAACTGGCGTCTTTTGTGGGGTTAGAGCTAGAAACAGC	1
GTTATATATG	GATACATCGGTGTGCATGGTATAGACGTGGGGGATAGATAGAGACATCAA	1
CGGCGGGGCG	GAAACACCGGTCGTCGTTCCGAGTTTGGGGGGGTTAGAGCTGGAATTAGA	1
ATGACCGTCG	GAAACACCGGTCCTAGAAGCTGAGTTGTGGGGTTAGAGCTAGAAATAGCA	1
TACTCATAAA	GAAACACCGGTTCCCGTTAGCTCTGAGTGGGGTTAGAGCTAGAAATAGCA	1
GGCACATACG	GAAACACCGGTTTTAGGAAATGGCGAGTTAGGCTAGGGCTAGAAAGATCA	1
GAATCAGCCG	GAAACACCGGTTTTAGTAAATGACGAGTGGGGTTAGAGCTAGAAATAGCA	1
GCCAAAAAAT	GAAACACCGGTGTTCGTCGAGTGGGGGTAGGGGTTAAAACAAGAAATAAA	1
TGAACATCTT	GAAACACCTGTGGCGGATAGCTCGTAGTAGGGATAGAGCTAGAAATAGCA	1
TAAGCAGCAA	GAAACACCGGTTGTGGTGGACTCGGTGAGGGAGAGATAGCATGAGAATCT	1
GACTATTATA	GAAACACCGGTAGTCGTTCGTTGCGGGGGGGTTAAGGGTAGGAATAGCCA	1
TCAGCAACAA	GAAACACCGGTGGGGTTAGAGCTAGAAATAGCAAGTTAACCTAAGGCTAG	1
AAATCTATAA	GAAACACCTGTTTTGTTTGCGTGGTTGTGGCTTGAGATCGCGCGTTAACA	1
GTAATATATA	GAAACACCGGTCGTCGTTCGTAGGGGTGGGGTTAGAGCTAGAAATAGCAA	1
AGACAGCAAA	GAAACACCGGTGTTCTTTGCTCGAGGGTGGGGTTGGAGCTAGAAATAGCA	1
GATCCAAGCG	GAAACACCGGTTGCCGTTCCATCTGAGAGCTGTTAGAGCTAGGTTTACCT	1
TTCTTCTCCC	GATACACCGGTCCTAGAAGCTGAAGTGGGGTTAGAGCTAGAAATAGCAAG	1
CCCTCGCACC	CAAAACACCGGTTCAACCGGCGTGGGGTTAGAGCTAGAAATAGCAAGTTA	1
AATTGGGCCA	GAAACACCGGTTGCGTGGATGTGGCTGTGGGATTAAAACCAAAAAAACCA	1
AATACTGCCG	GAAACACCGGTTCCCGTTATGGGTCAGTGGGGGTAGAGCTAGAAAAAGCA	1
TAAACATAAT	GAAACACCGGTTAACATAGTTAAGTAGGGGGGTTAGAGCTAGAAATAGCC	1
ATAGCAAAAA	GAAACACCGGTTGGGAGAGATGTTGAATGAGGAAGGTAACAGAAAGAGAA	1
GAATCAAACA	GAAACACCGGTGATAAAATAGCAAGTGAGGGTATAGAGATAGCGATAGCA	1
GAGTCTAGTG	GACACACCGGTTCTCGTTACGTATTATGTTGGGTTAACGCAAAAAATCGA	1
AAACCCATGA	GAAACACCGGTTTAGTATGGAGGGGTAGAGCTAGAAATAGCAAGTTAACC	1
AACAAGCAAC	GAAACACCGGTGATCTAAAGATCCGCGTGGGGATAGAGCTAGAAATAGCA	1
GTGACAGTCG	GAAACACCGGGGGGATAGAGCTAGAAGTAGCAAGTTAACCTAAGGCTAGA	1
AACATGCTAG	GAAACACCGGTTTTATAGGGTTGGAGGTGGGGATAGAGCGAGAAACTACG	1
TGCACAGATT	GAAACACCGGTCCTCGTTAGATCGACGTGGGGTTAAGCCAGGAAAAAGAA	1
GAGTCAAGCG	GAAACACAGGTTATCGTTACGGATTTGTGGGGTTAGAGCTAGAAATAGCA	1
GTGGGCGAGA	GAAACACCGGTGGGGTTAGAGCTAGAAATAGCAAGTTAACCTAAGGCTAG	1
CACAACCTCC	GAAACACCGGTAATCTAAAGATACACGTGGGGATAGAGCTAGACATAGAA	1
TGTTCAACCC	GAAACACCGGTTAGGATAATGAATATTGTGGGGATAGCGAGAAATAGCAA	1
TGCCCTTACT	GAAACACCGGTTCACGTTGGCTCGTAGTGGGGTTAGAGCTAGAAATAGCA	1
ATGAGGGTAG	GAAACACCGGTTGTGGGGAATTCGGTGAGGGAGAAATAGCAAGATAACAT	1
TTCTTCTCCC	GAAACACCGGTCGCGAAAATGTGCCGGTGGGGTTAGAGCTAGAAATAGCA	1
AATAATGCAG	GAAACACCGGTGCCCTTTATGGGACCGTGGTGTTAGAGCTAGAAATAGCA	1
GAATTAAATT	GCGGAACCACCGGGGCTATAGGTTTCGAGGTGGGTTAGGAGCTGGAAATA	1
CAAACACAAT	GAAACACCGGTGTCAATTCGAAATGAGTGGGGTTAGAGCTAGAAATAGCA	1
ACAACCCCCT	GAAACACCGGTGACGCGAGGACGTTAGAGCTAGTAAAAGCAAGTTAACCA	1
CCAGCAAAAA	GAAACACCGGTGGGGGTAGAGCTAGAAATAGCAAGTTAACCTAAGGCTAC	1
CCCCGCCGCC	GGAACACCGGTAGAATGGATCCACGGGTGGGGTTAGAGCTAGAAATAGCA	1
CGCTCATCAA	GAAACACCGGTGAGCTAAGGACTTTTGGGGTTAGAGCTAGAAATAGCAAG	1
TCAACCCACT	GAAACACCGGTGATCTGTGCACGAGGGAGGGGGTAGAGCCAGGAATAGCA	1
GGCACTGAGA	GAAACACCGGTGAGATGCCTCAAGTGCTAGAAATAGCAAGTTAACCTAAG	1
AAATTAAAAC	GAAACACCGGTGCTAATCGTTAGCTCGTGGGGTTAGAGCTAGAAATAGCA	1
CAGTCACGCA	GAAACACCGGTTGCCATTCCATCTTTGTGGGGTTAGAGCTAGAAATAGCA	1
GAATCAGCCG	GAAACACCGGTTTTAGTGGGGTTAGAGCTAGAAATAGCAAGTTAACCAAG	1
GAATCAGCCG	GAAACACCGGTTTTAGTAAATGGTGGGTGGGGTTAGAGCTGGAAATAGCA	1
ATGACCGGCG	GAAACACCGGCCCTAGAAGCTGAGTTGAGCGGTTAGAGCTAGAATTAGCA	1
TTAACCCTCT	GAAACACCGGTCCCACGTGGACATTGGAGCTTGACATAGCACGTTTCCTT	1
TAAACCCAAT	GAAACACCGGTTTACTTAGTTAACTAGTGGGGTTAGAGCTAGAAATAGCA	1
ATGACAGTAG	GAAACACCGGTCCTAGAAGTGGGGTTAAAGCTAGAAATAGCAAGTTAACC	1
GTCTAACCGA	GAAACACCGGTGCGCGGTGATTATGCTTGAGAATTAGCATGTAACCTACG	1
AATCCATCAC	GAAACACCGGTGACAAACGTATGTCAGTGGGGTTAGAGCTAGAAATAGCA	1
CTGACAACAC	GAAACACCGGTTGTATGCGATGGTTTGTGGGGTTAGAGCTATAAATAGCA	1
AAACGCGATT	GAAACACCGGTGCTAGCGGTTTCGAAAGTTGGGTTAGAGCTAGATATAGC	1
ATGACGGTCG	GAAACACCGGTCCTAGAGGCTGAGTTTTGTGGGGTTGAAGCTGGAAATGG	1
TAAAACCAAT	GAAACACCGGTGTCCTTAGGCTAGATGTAGAAATAGAGCGTTAACCTACG	1
TTCTTCTCCC	GAAACACCGGTCGAAAAAATACGCCGGGGGGGTAAAAGTTAGAATTAGCA	1
CATTGGGACA	GAAACACCGGTGCCAGTGGTATCGAAGTGGGGTTAGAGCTAGAAATAGCA	1
GTCAACTACG	GAAACACCGGTGGCAGCCAGCCACTTGTGGGGTTAGAGCTAGAAATAGCA	1
TGTACCGATT	GAAACACCGGGCGTAGAGCTAGAGTTGGCAAGTTAGACTTAGGATAGTCA	1
GATTCAGCAG	GAAACACCGGTTTTAGTAAATGGTGAGTGGGGTTAGAGCTAGAAATAGCA	1
TAAACCCTTA	GCCACACCGGTGACGCGGGGTGGGGTTAGAGGTAGCAATAGCGAGTTAAA	1
TAATCAAAAA	GAAACACCGGTGGGAATAGGATTTGAGTGGGCTTAGTGCTCGAAATCGAA	1
TTCTTCTCCC	GAAACACCGGTTCCCGTTAGCTCGTAAGTGTGGTTAGAGCTAGAAATAGC	1
AAATTAATCC	GAAACACCGGTTGTAATAGTTGAGTTGTGGGGTTAGAGCTAGAAATAGCA	1
AGACCAATCA	GAAACACCGGTGTTAGAGCTAGAAATAGAGCGTTAAACTAAAGCTAGACC	1
CAACAGCAGC	GAAACACCGGTTTTATCTGCTGGAGAGTGGGGTTAGAGCTAGAAATAGCA	1
GCCAACATCC	GAAACACCGGTGATCTCAGGGTCGCGGTGGGGATAGAGCTAGAAATATCA	1
ATGACGGTAA	GAAACACCGGTTGTAGTATATTAGGTGTGGGGGTAAAGCTAGAATAACCA	1
GAGTCAAGCG	GAAACACCGGTTATCGTTACGGATTCGTGGGGTTAGAGCTAGAAATAGCA	1
CCGGTCGCGC	GAAACACCGGTTGGCTTTACCCCTTTGTAGGGTTAGAGCTATAACTAGCA	1
CAACGAGATT	GAAACACCGGTGCTCGCGGTTTCGAGGTGGGGTTAGAGCTAGAAATAGCA	1
GAAATATAAA	GAAACACCGGTGAGAAAGGTAAGGTAGGGGGGAGAAAGCTAGAGATAGCA	1
CTGAATGTTG	GAAACACCGGTGCTCTTTGCTCGGGGGTGGGGTTAGAGCTAGAAATAGCA	1
TAAAACCACT	GAAACACGGGCTTACTTAGCTAACTATAGGGGTTAGAGCTAGAACTAGCA	1
ATGACAGTAG	GAAACACCGGTCCTAGAAGAGGGGTTAGTGCTAGAAATAGCAAGTTAACC	1
GAATTAAAAA	GAAACACCGGTGCTAATAGTTAGCTCGTGGGGTTAGAGCTAGAAATAGCA	1
ACAACCATGC	GAAACACCGGTGTGGTTAGAGCGAGAAGTGGCAGGTTAAGCTAAGGATCG	1
ATCTAACCGA	GAAACACCGGTGTGCGGAGATTATGCGTGAGAAATAGCAAGTAATCTAAG	1
ATCTAAGCAA	GAAACACCGGTTGGGGGGGACTATGCGTGAGAGATAGCGAGAGATCTAAT	1
GCACTCCGTA	GAAACACCGGCGAGAAGGATCAACGGCGGGGGGTTAGAGCTAGAAATAGC	1
AATCGGGCAC	GAAACACCGGTTGCGAGGATCTCGCAGTGGGGGAAATAGCAAAATAACCA	1
AACATGGTGA	GAAACACCGGTTTACGATCATAGGTCGTGGGGTTAGAGCTAGAAATAGCA	1
CAACGAGATT	GAAACACCGGTGGTAGCGGTCTAGAAGTGGGGTAGAAGCAAAAAAAACAA	1
ATGACAGTCG	GAAACACCGGTGTGCGGAGATTATGCGTGAGAAATAACAAGTAACCTAAG	1
AAACCCATGA	GAAACACCGGTTTAGTATGGAGGGAAGGGGGGTTAGAGCTAGAAATAGCA	1
CCAATATATA	GAAACACCGGTGAACCTGGCAACGTCGTGGGATAAGACCTAGTAATATCA	1
CGGTCATCAA	GAAACACCGGTTGGAACTGATCTTTTGGGGGTTGAGAGATAAAAATAGCA	1
TATTTCTTCC	GAAACACCGGTCGCGAAAATGTACAAGTGGGGTTGGGGTAGGAATTAGAA	1
CAATGAGTCT	GAAACACCGGTGGTAGCGGTTTCGAAGTGGGGTTAGAGTTAGAAATAGAA	1
GAATGAGGCG	GAAACACCGGTTATCGCTGCGGCTTTTTGGGGGTTAGAGCTAGAAATAGC	1
AGACAGCAAC	GAAACACCGGTGCTCTTTGCTCTAGGGTGGGGTTAGAGCTAGAAATAGCA	1
GAGATACCCC	GAAACACCGGTTATCTAAAGTCCTTTGTGGGGTTAGAGCTAGAAATAGCA	1
TTATTCTCCC	GATACACCGGTCCTAGAAGCTGAAGAGGGGTTAGAGCTAGAAATAGCAAG	1
ATATCAGACG	GAAACACCGGTTGTAGTAGATGGTGAGTGGGGTTAGAGCTAGAAATAGCA	1
TACACACCGA	GAAACACCGGTTTACTTAGTTAACTCGTGGGGTTAGAGCTAGAAATAACA	1
GAATTAAAAA	GAAACACCGGTGCTAATAGAGCGAGGTAGGGTATAGATCTAGAGATATCA	1
GACTATGTAC	GAAACACCGGTGACAGACGCATGTCAGTGGGGTTAGAGCTAGAAATAGCA	1
CCACGCCACC	GAAACACCGGTAGTAATAGGTAACAGGTGGGGATAGAAAGATAAACAAAA	1
GGCTCAAAAT	GAAACACCGGTGCTAATAGTTACGTAGTGGGGTTAGAGCTAGAAATAGCA	1
TGCACCTCCT	GAAACACCGGTTCTCTTAAGATCGTAAGTGGGATTAGAGCTTGAAACAGC	1
AATGGAGAAA	GAAACACCGGTGAGATTCCTATCGTGGTGGGTGTAGAGATATAAATAAAA	1
AGTCAGCCAA	GAAACACCGGTGTTCTTTGATTCAGGGTGGGGGTAGAGCTAGAAAAAGCA	1
ATCTATCTGA	GAAACACCGGTATTCGGAGCTTACGCGTGAGAAATGACCAATAAACTAAA	1
