TTCTTCTCCC	GAAACACCGGTCGCGAAAATGTGCCGGTGGGGTTAGAGCTAGAAATAGCA	2
GGACGGCAGC	GAAACACCGGGGTACTGCACTCGAGGGTGGGGTTAGATCTAGAAATAGCA	1
AATCCATCAC	GAAACACCGGTGGCTAGAAATAGCAAGTTAACCTAAGGCTGGTCCGTTAT	1
CGGCGGGTTG	GAAACATCGGTCGTCGTTCGTGGGGTTAGAGCTAGAAATAGCAAGTTAAC	1
GTGGGCGAGA	GAAACACCGGTGGAATGCCTCCACGGCTGGGGTTAGCGCTAGAAACTGCA	1
GAGTCTAGAG	GAAACACCGGTTATCGTTACGGATTTGTGGGGTTAGAGCTAGAAATAGCA	1
GTTTGAGAGA	GAAACACCGGTGGTGGTAGACTTGGAGTGGGCAAGCTAACGAGATACCAT	1
GAATTAAAAC	CAAAACACCGGTGCGATTAGTTAGTTTGTGGGGTTAGAGCTAGAAATAGC	1
ATATAACCGA	GAAACACCGGTGTGCGGAGATTATGCGTGAGAAATAGCATGGAACCTAAG	1
ACTTGGGACA	GAAACACCGGTTCTGGGGAAGTCGAGGTAGGAAAAATAAGCAGTTCAAAG	1
ATCTAAAGGA	GAAACACCGGTGTGCGGAGATTATGCGTGGGAATAAACATGGAACCTAAA	1
CCGTCAATGA	GAAACACCGGTTTGTTTTATTGGTTTGTGGGGTTAGAGCTATAAATAGCA	1
AAAACCCTCG	GAAACACCGGTGTTCGGTCATAGGTGGTGGGGTTAGAGCTAGAAATAGCA	1
GGCCATCCAA	GAAACACCGGTACTATTTACTTAAGGGTGGGGTTAGAGCTAGAAATAGCG	1
AATTGGGCAA	GAAACACCGGTTGTGGGGAACTCGGTGTGGGAGAAATAGCAAGTTAACCT	1
TAATTCATAT	GAAACACCGGTGCTGCTAGTACGTTCGTGCTAGTAGTAGTAAGATTAGCT	1
CAACGAGAAT	GAAACACCGGTGTTATTTGCTCGGGAGTGGGGTTAGAGCTAGAAATAGCA	1
GAATCAGCCG	GAAACACCGGTTTTAGTAAATGGTGGGGTTAGAGCTAGAAATAGCAAGTT	1
GAAGTAAAAA	GAAACACCGGTGCTAATAGTTAACTCGTGGGGATAGAGCTAGAAACAGCG	1
GACACTGCCC	GAAACACCGGTTCTCGAAAGCTCCCAGTGGGGTTAGAGCTAGAAATAGCA	1
TATTCACAAA	GAAACACCGGTGTTCCTTGTATCTACGTGTGGTAGAGCTTGAAACTGCAA	1
AATATGCTAG	GAAACACCGGTGTTCGATCCTAGGGCGTGGGGGTAGAGCCAGAAATTGCA	1
CACCACCTCC	GAAACACCGGTAGTCTAAATCTACCGGTGGGGTTAGAGCTAGAAATAGCA	1
AAATGAGATA	GAAACACCGGTTGGGGTAGACCTAGAGAGGGCGAGATAGCCAAAGGCCCT	1
CCCACCCCCC	GAAACACCGGTTGAGCCAGCGCTAGATATCAAATTAACATCTAACTCTTC	1
AGACAGAAAC	GAAACACCGGTGTGGTTAGAGCGAGAAAGAGGATGGTAATCTAAAGAGAG	1
AAACCCATGA	GAAACACCGGTTTAGTATGGGGGGATATAGGTATAAATATCAAAATAACC	1
GTAAACCACC	GAAACACCGGTTTTAAGCGATGGTTTGTGGGGATAGAGCTAGAAATAGCA	1
GCCTAGCAAG	GAAACACCGGTTGAAGCGGGCTCTTTGGGGGGGTAGGGGTTGAAATAGGC	1
ATGACTGCCG	GAAACACCGGTCCTAGAAGTTGAGCTAGAGGTAGAAATAGAGAGTTAGCC	1
AAACAGCAAA	GAAACACCGGTATTCTTTGCTCGAGGGTGGGGTTAGAGCTAGAAATAGCA	1
GTAATATATA	GAAACACCGGTTGGCTTTACTCCGTGGGGTTAGAGCTAGAAATAGCAAGT	1
GTAATATATA	GACACACCGGTTGGCTTTACTCCGTGGGGTTAGAGCTAGAAATAGCAAGT	1
CCCTCACACC	GAAACACCGGTGGCAATTGGTTCTATGTGGGGTTAGAGCTAGAACTAGCA	1
CAACGAGATT	GAAACACCGGTGCTAGCGGTTTCGAAGTGGGGTTAGAGCTAGAAATAGCA	1
GTGGGCGAGA	GAAACGCCGGGTCAGAGCTAGAAATTTCAAGTTAAAGTGCGACTAATCGG	1
TACAAACTCT	GAAACACCGGTGAGGTGATGACGCTCGTGGGGATAGAGCTAGAAATAGCA	1
TTCTTATCCC	GAAACACCGGTCGTAGAAGTGGGCCGGTGGGGTTAGAGCTAGAAATAGCA	1
TAATTAATCC	GCAACACCGGTTGTGATAATCAAAAAGTGGGGTAGAGCTAGAAATAGCAA	1
TCAGCAAAAA	GAAACACCGGTGGGGTTAGAGCTAGAAATAGCAAGTTAACCTAAGGCTAG	1
TAATTAAAAT	GAAACACCGGTCCTCCTAGTTAGCTCGTGGGGTTAGAGCTAGAAATAGCA	1
ACATCAAAAA	GAAACACCGGTGGGCGGAGAGTAAGAAATAGCAAGTTAACCTAAGGTTAG	1
ATCTTATCCC	GAAACACCGGTCGCAAACATGTGCCGGTGGGGTTAGAGCTAGAAATAGCA	1
GTCTTATAAA	GAAACACCGGTGAGAGTTAAGTTCGAGTTAGAAATAGAACGATAAACAAA	1
TAAATACTAC	GAAACACCGGTTTACATAGTTAACTCGTGGGGTTAGAGCTAGAAATAGCA	1
GGATCATCAA	GAAACACCGGTGAGCATAGAGCTTGGTGTAGATCTAGATATAACTAGTAA	1
TGGAGGGTTG	GAAACACCGGTGACCGTACGTCGGGTTAGAGCTAGCAATAGCAAGTTAAC	1
ATACTACATT	GAAACACCGGTTGTAAGCGATGGTTTGTGGGGTTAGAGCTAGAAATAGCA	1
AATTGCGCCA	GAAACACCGGTTGTGGGGAACTCGGTGTGGGGGAAATGGCAAGATAACCT	1
AACCGCTGAC	GAAACACCGGTGGCAAATGCATGCTAGAGGGGGCAGAGCTAGAAATAGCA	1
CATTCACAAA	GAAACACCGGTTGTGGGGAACTCGGTGTGGGAGAAATAGCAAGTTAACCT	1
ACGCTATCAC	GAAACACCGGTGACCTGTGGTCCTTTGTCTGGTTATAGCTATAAATAGCA	1
TAAACCCAAA	GAAACACCGGTTGACTTGTTAACCAAGTGGGTTAAAGCCTAAAATTACCA	1
GAATCAAGCG	GAAACACCGGTTATCGTTACGGATTTGTGGGGTTAGAGCTAGAAATAGCA	1
CTGTAAACAC	GAAACAACGGTGTGCGGTACTCTTTGGTGGGATTAGAGCTATAAATAGAA	1
TAAACGCAAT	GAAACACCGGTTTACTTGGATACGTAGTGGGGGTAAAAGTAAGATAAGCA	1
ATACCACACT	GAAACACCGGTGGGGTTATAGCTAGAAATGGCAAGTTAACCTAAGGCTAG	1
GACATACTGA	GAAACACCGGTAAGCTAAAGATCCCCGTGGGGATAGAGCTAGAAATAGCA	1
ACAACAAGCT	GAAACACCGGTAATCGAAAGGGATTTGTGGGGATAGAGCTAGAAATAGCA	1
CAGCGGGTTG	GAAACACCGGTTTTCGATCGTGGGGTTAGAGCTAGAAATAGCAAGTTAAC	1
GAATTAGAAA	GAAACACCGGTACTAGTTACTTACGGGTGGGGTTAGAGCTAGAAATAGCA	1
CCCTGCCGCC	GAAACACCGGTTGAATGTTCGAGTTTTGTGTAGCTAGATCTCCAAAGAGC	1
CGGTGGCATG	GAAACACCGGTCGTAGTTCGATGTGTTAGTGCTAGAAATAGCAAGTTAAC	1
GTGACCGTCC	GAAACACCGGTAATATAAGGTGCGCCTAGAGCTAGGAACAGCAAGTAGAA	1
CTCCCCCACC	GAAACACCGGTAGTATGCAGTGGCTTGTGGGGTTAGAGCTAGAAATAGCA	1
GAATAAGTAG	GAAACACCGGTTTTAGTAAATGGTGAGTGGGGTTATAGCTAGAAATAGCA	1
TAATCAAAAA	GAAACACCGGTGCTAATAGTTAGAGAGTTGGGTTGTAACCCGAAATAGAA	1
AATTCATCAA	GAAACACCGGTGAGAAAAGAATGTTTTTGGGGCTAAGCTTAGAATTACCA	1
CCGATAACTA	GAAACACCGGTGGGCATGAGATAACCTAGGGGCAGTCGGTTAAAATCGCG	1
TTCTTCTCCC	GAAACACCGGTCGCGAAAATGTACCGGTGGGGTTAAACCAGGAAATGCAA	1
GCCTAGGAAA	GAAACACCGGTTCTACCTACTTATTTGGGGGGGTTAAAGTAGGAATTGCA	1
CGGCGGGTTG	GAAACACCGGTCGTCGTTCGTAGGGCCGTGGGGTTAGAGCTAGAAATAGC	1
TGCACTTCCT	GAAACACCGGTTCCCGTTAGCTCGTGGGGTTAGAGCTAGAAATATCAAGT	1
GACTGCGAGA	GAAACACCGGTTTAGATCACTAAAGAGTGGGGTTAGAGATAGCAATAGCA	1
TAACCCGCTC	GAAACACCGGTCTCGAAAGTGTGGAAGTGGGGTTAGAGCTAGAAATAGCA	1
GTAATATATA	GAAACACCGGTGAGCATGATAACGTTATAGCTATAGATAGCAATCTAACC	1
CGAACCCCAA	GAAACACCGGTTTGATCAGTACGTTATGGGTTTTGAGCCTGAAATAGCCA	1
CCTTTCATAC	GAACACCGGGTGGCTTTACTCCTTTGGGGGGATAGATCTCTAAATAACCA	1
CCCTATGTAA	GAAACACCGGTACTAGTTACGTACAGCTGGGAATAGCAATATAACTAAAG	1
TACACTGCCT	GAAACACCGGTTCCAGTTAGCTCGTCGTGGGGTTAGAGCTAGAAATCGCA	1
ATGATAGAAA	GAAACACCGGTGCTAGGACTCACCTGGTTTCGATCGAGAAATAGCTAGTT	1
ATGACCGCCG	GAAACACCGGTCCTAGAAGCTGAGTTAGGGCTTTATATCGCTAAATACCC	1
ACTACCCTCC	GAAACACCGGTGACGAAAGGATGTCAGAGGGAGTAGAGCTAAGATAAGCA	1
TAGTCCAGCG	GAAACACCGGTTATCGTTACGGATTTGTGGGGTTAGAGCTAGAAATAGCA	1
TCAGCTACCG	GAAACACCGGTGGGGTTAGAGCTAGAGATAGCATGTTAACCTAAGGCTAA	1
GATTATGTAA	GAAACACCGGTACTAGTTACTTACGGGTGGGGTTAGAGTTAGAATTAGCA	1
AATAATGCAG	GAAACACCGGTGCCCTTTATGGGACCGTGTGGTTAGAGCTAGAAATAGCA	1
TCAACCCTCT	GAAACACCGGTTACGCGAGGGTTATTGCTGGAAATAGCACTATAACTTAA	1
TCAACCCTCT	GAAACACCGGTGACGCGAGGACGTTAGAGCTAGATATAACAAGTTAACCT	1
AGACAGCAAC	GAAACACCGGTGTTCTTTGCTCGAGGGTGGGGTTAGAGCTAGAAATAGCA	1
TTCTAACCGT	CTAAACACCGGTTTGCGTAGTTAACGCGTGAGAATTAGCATGTAACCTAC	1
GAATTAACAA	GAAACACCGGTGCTAATAGTTAGCTCGTGGGGTTAGAGCTAGAAATAGCA	1
AACACGCTAG	GAAACACCGGTTTTCGATGATAGCTAGTGGGGTTAGAGCTAGAAATAGCA	1
GACTATGCAA	GAAACACCGGTACTAGGTAACTCTGGGTGGGGGTAGTGCTAAGAAAAGCA	1
AATCCACAAC	GAAACACCGGTGTTATTTGCTCGTGGGTGGGGTTAGAGCTAGAAATAGCA	1
TAATTAATAC	GAAACACCGGTTGAGATAATCAAGAAGTGGGGGAGAGCTAGAAATAGCTA	1
TCGTCTACAC	GAAACACCGGTTCGCCTTACTTACTTGTGGGGTTAGAGCTATAAATAGCA	1
AACAACCTGC	GAAACACCGGTATTCTATGGATGGCCGTGGGGATAGAGCTAGAAATAGCA	1
ATGACCGTCG	GAAACACCGGTCCTAGAAGCTGAGTTTGTGGTGGTAGTGCTAGATATACC	1
CGTCCGCAAC	GAAACACCGGTGTTAATTGCTCGTGGGTGGGGTTAGAGCTAGAAATAGCA	1
TAAAGCCAAC	GAAACACCGGTTGAATGGGTCAACGGGTGGGGTTAGAGCTAGAAATAGCA	1
TGTCCAGATT	GAAACACCGGTCTTCCTGGAATCGTGGGGTAGAGCTAGAAATAGCAAGTT	1
TTCTTCTCCC	GAAACACCGGTCGCGAAAATGTGCCGGTGGGGTTAGAGATCGAAATAGCA	1
ATCAAACCGA	GAAACACCGGTGTGCGGTGATTATGCGTGGGAATAAGCCTGTAAACTAAG	1
ACTAAGGGCT	GAAACACCGGTGGTGGGCGTGGAGGTATAGATGGAAAAAGAAGGTGGGGT	1
TTCTTCTACC	GAAACACCGGTGGCGAACATGCGCCTGTGGGGCTAGAGCTAGAAATAGCA	1
GACATTCCAC	GAAACACCGGTTCGCTTTACCTCTTAGTGGGGTTAGAGCTATAAATAGCA	1
AGAATGTAAA	GAAACACCGGTGTTCTTTGATAGAGGGTGGGGTTAGAGCTAGAAATACAA	1
GAAGCAAGAG	GAAACACCGGTTATCGTTACGGATTAGTGGGGTTAGAGATAGAAATAGAA	1
AGTCCAGATT	GAAACACCGGTCTTAATGGAATGTACGTGGGGTTAGAGCTAGAAATAGCA	1
CCCGCACACC	GAAACACCGGTTCGGCTAGAGCTTTTTGTGGGGATATAACCTAAGGTAGC	1
ATACATCACC	GAAACACCGGTGCTAGGTGCTTGTTGGGGGGGTTAAGGCTAGAAATAGCA	1
GAGCGGGAGA	GAAACACCGGTGAGCGGCCGCAAGGGCTAGGGATAGAGAGATAAACAAAG	1
GCGTCAAACG	GAAACACCGGTTATCGTTGCTCATTTGTGGGGTTAGAGCTAGAAATAGCA	1
AGTCAGCAAC	GAAACACCGGTGTCCTTTCCACGTGGGTGTGGTTAGAGCTAGAAATAGCA	1
CTCTTCTACC	GAAACACCGGTTCAAAAAACGGCTTTGAGGGAGATATAGCTAGAAATACC	1
GTGGGAGCGA	GAAACACCGGGTAGGAGATAGAAATTTTGGGTTAAAAGTAAAAAAAGCAG	1
CATTAACAAA	GAAACACCGGTAATCTAAAGATCCCCGTGGGGATAGAGCTAGAAATAGCA	1
AACATGTCAT	GAAACACCGGTTTTCGATCATAGGTCGTGGGGTTAGAGCTAGAAATAGCA	1
ATCTAACCGA	GAAACACCGGTGTGCGGAGATTCTGCGTGAGAAATAGCAAGTAATCTAAG	1
CATTCACATA	GAAACACCGGTGCCAGTTGGTTCTGAGTGGGGTTAGAGCTAGAAATAGCA	1
CGTTCATCAC	GAAACACAGGTGAGAACAGAACGTTTTGGGGTTAGAGCTAGAAATAGCAA	1
TAATTAATCC	GAAACACCGGTTGAGATAATCAAAAAGTGGGGTAGAGCTAGAAATAGCAA	1
AATTTAACAC	GAAACACCGGTGGGAATTGCTTGTAGGTGGGGTTAGAGCTATAAATAGAA	1
GTAATATATA	GAAACACCGGTGAGCATGATAACGTCCGTGGGGTTAGAGCTAGAAACAGC	1
TTCTTCCCCA	GAAACACCGGTCGCGAAAATGGGGCGGAGGGGTTAAAGCTGGAAATAGCA	1
ATGGGCGAGA	GAAACACCGGTGAGATGACTCACGGTGTTTAGAGCTAGGCATAGAAAGGT	1
GTAATATATA	GAAACACCGGTGGGGATATAGCTATAAATAGCGAGATAGCCTGTTGCTAT	1
CAGTCCCAAA	GAAACGCCGGTTGTGGGGGCTTCGGTGTGGGGGTAATAGTAAGATAAGCT	1
TAGATACAAT	GAAACACCGGTTTACTTAGTTAACTAGTGGGGTTAGAGCTAGAAATAGCA	1
ACCTCGGACG	GAAACACCGGTCCAAAGAGCTTTGTTTGTGGGGTGGTTGCTAGTAATAGT	1
