AGACAGCAAC	GAAACACCGGTGTTCTTTGCTCGAGGGTGGGGTTAGAGCTAGAAATAGCA	3
ATGGCAGACA	GAAACACCGGTGGGGGTAGATCTAGAAATAGTAAGTAAAGCTAAGTATAC	1
AACAGGCTAG	GAAACACCGGTATTCGAACATAGGTCGTGGGGATAGAGCTAGAAATAGCA	1
CCCCGCGGCT	GAAACACCGGTCGCACGGATATCTACGTGGGGTTGAGCCTGGAAATAGAA	1
ATCTAACCGA	GAAACACCGGTGTGCGGAGATTATGCGTGGGAAATAGCAAGTAACCTACG	1
ATGACCGTCG	GAAACACCGGTTTAGTTTGAGCTGTTAGAGGTAGGTTTACCAAGTTAACC	1
AGATCCTCAA	GAAACACCGGTTTACTTAGTTAACTAGTGGGGTTAGAGCTAGAAATAGCA	1
GTGCGGGAGT	GAAACACCGGTGTTCTTCGTCCCCGGGGGGGGATAGCTAGAAAAAGCAAG	1
TCAGCAAAAA	GAGACACCGGTGGGGTTAGAGCTAGAAATAGCAAGTTAACCTAAGGCTAG	1
TGCACTTCCT	GAAACACCGGTGGGGTTAGAGCTAGAAATAGCAAGTTAACCTAAGGCTAG	1
TTATCACACT	GAAACACCGGTTGCGGAGTTGTGTTTGTGGGGGTAGAAGCAAGAAAATCA	1
AATTGGGCAA	GAAACACCTGTTGTGGGGAACTCGGTGTGGGAGAAATAGCAAGTTAACCT	1
TACCGCCACT	GAAACACCGGTTGAATGGATCCACGGGTGGGGTTAGAGGTAGAAATAGCC	1
TCCTGAAAAC	GAAACACCGGTGGCGGTAGTGCGAGAGTTGGCAGGGTGATAGAAAGAGAA	1
TGCACTGATT	GAAACACCGGTCTCCCTTAAATCGACGTGGGGTAAAGCTAAGAATAGGAA	1
CCCCGCCGCC	GAAACACCGGTAGAATGGATCCACGGGTGGGGTTAGAGCTAGAAATAGCA	1
TGACCAGCCT	GAAACGCCGGTTTTCCTGGAATCTACGGGTGGAGGAGCTAGAAGTAGGAT	1
ATCTAACCGA	GAAACACCGGTGTGCGGAGATTATGCGTGAGAAATAGCAAGTAACCTAAG	1
GAATCAGCCT	GAAACACCGGTTTTAGTAAATGGCGAGTGGGGTTAGAGCTAGAAATAGCA	1
CCGAGCAACA	GAAACACCGGTTCGAAATGGCAACTCGGGGGGTTGATATACCAATAGCAA	1
GACAATGTCC	GAAACACCGGTATTAGTAGATTACTGGTGGGGTTAGAGCTAGAAATAGCA	1
ACTCGCCGCC	GAAACACCGGTAGAATGGATCCACGGGTGGGGTTAGAGCTATGAATAGCA	1
GAGGGCGAAA	GAAACACCGGTGGGGTTAGAGCTAGAGATGGCATGTTACTCTAAAGATAG	1
ATGACACACA	GAAACACCGGTGGCAATTCGATCTGAGAGGGGTTAGAGCTAGAAATAGCA	1
TAAACACAAT	GAAACACCGGTTTACTTAGTTACCTTGTGGGGTTAGAGCTAGAAATAGCA	1
TAACCCGAGT	GAAACACCGGTTTACTTGGAATCTTCGTGGGGTTGGACTTGGAATGGCAA	1
ATCTGCCAAT	GAAACACCGGTGTGCGTAGTTTATTCGTGGGAATTAGCAAGTAAACTACA	1
AAATGGGAAA	GAAACACCGGTTGTAGGGAATACGGTGGGGGAGAAGAGGTAGGATAAGCT	1
GTACTGTATC	GAAACACCGGTGGTCATGATCACATAGTTGGGTATAGCTCTAAATATCAC	1
GTCATATACG	GAAACACCGGTGGGAGTCATCCACTTGTGGGAATATAACTTAAGACTGCT	1
ATAATATATA	GAAACACCGGTCGTCGATGGTAGGGATGGGGGTAGAGGTAGGAAAAGGAA	1
TGTCCAGATT	GAAACACCGGTCTTCCTGGAATCTACGTGGGGTAGTGCTAGAAAAAACAA	1
TGCACTTACT	GAAACACCGGTTCCCGTTAGCTGGTAGTGGGCTTAGTGCTAGAAATAGCT	1
CCCTTACACC	GAAACACCGGTTCACCCTGGGACTTTTGTGGTGATAGCTCTAGATAGCGC	1
CCCCGCCGCC	GAAACACCGGCTAGAAATAGCAAGTTAACCTAAGGCTAGTCCGTTATCGA	1
GACTATGTAA	GAAACACCGGTACTGGTTAATTACTGGTGGGGGTAGAAGTAGGAAAAGCA	1
GCCGTTAACA	GAAACACCGGTGGGGTTAGCGCTAGAAATAGCATGTCAACCTAAGGATAG	1
AGACAGCCAC	GAAACACCGGTGTTCTTTACTCGTGGGTGGGGTTAGAGCTAGAAATAGCA	1
TCAAAATTCT	GAAACACCGGTGAGCATGGTAATGTCCCCGGGGGGATAGAGCTAGACAAA	1
AGACAGCAAC	GAAACACCGGTGAGTGGGGTTAGAGCTAGAAATAGCAAGTTAACCTAAGG	1
AACATGCTCG	AGGGCCGAACAACCGGTTGTAGATCTTATGTGGTGGGTTTAGAGCTTAAA	1
GGCCAAGAAA	GAAACACCGGTAGAAGTTGCTAATTGGCGGGGGTAGAGCTAGAAATCACA	1
GAGTCAAGCG	GAAACACCGGTTATCGTTAAGGATTTGTGGGGTTAGAGCTAGAAATAGCA	1
TAATTAATCC	GAAACACCGGTTGCGATAATCAAAAAGTGGGGTAGAGCTAGAAAAAGCAA	1
CACCCACTGA	GAAACACCGGTGGCAATTCGATCTGAGTGGGGTTAGAGCTAGAAATAGCA	1
TACTTAATCC	GAAACACCGGTTATCGTTACCACGTAGTGGGGTTAGAGCTAGAAATAGCA	1
GACTCAGCCC	GAAACACCGGTAATATAAAAATGTCCGTGGGGTTAGAGTTAGAAATAGAA	1
CAAACGGACT	GAAACACCTGTGCTGGCGGTTTCGAAGTGGGGTTAGAGCTAGAAATAGCA	1
TTGCCAGACC	GAAACACCGGTCCTACTGGCATAAAGTGGGGCTTGAGTCAACTATAGAAA	1
CGTCCAGATT	GAAACACCGGTCTTCCTGGAATCTACGTGGGGTAGAGCTAGAAATAGCAA	1
AGACAGCACT	GAAACACTGGTGCCCTTTATTCGACCGTGGGGTTAGAGCTAGAAATAGCA	1
CGATCATCAA	GAAACACCGGTGTTAACAGAACGTGAGGGGGGTAGGAGTTGGAATAAGCA	1
TAATTAGTTC	CTAAACACCGGTCGTCGTTCGTAGGGCGTGTGGTTAGAGCTAGAAATAGC	1
AGTTCATCAA	GAAACACCGGTGAGAACCGAACGTTTTGGGGTTAAGGCTAAAAATAGCAA	1
TAATCATCAA	GAAACACCGGTTTAAATAGATAGTTAGTGGGGTTAGAGCTAGAATAAGAA	1
GCAGGCGCCA	GAAACACCGGTAGGTTGGGTTAGAGGGAGGGGTTAGAGCTAGACATAGCA	1
TAAATAAACT	GAAACACCGGTTGACTTAATTAAATAGTGGGGTTGAGCTAAAAATTAGAA	1
ATACCACACT	GAAACACCGGTTGTAAGCGATGGTTTGTGGGGTTAGAGCTAGAAATAGCA	1
CATTCACAAA	GAAACACCTGTGGCAATTCGATCTGGGTGGGGTTAGAGCTAGAAATAGCA	1
AAACCCATGA	GAAACACCGGTTTAGTATGGGTTTAGTTTAGTGGGGTTAGAGCTAGAAAT	1
GAATAAAAAA	GAAACACCGGTGGTAGTAGCTTGCGGGTGGGCTTGGAGACATAAAGAGCG	1
AGTACATAAA	GAAACACCGGTGAGAATAGTAAGGTCCGTGGGGTGAGATAGAGAAAGCAA	1
GTAATATATA	GAAACACCGGTGAGAATGATAACGTAGCAAGTTAACCTAAGGATAGACCG	1
AAACCCATGA	GAAACACAGGTGTAGGATGAAGGTGAGTGGGGTTAGAGCTAGAAATAGCA	1
AACAAGCAAC	GAAACACCGGTGTTCTATGATAGAGGGTGGGGTTAGAGCTAGAAATAGCA	1
TCAACAATAA	GAAACACCGGTGGCGTTAGAGCTAGAAATATCAAGATAACCTAATACTAG	1
GACAACCTCC	GAAACACCGGTAATCTAAAGATCCCCGTGGGGATAGAGCCAGAAATAGCA	1
CTATGAGATT	GAGACACCGGTGCTAGCGGTTTCGAAGTGGGGTTAGAGCTAGAAATAGCA	1
CCCTCGCACC	GAAACACCGGTTCAACCGGCGTCTTTTGTGGGGTTAGAGCTAGAAATAGC	1
GAAATTACCA	GAAACACCGGTTCTAGTTAGCAGGGAGTGGGGTTAGAGGTAGAACTAACA	1
GCAACAGATT	GAAACACCGGTGAGGCTGGAAACGTCGCGGGAGGGTTAGAGAGAGAAACA	1
GAATTAAAAA	GAAACACCGGTGCTAATAGTTAGCTCGTGGGGTTAGAGCTAGAAATAGCA	1
CGGCTGACAC	GAAACACCGGTGGTCTTTACTCGTTGGTGGGGTTAGAGCTAGAAATAGCA	1
CCGTTAACAC	GAAACACCGGTTGGCTTTACTCCTTTGTGGGGTTAGAGCTATAAATAGCA	1
AATCCTGCCG	GAAACACCGGTGACAAACGTATGACAGGGGGGTTAGAGCTAGAAGTAGCA	1
TCATCTAAAA	GAAACACCGGTGCTGTTTGCGTTAGAAATGGCATGTTAACCTAAATCTAG	1
GTCATAGTAA	GAAACACCGGTACTAGCTTGTTACTAGAGGGGTTAGAGCCAGGAATACCT	1
ACACCCCTGA	GAAACACCGGTGTAGTAAGGAGGGGAGAGGGGTTAGTAGTAGAAATAGCA	1
ATTTATCCGA	GAAACACCGGTGCCCTTTATGGGACCGTGGGGTTAGAGCTAGAAATAGCA	1
CATTCACAAA	GAAACACCGGTTCCCGTTAGCTCGTAGAGGGGTTAGAGCTAGAAATAGCA	1
CATCCATAAC	GAAACGCCGGTGACAAACGTATGTAAAGCGGGGTTGGGGATAGAAATAGC	1
GAGTCAAGCG	GAAACACCGGTTATCGTTACGGATTAGAGCGTGGTGTTAGAGCTAGAAGT	1
TCAGCAAGAA	GAAACACCGGTGGGGTTAGAGCTAGGAATAGCAAGTTAACCTAAGGCTAG	1
CCTTGGCACC	GAAACACCGGTCGTCGCGCCGTCGTTTGGGGCTATAAAGCGCGAGATACC	1
AGACAGCAAC	GAAACACCGGTTGTGTTTGCTCCGGGGTGGGGTTAGTGCTAGGATTAGCA	1
ACTCATCCCG	GAAACACCGGTGGCCTTTATGGGACCGTGGGGTTAGAGCTAGAACTAGCA	1
AAAATAATGA	GAAACACCGGTCTAGGATGGAGGGGGTTGGAGTTAGAATAAGAAAGTCAA	1
ATACCACACG	GAAACACCGGTTGTAAGCGATGGTTTGTGGGGTTAGAGCTAGAAATAGCA	1
AGGCAGCAAC	GAAACACCGGTGTTCTTTGCTCGAGGGTGGGGCTAGAGCTAGAAATAGCA	1
ATCTAACCGA	GAAACACCGGTGTGCGGAGATTATGCGTGGGAAATAGCAAGTAACCTAAG	1
AGACACCAAG	GAAACACCGGTGGCTAGAAATAGCAAGTTAAGCTACGGCTTGTCCGTGCT	1
CAACGAGATG	GAAACACCTGTGCTCGCGGCGTCGATGTTGGGTTAGAGCTAGAAATAGCA	1
CATTCACAAA	GAAACACCGGTGGGGTTAGAGCTAGAAATAGCAAGTTAACCTAAGGCTAG	1
TAATTAAAAA	GAAACACCGGTGCTAATAGTTAGCTAGTGGGGTTAGAGCTAGAAATAGCA	1
