CATTCACAAA	GAAACACCGGTGGCAATTCGATCTGAGTGGGGTTAGAGCTAGAAATAGCA	2
GAAATATATG	GAAACACCGGTTATCAAGTGGGGTTAGAAAAAAAAAAAAAAAAAAAAAAT	1
AAATCCATGA	GAAACACCGGTTTAGTATGGGGGGTTAGAGCTAGAAATAGAAAGTTAACC	1
TCAACACTCT	GAAACACCGGTGACGTGAGGACGGTAGATCTATAAATAGCAAGTTAACCA	1
CGTTCATCAA	GAAACACCGGTGAGAACAGAACGTTTTGGGGTTAGAGCTAGAAATAGCAA	1
CACATGCTAG	GAAACACCGGTTTTCGATCATAGGTCGTGGGGTTAGAGCTGGAAATAGCA	1
TAATCACTCT	GAAACACCGGTGACGCGAGGACGTTAGAGCGAGAAATAGCAAGTTAACCT	1
GCATCAGCCG	GAAACACCGGTGTTAGTAGATGGAGAGTGGGGTTAGAGCTAGAACTCGCA	1
AAACCAATCC	GAAACACCGGTTTTGTATGGGGGGAAAGTGGTGTTAGAGCTAGAACTAGC	1
TAACCCCTAT	GAAACACCGGTTTAGTTAGTTAACTAGAGGGCTTGAAGCTACAAATTGCC	1
TGCACTTCCT	GAAACACCGGTTCCCGTTAGCTCGTAAGGGGGGTCAGAGCTAGAAATAGC	1
TACTCCATAA	GAAACACCGGTACAAGTTGCTTAGGAGTGGGGTTAGAGCTGGAAATAGCA	1
CACATGCTTG	GAAACACCGGTCTTCGATCGTAGGGCGAGGGGTAGAAGTAGGAAGTAAAC	1
AACATGCTAG	GAAACACCGGTTTTCGATCATAGGTTAGAGCTAGAAATAGCTAGTCTACC	1
AATTAACAAC	GAAACACCGGTTGCAATTCCATGTGGGTGGGGTTAGAGCTAGAAATAGCA	1
TGTCCCGATT	GAAACACCGGTCTTGCTTGGATCTAGAGATGGCATGTTACTCTAAGTCTC	1
TGAATATAAA	GAAACACCGGTCTTCGTTCGTAGAGGGGGGGTTAGGGCTTGAAATAGCAA	1
AGACAGCAAC	GAAACACCGGTGTTCTTTGCTCGAGGGTGGGGTTAGAGCTAGAAATAGCA	1
GCAACCTACT	GAAACACCGGTGACGCGGGGATTAGAGCTAGAAATAGCAAGTTAACGTAA	1
GACTACTCCC	GAAACACCGGCACGCTAATGATCCCGGGGGGTTTGTACTTGGAATTACCA	1
AATAATTCTG	GAAACACCGGTGCCCTTTATGGAACCGTGGGGTTAGAGCTAGAAATAGCA	1
CGATTATCTA	GAAACACCGGTGAGCATGGTAACGGAGCAAGCTAACCTAAGCCTAGTCCG	1
AATTTGGCAA	GAAACACCGGTTGTGGGGAACTCGGTGTGGGAGAAATAGCAAGTTAACCT	1
CGGCGGGATG	GAAACACCGGTCGTCTGTCGTGGGGTTAGGGCAAGACAAGGCAAGTTAAC	1
GACTTTGAAA	GAAACACCGGTGCTAGTTGCTAGCTCGTGGGGTTAGAGCTAGAAATAGCA	1
AGTCCATAAC	GAAACACCGGTGACCATCGTATGTCAGTGGGGTTAGAGCTAGAAATAGCA	1
CATCGACAAT	GAAACACCGGTGGCAATTGGTTCTGAGTGGGGTTAGAGCTAGAAATAGCA	1
GGGATATATA	GAAACACCGGTCGTCGTTCGTAGGGGTGGGGTTAGAGCTAGCAAGAGCAA	1
CCGTTAACAC	GAAACACCGGTCGCGATAATTTTACTGTGGGGTTAGAGCTAGAAATAGCA	1
CCCCCCCGCG	GAAACACCGGTTATACGATATCTAGAGTTGGGTTTAGCCAGTTAACATCA	1
GGAACTTCAA	GAAACACCGGTGCTAATAGGTAGGTAGTGGGGTTAGAGCTAGAAATAGCA	1
TGATTAAATT	GAAACACCGGTCTTCCTGGAATCTACGTGGGGTAGAGCTAGAAATAGCAA	1
TTCTTCTCCC	GAAACACCGGTCGCGAAAATGTGCCGGTGGGGTTAGAGCTAGAAATAGCA	1
AGTCGGGCAA	GAAACACCGGTTGTGGTGCACTCGGTGTGGGATAGATAGCAAGTTAAACT	1
CATTCACAAA	GAAACACCGGTGCTAATAGTTAGCTCGTGGGGTTAGAGCTAGAAATAGCA	1
GTAATATATA	GAAACACCGGTGAGCATGATAACGTCGTGGGGTTAGAGCTAGAAATAGCA	1
GACAAAGTTT	GAAACACCGGTAATCTAAGGATCCCCGTGGGGATAGAGCTAGAAATAGCA	1
TAATGAATCA	GAAACACCTGTTGTGATTGTGGGGTAGAGCGAGATATAGCAAGTTAACCT	1
AAACCCATGA	GAAACACCGGTTTAGTATGTGGGGTTAGAGCTAGAAATAGCAAGTTAACC	1
AACTTGGTAG	GAAACACCGGTTCTAGATACTAGCGGGTGGGGTTAGAGCTAGAAATAGCA	1
CGGCGATATA	GAAACACCGGTCGTCATTCGCGGGGATAGGGATAGTAATCGCAAGCTAAC	1
CAACCAGATT	GAAACACCGGTGTTAGCGGTTTCGAAGTGGGGTTAGAGCTAGAAATAGCA	1
CCACGAGCTT	GAAACACCGGTGCTCGCGGTTTCGAAGTGGGGTTAGAGATAGAAATAGCA	1
TTCTTATCAC	GAAACACCGGTCGCGAAAATGTGCCGGTGGGGTTAGAGCTAGAAATAGCA	1
GATAGCGACG	GAAACACCGGTGACATTTCTCAAGCGCTGGGGATAGCGCTAGAAACAGAA	1
TTGTTAACAC	GAAACACCGGTCGCCTTAATTCCCTGGTGGGGTTAGAGCTAGAAATAGCA	1
ATCTAACCGT	GAAACACCGGTGCGCGGTGGTTCGGAGTGGGGTTAGAGCTAGAAATAGAA	1
AAATTACTCC	GAAACACCGGTTGAGATAGTGGGGTAGAGCTAGAAATAGCAAGTTAACCT	1
ATTATCGAAC	GAAACACCGGTGACAAACCTCAGGTGGTGGGACTAGAACGATAAACAAAG	1
CGTTCATCAA	GAAACACCGGCGAGAACAGAACGTTTTGGGGTTAGAGCTAGAAATAGCAA	1
TGTCCAGATT	GAAACACCGGTCTTCCTGGAATCGTGGGGTAGAGCTAGAAATAGCAAGTT	1
CCCCGCCGCC	GAAACACCGCGGGGTTAGAGCCAGAAATAGCAAGTTAACCAAAAGCAAGG	1
AAAGGAGAAA	GAAACACCGGTTGGGAGCGAGCTAGAGTGGGCAAATTAACATAAGAATCT	1
GAACCAGCCT	GAAACACCGGTTTTAGGAAATGGCGGGGGTAGATCAAGAAATAGCAAGTT	1
GGCTATGTAA	GCAACACCGGTAAGAATTAAATCATGTTGGGGTTAAAGCTAGAAATATAA	1
GTAATATATA	GAAACACCTGTCAGCACGCGGGGGTAGAGGTAGTAATACCAAGTTAAGCT	1
AAACCCAAGA	GAAACACCGGTTTAGTAAGGTGGGAAAGGGGGGTTAAAGCAAGAATAAGC	1
ATATCACCCT	GAAACACCGGTGGGAAGCGATTGTTTGTGGGGTTTAGCCTGGAAATAGAA	1
TAATTAATCC	GAAACACCGGTTGTGGTAATCTGGGAGTGGGGTAAAGACTAAGATAACCA	1
GTAATATATA	GAAACACCGGTGACCATCGTAACGTAGCGGGTTTAGATGTAGCAATAGCA	1
TAATTAATCC	GAAACACCGGTTGTGATAGTTGGGTAGAGCTAGAAATACCAAGTTAACCT	1
CGGCGGGTTG	GAAGCACCGGTCGTCGTTCGTAGTGTTGGGGGGTTAGAGCTAGAAATAGC	1
TAATTTTTCC	GAAACACCGGTTGCGGTTGTGGGGTAGTGGTGGTAAAAGCAAGTTTACCT	1
GGTACAGATA	GAAACACCGGTCGTCCTGGAATGTACGTGGGGTAGAGCTAGAAATAGCAA	1
CAACGACATT	GAAACACCGGTGCTAGCGGTTTCGAAGTGGGGTTAGAGCTAGAAATAGCA	1
TAAATAATCC	GAAACACCGGTTGGGATGATCAAAACGAGAGATAGAGCTAGAAATAACAA	1
GAAGGCGATA	GAAACACCGGTGAGATGGGAATCGCAGGGGGGTTAGAGCCAGAAATAGCA	1
TGTCCAGATT	GAAACACCGGTCTTCCTGGAATCTACGTGGGGTAGAGCTAGAAATAGCAA	1
GAATTAAAAA	GAAACACCGGTGCTCATAGTTAGCTCGTGGGGTTAGAGCTAGAAATAGCA	1
ATCTATCCAA	GAAACACCGGTGTTCTTTGCTTATGGGTGGGGTTAGAGCTAGAAATAGCA	1
GCATTAAAAA	GAAACACCGGTGCTAGTAGATCTCGAGAGGGGTTGGAAATCGAAATCGCA	1
AATTCACCAA	GAAACACCGGTGACAATTGGGGCTAAGTGGGGTTAGAGCTAGAAATAGCA	1
AACATACTAA	GAAACACCGGTGATAGATCTTTGCGCGTGGGGTTAGAGCTAGAAATAGCA	1
AAGCCAGAGA	GAAACACCGGTGACGAGCTTATCTCAGTAGGGTTAGAGCTAGAAATAGCA	1
TAAGCAACAA	GAAACACCGGTGCGCTTTGTGCTACCGTGGGGTTAGAGCTATAAGTATAA	1
GACAACCTCC	GAAACACCTGTAATCTAAAGATCCCCGTGGGGATAGAGCTAGAAATATCA	1
TATTTATATC	GAAACACCGGTTGCGAAAATTCGATAGTGGGAAGAGCTCTAAATAGAACT	1
GTACTATATA	GAAACACCGGTCGTCATTGGTAGGGGGTGGGGTTAAGGCAAGAAAAAGAA	1
CCGTTGAAAC	GAAACACCGGTGTTCTTTGCTCTTGTGTGGGGTTAGAGCTATAAATAGCA	1
TGCACTTCCT	GAAACACCGGTTCCCGTCCGCTCGTAGTGGGGTTAGAGCTAGAAATAGCA	1
AATACATCAC	GAAACACCGGTGACAAACGTTTGTCTAGTGGTGTTAATACTAGAATAAGC	1
ATCTCCCCGA	GAAACACCGGTGTGCGGAGATTATGCGGGGGAAGTAGCAAGAAGCCTAAG	1
CGTCCATCAA	GAAACACCGGTCATACTGGAATCAGAGCGGGATATAGAGAGAGATCTCAA	1
TCGGTGGGAC	GAAACACCGGTTGTAGCTCGTGGGGTTAGAGGTAGAAATAGAAAGATAAC	1
GACTTTCTAA	GAAACACCGGTTCTCGTTCATCGGTCGTGGGGTTAGAGCTAGAAATAGCA	1
ACGTTCATCA	GAAACACCGGTTGGCTCTGCTCCTTTTGGGGTTTAAGGTTGTAATAGCCA	1
AATCGACCAC	GAAACACCGGTGACCAATGGATGGCTGAGAGCTAGAAAGTCCAAATTAAA	1
TATAGCCAAT	GAAACACCGGTTTTGGTGAATACCTTGTGGGATTAATGCTAAGTTAACCA	1
