TCATCATCAA	GAAACACCGTGGGGTAAGAGGGGGAAATACTAGATATAGCTAAGTAACCT	1	bc
CGCCCACGAA	GAAACACCGTCAGAATGGAACCACGGGTAGCAACTTATCTAGAAGTAAGC	1	bc
ATCTCACCCG	GAAACACCGGTGATCGTTACGGATTTTGTGGGGATAGAGCTAAACATAGC	1	bc
CACTGTGTCA	GAAACACCGGTAGAATTGATCTACGGGTGGGATTAGAGCTAGAAATAGCA	1	bc
GAATAAGCAA	GAAACACCGGTATTAGTTACTTACGGGTGGGGTTAGAGCTAGAAATAGCA	1	bc
TGCTAACCTT	GAAACACCGGTCTGCCTGGAATCTACGGTGGGGATAAGCAAGAAATTACA	1	bc
ATTATGGCAA	GAAGCACCGGTGGTGGGGAAATCGCAGTGGAAGATATAGCAAGTCAGCTT	1	bc
AGACCATCAA	GAAACACCGGGTGGATAGGGTGAGAAATAGCAAGATAACTTAAGATAACA	1	bc
ATTACCTCCC	GAAACACCGGTCCTAGAAGCTGAGTTAGAAGAGGGGATAGAGCTAGAAAT	1	bc
CGCACGCACT	GAAACACCGGTTCAACCGAGGTCGTGATGCGGTGGGAGGGTTAGAGCTAG	1	bc
GCAATCCGCC	GAAACACCGGTGGAATGGATCCGGGGGTGGGGTTAGAGCTAGAAATAGCA	1	bc
ATGTCCGTAA	GAAACACCGGTCCTAGAAGCTGAGTTATAGGTGGGGATAGAGATAGAAAT	1	bc
GAATATGTCT	GAAACACCGGTACTAGTTACTTACGGGTGGGGTTAGAGCTAGAAATAGCA	1	bc
CGACGGGAAG	GAAACACCGGTCGTCGTTCGTATGGAAGTAGGGATAGAACTAGAAATAGC	1	bc
CCAGCCAAAC	GAAACACCGGTGGAATTAGTGCTAGAGATGGGATAGAGATAGAAATAGCA	1	bc
AGCCGGCGCC	GAAACACCGGTGTTCTTGATCCGCGGGTGGGGTTAGAGCTAGAAATAGCA	1	bc
CACCGACACC	GAAACACCGGTAGAAGGGATCCACGTGTGGGGCTAGAGCTAGAAATAGCA	1	bc
ATACCGATCT	GAAACACCGGTTGTAAGCGGTGGTTTGTGGAGTTAGAGCTAGAACTAGCA	1	bc
GCAACATACA	GAAACACCGGTTCGCATGATAACATCAAGCAATAGCAAGTTAACCTATAA	1	bc
TAAACTGAAA	GAAACACCGGTATTCTTAATTAACTAGTGGGGTTAGAGCTAGAAATAGCA	1	bc
ATATAAAAGA	GAAACACCGGTGCGAAGAGATAATGCGTGGGGATTAAGAAATAAACTAAA	1	bc
GGACAACCCG	GAAACACCGGTTTTCTATTCGGGATAGAGCTAGTAATAGCAAGTTAACCT	1	bc
GTAACATCCA	GAAACACCGGTGAGCATGATCATAGCAAGAAATAGCAAGTTAACCTATAA	1	bc
TAAATCTTCC	GAAACACCGGTAGAGCTAGAAATAGCAAGTTAACCTAAGGCTAGTCCGTT	1	bc
GTCTTTTTTA	GAAACACCGGTAATAATTATTTGCGGGTGGGGTTAGAGCTAGAAATAGCA	1	bc
TAAAATGAAA	GAAACACCGGTTTAATTAGTTAACTAGTGGGGTTAGAGCTAGAAATAGCA	1	bc
GATAAGGTAA	GAAACACCGGTAATGTGGAGATCGGCGTGGGAGAAGTAGCAAGTAAACCT	1	bc
TGTCATGATA	GAAACACCGGTATTCGTGACATCTGACGGGGGGTAGAGCTAGAAATAGCA	1	bc
TCATATGTAA	GAAACACCGGTACTAGGTACTTACGGGTGGGGTTAGAGCTAGAAATAGCA	1	bc
CACTGAGGCG	GAAACACCGGTTTTAAAGTGGGGCTAGAGCTAGAAATAGCAAGATAACCT	1	bc
CTACCAAACC	GAAACACCGGTTGTCAGCGATGGTTTGTGTGGTTAGAGCTAGAAATCGCA	1	bc
TACTCAATAA	GAAACACCGGTACTAGTTACTTACGGGAGAGGATAGAGCTAGAAATAGCA	1	bc
GAGAGAATTA	GAAACACCGGTTGTCATGAAAATATCATTAATTTGCATTTCAACCTATAA	1	bc
TGATTGAAAC	GAAACACCGGTTGGTTCTGTCCGAGGGTGGGGTTACACTTAGAATTGGCA	1	bc
CGACTAACAC	GAAACACCGGTGTTCTTTACTCGTGGGGCTAGATATATCTAGCTATAGTA	1	bc
GATTCAGTAA	GAAACACCGGTACTAGATACTTACGGGTGGGGTTAGAGCTAGAAATAGCA	1	bc
AAACTAATGC	GAAACACCGGTTGAGTTTGTAAGAAAGTGGGGTTGGACTTGGAATTGCCA	1	bc
GACTAACCAA	GAAACACCGGTGTGAGGAGCTTATGGGTGGGAAATAGCCAGTAACCTAAG	1	bc
GAGCGCCGCG	GAAACACCGGTTAAAGTGATCGACTGGTTAGGGCTAGAGATAGCAATATA	1	bc
CTACTATCCC	GAAACACCGGTGGCGGAAATGTGCCGGTGGGGTTAGAGCTAGAAATAGCA	1	bc
AGGACTGCCT	GAAACACCGGTCCTAGAAGCTGAGTTAGAAGTGGGGTTAGAGTTAGAAAT	1	bc
TTCTTATCAA	GAAACACCGGTCGCGAAAATGTGCCGGTGGGGTTAGAGCTAGAAATAGCA	1	bc
ACGTTGGCAC	GAAACACCGGTTGTGGTGAACTCGGTGTGGGTGAAAAAGCAAGTTAACCT	1	bc
GAACAGGCCC	GAAACACCGGTGTTCTTTACTCGAGGGTGGGGTTAGAGCTAGAAATAGCA	1	bc
ATCACTGCCT	GAAACACCGGTCCTAGAAGCTGTGTTAGAAGTGGGGTTATAGCTAGAAAT	1	bc
TCGTCAGCCC	GAAACACCGGTTTTAAAGTGGGGTTAGAGCTAGAAATAGAAAGTTAACCT	1	bc
TAATTACACT	GAAACACCGGTTTAATTAGTTAAATAGTGGGGTTAGGGCTAGAATTGGAA	1	bc
CAGCCAATTG	GAAACACCGGTTATCGTTACGGATTTTGAGGGGTTAGAGCTAGAAATAGC	1	bc
ACACGTCAAC	GAAACACCGGTATTATTGACCCACGGGTGGGGTTAGAGCTAGAAATAGCA	1	bc
CCTCGAGCCC	GAAACACCGGTAGTATGGATCTACGGGTGGGGTTAGAGCTAGAAATACCA	1	bc
ATACGACTCC	GAAACACCGGTTGTAAGAGATGGTTTGTGGGGTTAGAGTTAGAAAGAGCA	1	bc
TCAGCAATCC	GAAACACCGGTGGGGCTAGAGCTAGAAATAGCAAGTAAACCTAGGGCGTT	1	bc
ACCTCGCCCA	GAAACACCGGTTCAACCTGCGTCTTGAGCCGGGGGAGGGGTTAAAACTAG	1	bc
CCCCCCCCCT	GAAACACCGGTAGACTGGATCCACGGGTGGGGTTAGAGCTAGAAATAGCA	1	bc
GAGCGAGGTT	GAAACACCGGTTCTAGCGGCTTCGTTTGGGGGTTAGAGCTTGAAATAGCA	1	bc
CCACCCATGC	GAAACACCGGTTTAGTATGGAGGGTTAGGGAGTTAGAGCTAGAAATAGCA	1	bc
CAGTTCATAC	GAAACACCGGTTGGCTTTACTCCTTTAGCTATATATAGCAAGATAAACTA	1	bc
AATTACGCCC	GAAACACCGGTTGTGTAAAGCTCGCCGTGGGGAAAAAGCCAGGTTAACCT	1	bc
GAAAGAGATA	GAAACACCGGTTTCGGTGGGGTTAGAGCTAGAAATAGCAAGTAAACCTAA	1	bc
GTACATCAAC	GAAACACCGGTGATCTTTACTAGAGGTTGAGATAAGAGCTAGAAATAGCG	1	bc
TAAAACGATT	ACCGGCCGCAACACCGGTCTCCCTGGATTATAACGTTGGTTAGAGCTAGC	1	bc
ATATAACAAA	GAAACACCGGTGTGCGTTGCTTATGCGTGGGGAATGACATGTAAACTGCA	1	bc
ATGACAGTAA	GACACACCGGTCCTGGAAGCTGAGTTATAAGAGGTGATAGGGCTAGAAAT	1	bc
GACGCCAACC	GAAACACCGGTAATCTTAGGACTCCCGATGGGATAGTGCTAGAAAGAGCA	1	bc
CATTACCGTC	GAAACACCGGTCCTAGTAGCTGAGTTAGTGGGTTTAGAGCTGGAATTAGC	1	bc
TAAATATATC	GAAACACCGGTGAGCATGATAATAGCAAGAAATAGCAAGTTAACCTATAA	1	bc
TTCCTCGACC	GAAACACCGGTCTTGCTGGAGTCTAACGTGGGGTAGAGCTAGAAATAGCA	1	bc
GACCAGGAAC	GAAACACCGGTACTATGTACTCGCGGGTGGGGTTAGAGCTAGAAATAGCA	1	bc
AGACCACATC	GAAACACCGGTGTTCTTTGCTCGTGGGGGGGGTTAGAGCTAGAAATAGCA	1	bc
CAATTAGAAT	GAAACACCGGTGCTAGCGGTTACGTCGTGGGGTTAGAGCTAGAAATAGCA	1	bc
GTATCAAGCA	GAAACACCGGTCCTAGTAGCTGGCTCTTGTGGGGATAGAGCTAGATATCA	1	bc
GAATTGTCAA	GAAACACCGGTTGTGGGGAACTCGGCGTGGGAGAAATAGCAAGTTAACCT	1	bc
TGTCCACAAC	GAAACACCGGTGTTCTTGGCATCTGAGTGGGGGTAGAGCTAGAAATAGCA	1	bc
CATTCGGCCA	GAAACACCGGTTGAGGCGAACTCGTGGTGGGGGGAAGAGCAAGTTAACCT	1	bc
CCCCGACGAA	GAAACACCGGTAGAATGGATCCACGGGTGGGGTGAGAGCTTAACATAACA	1	bc
AGAAGGCCCC	GAAACACCGGTGTTCTTTGCTCGAGGGTGGGGTTAGAGCTAGAAATAGCA	1	bc
CCATGAAAAT	GACACACCGGTGCGCGCTACTTATTAAGGTGGATATAGACAGAAAAAGTA	1	bc
GCGAAAATAC	GAAACACCGGTAAGCTAAAGATCTATAGGGGGATATAGCTAGAAATACCA	1	bc
AAGTCGAGAA	GAAACACCGGTTATCGTTACGGATTTTGGGGGGTTAGAGCTAGAAATAGC	1	bc
GAACGAGCTG	GAAACACCGGTGCTAGCGGAGTCGATGTGCCGTTAGAGCGAGAAATAGCA	1	bc
AAAAGGGATA	GAAACACCGGTTGTGGGGGATTCGAAGTGGGGTTAGAGCTAAATAAAGCA	1	bc
GGCCCTGAAA	GAAACACCGGTCCTAGTGACTTCCAGAAATAGCTAGAGAACCTAAGGCCA	1	bc
ATCTTAACGC	GAAACACCGGTGTGCGGAGCTTCTGCGTGAGAAATAGCCAGTAAACTCTG	1	bc
CGCCACCACC	GAAACACCGGTAGAATGTATCCACGGGTGGGGTTAGAGCTAGAAATAGCA	1	bc
AATTCGTCCA	GAAACACCGGTTGTCGGGAGCTCGGTGAGGGCGAGATAGCGCGATATACT	1	bc
GCCAATGTCA	GAAACACCGGTACTAGTTACTTACGGGTGGGGTTAGAGCTCGAAATAGAA	1	bc
AATAACGTCC	GAAACACCGGTAATCTAAAGAGCCCCGTGGGGATAGAGCTAGAAATAGCA	1	bc
CCACTACACT	CAAAACACCGGTTGTAAGCGATGGTTTGTGGGGTTAGAGCTAGAAATAGC	1	bc
CAGCGAGCAT	GGAACACCGGTGGGAGCGACTTCGAAATCTGTATATAGCTAGAAATAGCA	1	bc
GGAACATCTA	GAGACACCGGTGAGCATGATAATAGAAAAAAATAGCAAGCTAACCTATAA	1	bc
CCGACAACAG	GAAACACCGGTCCTAGTAGCTGCGTTAGCAGTGGGGATAGAGCTAGACAT	1	bc
GTATTATCCC	GAAACACCGGTTATCATGATGATTTTTGGGGGTTTAAAGTTAAAATATCA	1	bc
TCACAGCTCT	GAAACACCGGTGATGCGTGCTCGGGGGTGGGGTTAGAGCTAGAAATAGCA	1	bc
CAATGAGCTA	GAAACACCGGTGCTATAGGTTTCGAAGTAGGATAGAGCTCGAAATCGAAA	1	bc
