AACAGGTCAA	GAAACACCGGTTGTGGTGAACTCGGTGTGGGAGAAATAGCAAGTTAACCT	1	bc
AAAACGCTCT	GATAGAAATAGTATCGAAAACTAATCATAGGGCGATAGCAACTTGTAGCA	1	bc
AACCCCGTTA	GAAACACCGGTTTAGTATGTTAGTGGGTTTGGAGCTAGCAATAACGAGTT	1	bc
AGTCCCGTTT	GAAACACCGGTTTAGTATGGAAGTGGGGTTAGAGCTAGAAATAGCAAGTT	1	bc
TTACTCCCCT	GAAACACCGGTCGCGAGAGTTTGCCTGTGGGGTTAGAGCTAGAAATAGCA	1	bc
AGACCTTCCT	GAAACACCGGTTGCCGGCGGCGGTTTGTGGGGTTAGAGCTAGAAATAGCA	1	bc
GCAGCATATA	GAAACACCGGTGAGGATAGTGAGAGAAATAAATAGCTAGCTAACCTATGG	1	bc
CAGCCAACAC	GAAACACCGGTTGCCTTTACTCCTTAAGGTGTAAATAGCAAGAGAACCTA	1	bc
GAAAAACTCA	GAAACACCGGTAATCTAAAGATTCCCGAGGGGATAGAGACAGAAGGAGAA	1	bc
ACTTGGACAC	GAAACACCGGTTGTGTGGACCTCGGTGTGGGTGAAATACCAAGTTAACCT	1	bc
TCCCCTCCCT	GAAACACCGGTTCAATGGGGGTAAAGCTTGAAATAACAAAGTAACCTTAA	1	bc
GCATTACTAA	GAAACACCGGTGCTAATAGTTAGCTCGTGGGGTTAGAGCTAGAAATAGCA	1	bc
AACCCCTCCT	GAAACACCGGTTCCGGTTGGCTCGAAGTGGGGTTAGAGCTAGAAATAGCA	1	bc
GGAAGGTATT	GAAACACCGGTCGTCGTTCGTAGGGCGTGGGGTTAGAGCTAGAAATAGCA	1	bc
ATAGCACAAA	GAAACACCGGTGGGGATAGAGGTAGAAATAGCAAGCTAACCTAAGTCTAA	1	bc
GAGATAAGTT	GAAACACCGGTTATCGTTACGGATTTTGTGGGGTTAGAGCTAGAAATAGC	1	bc
ACCTCGCAAA	GAAACACCGGTTCAACCGGCGTCTTGAACCGGTGGGGGGGTTAGAGCTAG	1	bc
GAGCGGGTCG	GAAACACCGGTCGTCGTTCGTGGGGCGTGGGGGTAGAGCTAGGAATAGCA	1	bc
AAACCAGATC	GAAACACCGGTGTAGGAGGGAAGAGGGGTTAGAGCAAGAAATAGAAAGAA	1	bc
ACTTGGAAAA	GAAACACCGGTTGTGGGGAACTCGGAGAGGGCGAAATAGCCAGTTAACCT	1	bc
TCAACTTCCA	CAAAACACCGGTTCCCGTAAACTTGTAAATAGCATGTAACTCTAAGTCTA	1	bc
TGACCGATAA	GAAACACCGGTCGTGGTTGGTAGGGAGTGGGGTTAGAGCTAGAAATAGCA	1	bc
AAATTGGGTA	GAAACACCGGTTGTGGGGAACTCGGTGTGGGAGAAATAGCAAGTTAACCT	1	bc
ATCACTGCCT	GAAACACCGGGTCTAGATATAGAAATAGGAGGTTAACGCTAGGAAAAGCA	1	bc
AGCCGGCTAC	GAAACACCGGTGTTCTATGCTCGGGGGTGGGGTTAGAGCTAGAAATAGCA	1	bc
TCCCCCAGCC	GAAACACCGGTAGAGTGGGGGCAGAGCTAGAAATAGTAAGCTAACGCTAG	1	bc
ATATGACACA	GAAACACCGGTTGTAAGCGATGGGTTGTGGGGTTAGTGCTAGAAATAGCA	1	bc
AACTAACACC	GAAACACCGGTAGTAAGCACTTGCGTGTGGGGTTAGAGCTAGAAATAGCA	1	bc
AAACGAGTTG	GAAACACCGGTTCTAGCGGATTCGAAGTGGGGTTAGAGCTAGAAATAGCA	1	bc
TTCTACGCCA	GAAACACCGGTACTAAATACTTACGGGTGGGGTTAGAGCTAGAAATAGCA	1	bc
ACGATCGCCC	GAAACACCGGTTGGATTGTCTCCTCTAGCTTTAAAATACAAGTTAACCTA	1	bc
TCGTCAACAA	GAAACACCGGTTGGGTTAACTCCTGTAGCTGTAAATAGCAAGATAACCTA	1	bc
TCCGTCAACA	GAAACACCGGCAGGCTTTACTCCTTTAGCTATAAATAGCAAGTTAACCTA	1	bc
AATTCGGCTT	GAAACACCGGTTGTGGTGAACTCGGTGGGGGGGAAATAGCAGGTTAACCT	1	bc
TTTCCCTCAC	GAAACACCGGTCGCGAAAATGCGGGGATGAAGCTCGGAAGAGCAAGCAAA	1	bc
TTCCGAGCTT	GAAACACCGGTGCCAGCGGTTTCGCAGTGGGGTTAGAGCTAGAAATAGCA	1	bc
ATCACCCACC	GAAACACCGGTTGTCTGAGATGGTTTGTTGGGTTAGAGCTAGAAATAGCA	1	bc
TGCACTCTCG	GAAACACCGGTTCTCGTTCGCTCGTAGTGGGGTTAGAGCTAGAGATAGCA	1	bc
CGCCGGCTTC	GAAACACCGGTCGTCGTTCGTAGGGCGTGGGGTTAGAGCTAGAAATAGCA	1	bc
ATAATATTTG	GAAACACCGGTGATCATTAGTAGAGCTAGAAATAGCAAGTTAAAGTAAAA	1	bc
ATACCCGTCT	GAAACACCGGTCCTAGAAGCTGTGGGGGTGGGGTTAGAGCTAGAAATAGC	1	bc
AACTTGCTCC	GAAACACCGGTTTTCGATCATAGGACGTGGGGTTAGAGTTAGAAATAGCA	1	bc
ATACAATATC	GAAACACCGGTGAGCATGGCTAGAGCTAGAAATAGCAGGTTAACCTAACG	1	bc
AACACCCTAA	GAAACACCGGTTTAGTATGGAAGTGGGGTTAGAGATAGAAATAGCAAGTT	1	bc
GAACCAAGGA	GAAACACCGGTTAAGGATGGAGGTGGGGTTAGAGCTAGAAGAGGAATGTT	1	bc
GAAACTGTCG	GAAACACCGGTCCTAGAAGCTTAGGGGGGGGGGTAAGGGCTGGAAAAAGC	1	bc
AAAAGTGTAT	GAAACACGGGGGGAAGAGGAGAGGTAGTGGGGTTAGAGCTAGAAATAGCA	1	bc
CTATTACATA	GAAACACCGGTGGGAATGCTTAGAGAGTGAAATAAGAAGTAGAAATAGCG	1	bc
TCGACCACAT	GAAACACCGGTTTGCTTAATTCCCTTAGCGAGATATAGCTAGTTAACGCA	1	bc
AGACTAATAC	GAAACACCGGTGTTCTTAGCTCGAGGGTGGGGTAACGCTTAGAAATAGCA	1	bc
AGTTAGCCAA	GAAACACCGGTTGTGGGGAACTCGGTGTGGGAGTAATAGCAAGTTAACCT	1	bc
GACTTTGATA	GAAACACCGGTACTAGTGACTTACGGGTGGGGTAGCAGCTAGAACTAGCA	1	bc
GAACCCGTAA	GAAACACCGGTATTAGATGGTAATGGGGGTGGAGCTAGAAATAACAAGTT	1	bc
AAACCACCAT	GAAACACCGGTTGTAAGCGATGGTTAGTGGGGTTAGAGCTAGAAATAGCA	1	bc
ATGCCCGTAA	GCATCACCGGTACTAGAAGCTGTTAGGTTGGGGTTAGAGCTAGAAATAGC	1	bc
GAGTCACGAA	GAAACACCGGTTATAGTTACGGCTTTTGGGGGGTTAGAGCTAGAAATAGA	1	bc
AGACCAGAAT	GAAACACCGGTGTTCTTTGCTCGAGGGTGGGGGTAGAGCTAGAAATAGCA	1	bc
CACAAGCACC	GAAACACCGGTTCAAATGGCATCTTGGTGGGGTTAGAGGTAGAGATAGAA	1	bc
AGCTATTCGT	GAAACACCGGTTTCCGTTGATTCGTCGTGGGAATTAAGAAAGAACCAAAA	1	bc
CGGCAGCCGG	GAAACACCGGTCGTCGTTCGTAAGGCGTGGGGTTAAGGCTGTAACTAGAA	1	bc
CCCCCACCAC	GAAACACCGGTTCCACCGGCGTCTTGAACCGGTGAGGGGGTTAGATCTAG	1	bc
AAATCAAACA	GAAACACCGGTTGTGGTAGAGTCGGTATTAGCGAAATAACATGATACCAG	1	bc
CTACCACCCA	GAAACACCGGTTGTATACAGTTAGAAATAGCGATAGAGCTAGAAACTGCA	1	bc
GACTTCACAA	GAAACACCGGTGCTAATAGTTAGCCCGTGGGGTTAGAGCTAGAAATAGCA	1	bc
AAAATGTACG	GAAACACCGGTTTTCGATAATAGGTCGTGGGGTTAGAGCTAGAAATAGCA	1	bc
TACTTCGCAA	GAAACACCGGTTGAGATAATGAGGGGGTGGGGTTAGAAATAGCAAGAGCA	1	bc
GCATCAAAAG	GAAACACCGGTTATCGTAAAGGGTGGTGTGGGGACTGAGCTTGACATAGC	1	bc
CCCAAACCCC	GAAACACCGGTAGTCTAAACACCTTCAGCGATATATAGCAAGTTAACCTA	1	bc
AATATATAAA	GAAACACCGGTGACCAGGGTTTGTGCTAGAAAGAGAGAGGTAGCCTAAGG	1	bc
AATTGCGTGA	GAAACACCGGTTTTCGGTAACTCGGTGTGGGAGGCATAGCATGGTAACTT	1	bc
GTCTTAACGA	GAAACACCGGTGCTAGTAGATAGCTCGTGGGGTTAAACCTAGAACTAGCA	1	bc
GAGACTGTAG	GAAACACCGGTCCTAGAAGCTGAGGGGGAGGGGTTAGAGCTAGAAATAGC	1	bc
AGGACTGTCT	GAAACACCGGTTCTAGTAACCGAGTTAGGGGTTGAGAGAGAAAAAGAGGA	1	bc
ACTTGAGCGA	GAAACACCGGTTGGCGGGAATTCGGTGTGGGAAAAATAGCATGTCACCCT	1	bc
