CGTCGGTCTG	GAAACANCGGTCGTCGTTCGTAGGGCGTGGGGTTAGAGCTAGAAATAGCA	1	bc
AAATCCGTCG	GAAACACCGGTCCTAGAAGCTGAGTTGTGGGGTTAGAGCTAGAAATAGCA	1	bc
GGCACTCCTC	GAAACANCGGTTCCCGCTAGCTCGTAGTGGGTTAGAGCTAGAAATAGCAA	1	bc
GTCACATCTA	GAAACANCGGTGAGCATGATTAGAGCTAGAAATAGCAAGTTAACCTAGGG	1	bc
GTACCAGATA	GAAAGANAGAACTTCCTAGATAATAACGTGCGGGACAGTTAGAAACTTGA	1	bc
ATCTAACCGA	GAAACANCGGTGTGCGGAGATTATGCGTGAGAAATAGCAAGTAACCTAAG	1	bc
AAATCAGACA	GAAACANCGGTTGTAAGCGACGGGGTGTGGGGTCAGAGCCAGGTTTACCA	1	bc
TCCGCACGCA	GAAACACCGGTGGGGTGAGAGCTCGAAATGGCATGTTACCCTAAATCTAG	1	bc
GTATCAGAAG	GAAACANCGGTCCTAGTAGCTGGGTCGTGGGGTTAGAGCTAGAAATAGCA	1	bc
GAAATATTTC	GAAACANCGGTGAGCATGATTAGAGCTAGAAATAGCAAGTTAACCTGCGG	1	bc
GACTATGTAA	GAAACANCGGTACTAGTTACTTACGGGTGGGGTTAGAGCTAGAAATAGCA	1	bc
GAAAGATAAA	GAAACACCGGTGAGCAAGCATAGAGCTTGATATAACAGCTTGAAATAAGA	1	bc
ATACAACCCA	GAAACANCGGTTGTAAGCGATGGTTCGTGGGGATAGAGATAGAAATAGCA	1	bc
GGAAAATAAA	GAAACANCGGTGAGCATGATTAGAGCTAGAAATAGCAAGTTAACCTAAGG	1	bc
CGTCCAGCTA	GAAACANCGTTCTTCCTGAACTCTAACGAGCAGTAGAGCTAGAAATAGCA	1	bc
CTTTCACCCT	GAAACANCTTGGGGATAGAGCTAGAAATGGGAAGATAGCCTAAAACTAGA	1	bc
AATCATGCAA	GAAACANCGGTAACAGATACATGCCGGTGGGGTTAGAGCTAGAAATAGCA	1	bc
AAGATGGTCG	GAAACANCGGTTTTAGAACCTAGGTTGTGGGGTTAGAGCTAGAAATAGCA	1	bc
AAACGGGCAC	GAAACANCGGTGTTCGTTGATTCGGGGTGGGGTTAGAGCTAGAAATAGCT	1	bc
GGTTCATCCG	GAAACANCTGGTGTTTAGAGCTATTAATCGGGAGTTAACCTAAGGCTAGT	1	bc
GAATAAGTAA	GAAAAANCGGTCTTAGTAAATGGGGGGGGGGGTTAGAGCTGGAATTGGAA	1	bc
CCCCCCTCCC	GAAACANCGGTAGCCGTTAGCCCGGAGTGGGGTTAGAGCTAGAAATAGCA	1	bc
TAACGTGACT	GAAACANCGGTGCCCGTGGGCTCAGAGCTACTAATAGTAAGTTAACCTCA	1	bc
GATATAGCTA	GAAACANCGGTGAGCTTGATTAGAGCTTGAGCTAGCAACTTAAAATAAGA	1	bc
AATTTGCCAG	GAAACANCGGTTTTCGTTCATACTCCGTGGGGGTAGAGCTAGAAAATGCC	1	bc
AGACCAGAAT	GAAACACCGGTGTTCTTGGAACCAAAGGGGGGTTAGAGCTAGAAATAGCA	1	bc
GCAATATACT	GCTAGANAGATCAGCATGATTTGAGCTTAAACTAGCATGTTCTCCTAAGG	1	bc
AACACGCTCT	GAAACANCGGTTTTCGATCATAGGTCGTGGGGTTAGAGCTAGAAATAGCA	1	bc
CACATGGAAG	GAAACANCGGTTTTAGATAATAGGTGGTGGGGTTAGAGCTAGAAATAGCA	1	bc
AATAAAGAAG	GAAACACCGGTGACCATGATGAGAGCGTGGGATAACAAGTAAACCTAAGA	1	bc
GCATTGTATC	GAAACANCGGTTCAACCGGCGTCTTGAACCGGTTGGGGGGTTAGAGCTAG	1	bc
ATCCTGCACC	GAAACANCGGTCGTGATAATGCGCCGGTGGGGTTAGAGCTAGAAATAGCA	1	bc
GAAATATAAC	GAAACANCGGTGAGCATGATTAGAGCTGGAAATAGCAAGTTAACCAAAGG	1	bc
AAACCACTAT	GAAACANCGGTTGTAGGCGATGGGTTGTGGGGTTAGAGCTAGAAATAGCA	1	bc
GGGATATATT	GAAACACCGGTGAGCATGATACGAACTGGAGATAGGAGGTTAACATAAGA	1	bc
GATTCACGAG	GAAACANCGGTGACAATTCGGGCTGTTGGGGGTTAGAGCTAGGAATAGCC	1	bc
TAATCCCACA	GAAACANCGGTGGCAATTGGATGTGGGTGGGGTTAGAGCTAGAAATAGCA	1	bc
AATCGATATT	GAAACANCGGTGCTAGTGGGGTTAGAGCTAGAAATAGCCAGTTAACCTCA	1	bc
ATTTCATCCA	GAAACANCGGGGCGAGAAGCTTAGATGTGGGGTTATAACTTGAAACTATT	1	bc
ATAATGTATC	GAAACANCGGTGTTCGTTGCTCGAGGTAGAGCTAGCAGGTTGAAGTAGAC	1	bc
GATATATAAA	GAAACANCGGTGAGAATGAGTAGAGATAGAAATAAGAAGTTAAAATAAGA	1	bc
ATCCCACCCA	GAAACANCGGTGGTCGGCGATTGTTTGTGGGGATAAAGATGGAAATTACA	1	bc
GGACTGGAAC	GAAACACCGGTGTTCTTTGCTCGGGGGTGGGGTTAGAGCTAGAAATAGCA	1	bc
CACTCATTGA	GAAACANCGGTTGGCGATAGCAAGAGCTAGTAAACCTACGGATAGTCAGT	1	bc
ATCCTGCACG	GAAACANCGGTTGTAAGCCATAGGTCGTGGGGTTAGAGCTAGAAATAGCA	1	bc
ACCATGCAAC	GAAACANCGGTTCACGCTCCTTGTTCGACCGGTTAGAGCTAGAAATAGAG	1	bc
CTGTCAGTAA	GAAACACCGGTGGCAATTCGTTCTGTGTGGGGTTAGAGCTAGAAATAGCA	1	bc
AAACAACACA	GAAACACCGGTTGTAAGCGATGGTTTGTGGGGTTAGAGCTAGAAATAGCA	1	bc
CAATACCACA	GAAACANCGGTTGTAAGCGATGGTTTGTGGGGTTAGAGCTAGAAATAGCA	1	bc
GGTACATATT	GAAACACCGGTCAGCCTGGTTACTGATGGAGGGAGCAAGTTAACCTAGGA	1	bc
TAAAGGGATG	GAAACACCGGTCTACTTGGGTAACTAGTGGGGTTGGAGCTAGAAATAGCA	1	bc
AATACACTAA	GAAACANCGGTGGCAATTAGATCTGCTTGGGGTTAGAGCTAGAAATAGAT	1	bc
CGACGTTATT	GAAACANCGGTGCTCGTGAGGGTAAGACTTAACATAGCAAGTTAGACTAA	1	bc
TAACCAGTTC	GAAACACCGGTTTTCCTGGTCTCTAAGGTGGGGAAGAGCTGGAAATGGCA	1	bc
GCGGTCATCA	GAAACANCTTGGGGTTAGAGCTAGAAATAGCAAGTTAACCTAAGGCTAGT	1	bc
CATTGATCTT	GAAACACCTGGGCTATAGGGGTTAAAGTTACAAATTGCAATTTAACCTAT	1	bc
TGTAATACAT	GAAACANCGGTGAGCATGATTAGAGCTAGAAATAGCAAGTTAACCTAAGG	1	bc
CCTCGCGCTT	GAAACACCGGTCGAATGGATCCATGGCGGGGGTTAGAGCTAGAAATAGCA	1	bc
TCTGCAACGA	GAAACACCGGTGGGGATAGAGCTAGAAATAGCAAGTTAACCTAAGGCTAG	1	bc
GATTCAGTAA	GAAACACCGGTGGCAATTCGATATGAGTGGGGTTAGAGCTAGAAATAGCA	1	bc
TAAATCTCTA	GAAACACCGGTTTACATAATTAACTCTAGGAATTACAGTTTGAACTAACA	1	bc
CTTTCCGCAG	GAAACACCGGTCGCAATTCGTGATGTGGGGTTTTAGCTCTAGAAATAGCA	1	bc
AAATTATATA	GAAACACCGGTTGTGGTGAACTCGTTGTGGGGGGAAAACCAAAAAAATCT	1	bc
GCAATGCACA	GAAACACCGGTGAGCATGATTAGAGCTAGAAATAGCAAGGTAACCGCAGG	1	bc
CAAAGCGTTT	GAAACACCGGTGCTAGCGGGGGTAGAGCTAGAAATAGCAAGTTAACCTAA	1	bc
GAGTCCCGAG	GAAACACCGGTTATCGTTGTGGATTATTTGGGGTAGAGCTAGAAATAGCA	1	bc
TTCACTTCAA	GAAACACCTGTTCCATTTATCTAGGAGAGGGGATAGAGCTAGAAATCGCA	1	bc
ATTTCAGACA	GAAACACCGGTGCTAGAGGCTGAGATGTGGGGTGAGAGCTAGAAATAGGA	1	bc
AGTACATCCC	GAAACACCGGTTCCCGTTAGCTTGTAGTGGGGTTAGTGCTGGAAAGAGCA	1	bc
GGAAAGCATC	GAAACACCGGTGAGCTTTGTTCGAGGTAGAGGTTACAGCTAGACCTAGCG	1	bc
GGCAAGCAAC	GAAACACCGGTGTCCTTTACTCGCGGGTGGGGTTAGAGCTAGAAATAGCA	1	bc
AAGTTAAGCG	GAAACACCGGTTTTCGATCCGGGGTCGTGGGGGTAAAAGCAAGAAAAGCA	1	bc
GTGACAGTAG	GAAACACCGGTCCTAGGAGATGAGTTGTGGGGTTAGAGCTAGAAATAAAA	1	bc
GCATTAACAC	GAAACACCGGTTGGCTTGATTCCATCTGCTATTAACAGCATGACATCAGG	1	bc
CGTACTGCCG	GAAACACCGGTGCCCTTGATGGGGACGTGGGGATAGAGCTAGAAATAGCA	1	bc
GTTTCCGCCA	GAAACACCGGTCCTAGAAGCTTAGGTGTGGGGGTAAGGCAAGAAATTACA	1	bc
AAGTATGCTA	GAAACACCGGTTTTCGATCATACGTCGTGGGGGTTAAGCTTAGAATAGCA	1	bc
ATATCACCCA	GAAACACCGGTTGTAAGCGATGGGTTGTGGGGGAAGTAGCAGAATTACCA	1	bc
TGCAAAACCT	GAAACACCGGTTGCCGTTAGCGAGTAGTGGGGTTAGAGATAGAAATAGCA	1	bc
GATACATATA	GAAACACCGGTGACCATTCGATCTGAGTGGGGTTACAGCTTGAAATAGCA	1	bc
GAAAAATTCC	GAAACACCGGTGAGCAAGATTAGAGCTAGAAATAGCAAGTTAAACTAAGG	1	bc
TACACCAACT	GAAACACCGGTTCACTTTGGTTCCTCGTGGGGTTAGAGCTAGAAATAGCA	1	bc
AGCCTGCCCC	GAAACACCGGTGTTCTTTGCTCGCGGGCGGGGTTAGAGCTAGAAATAGCA	1	bc
AAAACCATGA	GAAACACCGGTGAAGATGGTTAGATCAAGAAGTAGGAGGTTAACCTAAGG	1	bc
ACACCAAAGA	GAAACACCGGTGGGGTTAGTACTAGAAAGAGCAAGCTAATAGAAGTATAG	1	bc
GCAATCTTTA	GAAACACCGGTGACGCGAGGACGGTGTTGGGGTTAGAGCTAGAAATAGCA	1	bc
TTGACCCACC	GAAACACCGGTCCTAGAAGCTGAGTTGTGGGGTTAGAGCTAGAAATAGCA	1	bc
GACAACCTTA	GAAACACCGGTAATCTAGAGTACCGCTTGGAATAACAACTTGACCTAGGG	1	bc
CATTAACACC	GAAACACCGGTGGCAAATCGATCTGAGTGGGGTTAGAGCTAGAAATAGCA	1	bc
TGTATAGATA	GAAACACCGGTGAGCATGATTAGAGCTAGAAATAGCAAGTTAACCTAAGG	1	bc
CGCTCAGACC	GAAACACCGGTCTTCCTGGAATCTAACGCGGGGTAGAGCGAGAAAGAGCA	1	bc
GTATCAGCAA	GAAACACCGGTTGTGGGCGACGCGGTGTGGGAGAAATAGCAAGAGAATCT	1	bc
GACAAGCTCC	GAAACACCGGTAATCTAAAGATCCCCGTGGGGATAGAGCTAGAAATAGCA	1	bc
CCCAGGCGAG	GGAACACCGGTAGAATGACGTTAGAGCTAGAAATAGCAAGTGAACCTGAG	1	bc
ACAGCGCAAC	GAAACACCGGTGTGGTTAGATCTAGAAATAGCAAGGTAACCTAAGGCTAG	1	bc
TACACGCATT	GAAACACCGGTTTTCGATCATAGTACGTGGGGTTAGAGCTAGAAATAGCA	1	bc
GACACCCTCC	GAAACACCGGTTCTCGTTAGCTCGCAGTGGGGTTAGAGCTAGAAATAGCA	1	bc
GACAACGTTG	GAACCACCGGTAATCTACAGATGCGCGTGGGGATAGAGCTAGAAATAGAA	1	bc
TGCTCATCCA	GAAACACCTTGGGGTTAGAGCTAGAAATAGCAAGTTAACTTAAGGCTAGT	1	bc
