CAACGGGCAT	GAAACACCGGTGCTAGCGGATTCGAAAGTGGGGATAGAGCTAGTTATAGC	1	bc
GATACAACCG	GAAACACCGGTTATCGTTACGGATTTTGTGGGGTTAGAGCTAGAAATAGC	1	bc
CGGCAAGCTG	GAAACACCGGTCGTCGTTCGTAATGCGTGGGGAAAAAGCTAGAACCAGCA	1	bc
AACTACGTGA	GAAACACCGGTACTGGATACTGGCGGGTGGGGTTAGAGCTAGAAATAGCA	1	bc
CAGACAGTCG	GAAACACCGGTCCTAGAACCATCGTTGTGGGGTTAGAGCTAGAAATAGCA	1	bc
GATTGGGTCA	GAAACACCGGTAATCTAAAGATCGCCGTGGGGGTAGAACTAGGGATAGCT	1	bc
ATCTCACCCT	GAAACACCGGTTCGCGGTGATTCTTGGTGTGAGAGCTAGAAAAAGCAAGA	1	bc
GAAAAACCCC	GAAACACCGGTAATCTAAAGATCCCCGTGGGGATAGAGCTAGAAATAGCA	1	bc
AAATCAAGGG	GGAACACCGGTTTAGGATGCGAGTTTTGTGAGATCTGGAATTAGCATAGT	1	bc
ATATCAGACG	GAAACACCGGTTTTAGTAAATGGTGAGTGGGGTTAGAGCTAGAAATAGCA	1	bc
TTAACTCCCT	GAAACACCGGTTGTCAGCGGTGGTTTGTGGGGTTAGAGCTAGAAATAGCA	1	bc
ATCTTAACAA	GAAACACCGGTGTGCGGAGATTATGCGTGAGAAATAGCAAGTAACCTAAG	1	bc
GATCTATAAA	GAAACACCGGTGGGAATGATTTCTGCTTGGGATAGCAAGTTAACCTAAGG	1	bc
TATACAACAT	GAAACACCGGTTTACTTTGTTCACTAGTGGGGTTAGAGCTAGAAACAGCA	1	bc
TGCACAACCA	GAAACACCGGTTCCCGTTAGCTCGGAGAGATAAAGCTAGAAATAGCAAGT	1	bc
GCCAATGTCA	GAAACACCGGTACTGCGTGCTTGGGGGTGGGGTTAGAGCTAGAAATAGCA	1	bc
TAATTACTAA	GAAACACCGGTTGCAATTCGATCTGAGTGGGGTTAGAGCTAGAAATAGAA	1	bc
CAGAACCCCC	GAAACACCGGTAATCTAAACTTCTCCGTCTGTATATAGCTAGAAATCCCA	1	bc
GCGAAAATCC	GAAACACCGGTAATCTAAAGATCCCCGTGGAGATAGAGCAAGTAATCGCA	1	bc
TAAACCCCCG	GAAACACCGGTTTACTTAATTGGATCGTGGGGTTAGAGCTAGAAATAGCA	1	bc
GTTATGGAAA	GAAACACCGGTTGGCATGAACACGGGGTAGGAGTAATAGCAACTTAATAT	1	bc
CAACTGGAAA	GAAACACCGGTCGTCGTTCGTAGGGCGTGGGGTTAGAGCTAGAAATAGCA	1	bc
ACGCTAACCC	GAAACACCGGTTGGATTTGCTCCTTTAGCTATAAATAGCTAGTTAACCTA	1	bc
CGGCGTGTAA	GAAACACCGGTCGTCGTTCGTAGGGCGTGGGGTTAGAGCTAGAAATAGCA	1	bc
TAACCAGAAT	GAAACACCGGTTTAATTAGTTAACTAGTGGGGTTAGAGCTAGAAATAGCA	1	bc
GTGACAGTTG	GAAACACCGGTCATCGTAGCTGTGGTGTTGGGATAGAGATGGAAATCGCA	1	bc
AAGTTAATAA	GAAACACCGGTTGGGTATAGTCGTTAAGGGGTATATAGCAAGATAAAGCA	1	bc
TGATTAGATT	GAAACACCGGTCTACCTGGAATCTAACGTGGGGTAGAGCTAGAAATGGCA	1	bc
AGCCCGCACC	GAAACACCGGTGTCCGTTAGTCCGGGGTGTGGTTAGAGCTAGAAATAGCA	1	bc
GAAATAATGA	GAAACACCGGTTGAGATAATAAAAAAGTGGGGTAGAACTAGGAAAAGCAA	1	bc
AAGTTAATAC	GAAACACCGGTTGGATTTACTCCTTTAGCTATAAATAGCAAGTTAACCTA	1	bc
GACTCACTCC	GAAACACCGGTGATATTACGATCTGAGTGGGGTTAGAGCTAGAAATAGCA	1	bc
CACTTGCTCC	GAAACACCGGTTGAGCCAACCTCTTGGAGCGGTGGAGGTGGATAGAGCCA	1	bc
TCAGCCATAC	GAAACACCGGTGGGGTTAGAACTATCGATAGCAAGTTACCCTAAGGATAG	1	bc
AACAGCCGCC	GAAACACCGGTAGCCTGGCTCCGCGGGTGGGGTTAGAGCTAGAAATAGCA	1	bc
GATAACCAAC	GAAACACCGGTAACCTAAAGATCTGCGTGGGGATAGAGCTAGAAATAGCA	1	bc
GAAATATACG	GAAACACCGGTTTTCGTGAATAGAGCGTGGGGTTAGAGCTAGAAATAGCA	1	bc
AATAAACAAA	GAAACACCGGTGGTAATTCGATCTGAGTGGGGTTAGAGCTAGAAATAGCA	1	bc
TAAAATGAAA	GAAACACCGGTACTATTAACTTACTAGTGGGGTTAGAGCTAGAAATAGCA	1	bc
ATGTCAGTCA	GAAACACCGGTCTTAGTAGATGAGTTGTGGGGTTAGAGCTAGAAATAGCA	1	bc
AATCAGTAAC	GAAACACCGGTGACAGAGCTAGAAATAGCAAGTTAACCTAAGGATAGTCA	1	bc
GTCATTTCTA	GAAACACCGGTTCGCGTGATCACGTCTAGTTATAGCTAGATATACCAAGT	1	bc
CAGTAAACAA	GAAACACCGGTAGGCTTTACTCATTTAGCTATAAATAGCAAGTTATACTA	1	bc
GATTCACGAG	GAAACACCGGGTATCGTTACGGATTTTTTGGGGGTAGAGCTAGAAATAGC	1	bc
GCAACATCAT	GAAACACCGGTAATCTAAAGATCCCCGTGGGGATAGAGCTAGAAATCGCA	1	bc
TAAACAAGCG	GAAACACCGGTTATCGGTGGGCGTTTTGGGGGGTTAGAGTAAGAATTAGC	1	bc
GACTAACCCA	GAAACACCGGTTTTAGGAGATTATTCGTGAGGTTAGGGCTGTAAATAAAG	1	bc
TCTCCAGTCT	GAAACACCGGTCTCGCGAGGATGGAACTGGGGTTAGAGCTAGAAATAGCA	1	bc
TAATCCATAT	GAAACACCGGTTTACCTAGTTAACTAGTGGGGTTAGAGCTAGAAATAGCA	1	bc
CGCTCACACA	GAAACACCGGTTCCAGTTCGATCTGGGTGTGGGTAGAGCTAGAAATAGCA	1	bc
CAATCGCCCC	GAAACACCGGTTCAACCAGAGTCTTAAACCGGTGGGGGGGTTATAGATAG	1	bc
TGGATTTCAC	GAAACACCGGTTGCCTTTATTTCTTAATCTATAAATAGCAAGTTAAACTA	1	bc
CACCACTATT	GAAACACCGGTGCTAGCGGTTTAGAAAGTGGGGTTAGAGCTAGAAATAGC	1	bc
GGCTAGTTAG	GAAACACCGGTGGCAGCCAGCCACTTGTGGGGTTAGAGCTAGAAATAGCA	1	bc
CTATGAGCGT	GAAACACCGGTGCGCGGGGATTCGGAATTGGAGATAGAGCGAGAAATAGC	1	bc
ATTTCGCAAA	GAAACACCGGTGGCAATTCGATATGAGTGGGGTTAGAGATGGAAATAGCA	1	bc
TCATCAAGAG	GAAACACCGGTGGGGGTAGAGCTAGAAATAGCAATTTAACCTAAGGCTAG	1	bc
GAAAAATATC	GAAACACCGGTGAGCATGATAACCGGTGGGGTTAGAGCTCTAACCGGTGG	1	bc
TTCCTCTTGC	GAAACACCGGTCGCGAATATGAGCCGGTGGGGTTAGAGCTAGAAATAGCA	1	bc
AAACGGGTAA	GAAACACCGGTTTAGGGTGACTCGGAGTGGGATTAATACCAAGTTAACCT	1	bc
CGCCGGGCCG	GAAACACCGGTTGTCGTTCGCAGGGCGTGGGGTTAGAGCTAGAAATAGCA	1	bc
TGAAGGGTTT	GAAACACCGGTCATCGTTCGACGGGGGTGGGGTTAGAGCTAGAAATAGCA	1	bc
ATGAACCTCC	GAAACACCGGTGCTAGAAGCTGAGTTGTGGGGTTAGAGCTAGAAATAGCA	1	bc
CAATCAGGTG	GAAACACCGGTTTTAGTAAATGGTGAGTGGGGTTAGAGCTAGAAATAGCA	1	bc
CCTTGGGCCC	GAAACACCGGTTGAGGGGAACTCGGTGAGGGAGAAATAGCATGTTAACCT	1	bc
AGGTCAAACG	GAAACACCGGTTATCGTTACGGGTTTTGTGGGGTTAGAGCTAGAAATAGC	1	bc
CGGCGAACTG	GAAACACCGGTCGTCGTTCGTAGGGCGTGGGGTTAGAGCTAGAAATAGCA	1	bc
CACCTAAAAG	GAAACACCGGTTTTCTTTCATCCTTTAGCGAGTTATAGCTAGAAATAGCA	1	bc
GCCAAAAGCT	GAAACACCGGTGGTCGCCGTGGAGAGGTGGGGTTAGAGCTAGAAATAGCA	1	bc
GACTCGGACC	GAAACACCGGTTCTAGTTACTTACGGGAGGGGTTAGAGCGAGAGATAGCG	1	bc
GGATTTGTAA	GAAGCACCGGTACTAGTTACTTACGGGTGGGGTTAGAGCTAGAAATAGCA	1	bc
CTTAAAAAAT	GAAACACCGGTGAGCATGATAACCGGTGGGGTTAGAGCTCTAACCGGTGG	1	bc
