GCCCGCTGTC	GAAACACCGGTAGAATGGATCCACGGGTGGGGTTAGAGCTAGAAATAGCA	1	bc
AGCACTTAAT	GAAACACCGGTGGGGTTAGAGCTAGAAATAGCAAGTTAACCTAAGGCTAG	1	bc
GCCTAGGACC	GAAACACCGGTTCAACCGGCGTATTGAACCGGTGGGGGGGTTAGAGCTAG	1	bc
GGCTCCCAAG	GAAATACCGGTGGCAATCAGATCTGTGTGGGGTTAGAGCTAGAAATAGCA	1	bc
TTAAAGAGAT	GAAACACCGGTGCTAGCGGTTTCGAAGTGGGGTTAGAGCTAGAAATAGCA	1	bc
TCATCATCAA	GAAACACCTTGGGGGTAAGGCTAGAAATTGCAAGTTAACCTAAGGCTAGT	1	bc
ACCTAGCACA	GAAACACCGGTTCAACCAGCGTCTTGAACCGATGGAGGGGGTAGAGCTAG	1	bc
CAACAACAAG	GAAACACCGGTGTTCGTTGCTCGGGGGTGGGGTTAGAGCTAGAAATAGCA	1	bc
TCAACAGACG	GAAACACCGGTGGCGTTAGTGCTAGCGTTGGCTTGGAGATAGAAGTATCA	1	bc
CCCTTAGCCA	AGTGGACGAAACACCGGTTGTGGGGAACTCGGTGTGGGAGAAATAGCAAG	1	bc
CAATCACGCC	GAAACACCGGTTATATTTATGGATGGGTGGGGTTAGAGTTATAAATTGCA	1	bc
TCCCGACGTC	GAAACACCGGTAGAATGGATCCACGGGTGGGGTTAGAGCTAGAAATAGCA	1	bc
CACCGAGGTC	GAAACACCGGTGCAAGCGGTTTCGAGGTGGGGTTATAGCTAGAAATAGCA	1	bc
TTCATTTCTT	GAAACACCGGTGGGGTTAGAGCTAGATATAGCAAGTTAACCTACCGCTAG	1	bc
GACTCTCAAA	GAAACACCGGTATAATTTACTAACGAGTGGGGTTAGAGCTAGAAATAGCA	1	bc
GGCTCATACG	GAAATACCGGTGGCAGCCAGCCACTTGTGGGGTTAGAGCTAGAAATAGCA	1	bc
CGTTACTCAC	GAAACACCTTGAAGTTAGAGCTAGACATGGCAAGTTAACCTAAGACTCGT	1	bc
GATTCAAACA	GAAACACCGGTGGCAATTAGATCTTATTGGGGGTAAAGCTAAAAATAACA	1	bc
CAGTCAAAAG	GAAACACCGGTGGCAATTAGAGCTGAGGGGGGGTAGAGCTAGAAAAAGGA	1	bc
CATTCCCCCC	GAAACACCGGTGGCAATTAGATCTGAGTGGGGTTAGAGCTAGAAATAGCA	1	bc
AAATGAAGCG	GAAACACCGGTAGTAGGGAAGGATGGGGGGGGTTAGAGCTATAAATAGCA	1	bc
GAAATGTAAG	GAAACACCGGTTTTCGTGCATAGGTCGAGGAATAACAGCTAGAAATAGGG	1	bc
AATACAGCCC	GAAACACCGGTGACAAACGTATGGCAGTGAGGTTAGAACTAGAAATTGAA	1	bc
AACCAGCTAC	GAAACACCGGTGTTCTATCCTCGAGGGTGGGGTTAGAGCTAGAAATAGCA	1	bc
AGCCAGTACT	GAAACACCGGTGTCCGTTAGCCGGTGGTGGGGTTAGAGCTAGAAATAGCA	1	bc
CACCAAGATA	GAAACACCGGTGCTAGCGGTTTCGGCGTGGGGATAGAGCTAGAAATAGCA	1	bc
AGTTAATAAA	GAAACACCTTGGGGTTAGAGCTAGAAATAGCAAGTTAACCAAAAGCTAGA	1	bc
ATACCCAACA	GAAACACCGGTTTAGAATGAAGGGAAGTGGGGTTAGAGCTAGAAATAGCA	1	bc
GGAAATATCT	GAAACACCGGTGAGCATGATTAGAGCTAGAAATAGCAAGTTAACCTAAGG	1	bc
TCAACCAACC	GAAACACCGGTGGGGTTAAAGCTAGAAATAGCAAGTTAACCTAAGGCTAG	1	bc
CGCTACCAAG	GAAACACCGGTGGCAGCCAGCCACTTGTGGGGTTAGAGCTAGAAATAGCA	1	bc
GTGATCGTAG	GAAACACCGGTGGTGGTAAACTCGGCGTGGGAGAAATAGCAAATTAACCT	1	bc
CCCCCCAAGC	GAAACACCGGTTTAACCGGCGGCGTAAACGGGTTAGGGGGATAAATCTAG	1	bc
AACTAACCAC	GAGACACCGGTGACCAACGTTTGTCCGTGGGGATTGACCTAGAAACTGCA	1	bc
GCATTGTACA	GAAACACCGGTTCAACCGGTGTGTTGTAGAAGTGGCGGGGTTAGCGATGG	1	bc
TAATCGGGCA	GAAACACCGGTTGTGGGGAACTCGGCGTGGGAGAAATAGCAAGTTAACCT	1	bc
AACTCACCAC	GAAACACCGGTGACAAACGTATGTCAGTGGGGTTAGAGCTAGAAATAGCA	1	bc
CCACGCTATA	GAAACACCGGTGGGATGGATCAAAGGTAGGGGTAACAGGTAGACCTAGCA	1	bc
AGTTCACAAC	GAAACACCGGTGGCCATTCGATCTGGGTGGGGTTAGAGCTAGAAATAGCA	1	bc
ACCTCGCTCG	GAAACACCGGTTTTCGCTCCTTCGTCGTGCGGTGAGAGCTTTAAATAGCA	1	bc
ATTTGGGGAC	GAAACACCGGTTGTGGGGAACTCGGTGTGGGAGAAATAGCAAGTTAACCT	1	bc
GCACTATAAA	GAAACACCGGTGGGCTTGAATAGAGAAAGAGATAGCAAGCTAAAGTTAGG	1	bc
CCCCGAGGTT	GAAACACCGGTGCTAGCGGTCTCGGGGTGGGGTTAGAGCTCGAAATAGCA	1	bc
GTATAAAAGA	GAAACACCGGTGCGAAGAGATAGCTCGTGGGGTTAGAGATAGAAGCAGCA	1	bc
GGACAGGACG	GAAACACCGGTGTTATTTAATCGTGGGTGGGGTTAGAGCTAGAAATAGCA	1	bc
