GATAGGGAAA	GAAACACCGGTGGGCATGTACACGGCGTGGGGGAAGTAGCAGATTAAGCT	1	bc
TAAATACAAC	GAAACACCGGTTGACATAATTAACTAGTGGGGTTAGAGCTAGAAATAGCA	1	bc
AATACCTCCC	GAAACACCGGTAATCTAAGGATGCCCGTGGGGATAGAGCTAGAAATAGCA	1	bc
TCGTCGGGCT	GAAACACCGGTCGTCGTTCGCAGGGCGTGGGGTTAGAGCTAGAAATAGCA	1	bc
TCCAATCTAA	CAAAACACGGTGACGAGATAATGACTAGAGCTAGTAGTACTAAAATAAGC	1	bc
ATAAAAGCCT	GAAACACCGGTTGTAAGTGATGGTTTGTGGGGTTAGAGCTAGAAATAGCA	1	bc
TACTCCGTAA	GAAACACCGGTACTATTTACTTACTAGTGGGGTTAGAGCTAGAAATAGCA	1	bc
CCTTCAACAG	GAAACACCTTGGGGTTAGAGCTAGAAATATCAAGTTAACCTAAGGATAGT	1	bc
CCCTTTGTAC	GAAACACCGGTACTAGTTTCTTCCGGTAGCTGTTAGTGCTAGAAATAGCA	1	bc
GAAAAACTTT	GAAACACCGGTAATCTAAAGATCCCCGTGGGGATAGAGCTAGAAATGGCA	1	bc
CCCCCCTCCC	GAAACACCGGTGACATACGTATGTCAGAGAGGTAAGAATAGCAAGTTAAC	1	bc
AAATTACCAC	GAAACACCGGTTTGCTTTACTCCTTTGTCTATATATAGCAAGTTATACTA	1	bc
CCAACGCTCC	GAAACACCGGTGACGCGAGGACGGTGGTGGGGTTAGAGCTAGAAAGAGCA	1	bc
TTAATCTCCT	GAAACACCGGTCGCGAAAGTGCGCCGGTGGCGTTAGAGCTCGAGATAGCC	1	bc
AAAAACCTCG	GAAACACCGGTAATCTAAAGAGCCCCGTGGGGATAGAGCTAGAAATAGCA	1	bc
CCCTGGGCCC	GAAACACCGGTTGTGCGGAACTCGTTGTGGGAGGAATAGCATGTTACTCT	1	bc
CCAACCCCCC	GAAACACCGGTGACGCGAGGACGGTGGTGTGGCTAGAGCTAGAAATAGTA	1	bc
CAGTTACCAA	GAAACACCGGTGGCATTTCGTTCTTTGTCTGTTTATAGCTAGATATAGCA	1	bc
TGATCATAAA	GAAACACCTTGTGGTTAGAGTTAGAAATAGCATGTTAACCTAAGGTTAGT	1	bc
GATCCTGTAC	GATACACCGGTAATAGTTACTTACGGGTGGGGTTAGAGCTAGAAATAGCA	1	bc
CGCCGGCAAC	GAAACACCGGTGGTATTTACTCGAGGGTGGGGTTAGAGCTAGAAATAGCA	1	bc
CCACTAGCTC	GAAACACCGGTGCTAGCGGCTTCTTAATCTGGATATAGCTAGAAATAGCA	1	bc
GCCAAAAGCT	GAAACACCGGTAGTCGCCGTGGAGAGTGGTGGGGTTAGAGCTAGAAATAG	1	bc
ATCACGCAAT	GAAACACCGGTTGTCAGCGATGGGTTGTGGGGTTAGAGCTAGAAATAGCA	1	bc
GCGTTAGAAA	GAAACACCGGTGGGCTTTACTACATCAGCTAAAAGTAGCAAGTTAAAATA	1	bc
GAAAAAATCC	GAAACACCGGTAATCTAAAGATCCCCGTGGGGATAGAGCTAGAAATAGCA	1	bc
CACTGGCATC	GAAACACCGGTTCAACCGGCGTCTTGAACCGGTTGGGGGGATAGAGCTCG	1	bc
CGGTTGGTAG	GAAACACCGGTTGTCGTTCGTAGGGCGTGGGGAAAGAGCTAGAAAAACTA	1	bc
GCCAAAAGCT	GAAACACCGGTGGTCGCCGTGGAGAGTGGTGGGGTTAGAGCTAGAAATAG	1	bc
GACATATATC	GAAACACCGGTGAGCATGATTAGAGCTAGAAATAGCAAGTTGACCTAACG	1	bc
GTAATCTCTC	GAAACACCGGTGACGAAGATTAGCGCTAGAAATAGCAAGTTAAAATAAGA	1	bc
AAATAAGCGG	GAAACACCGGTGTTAGGAAATTACGCGTGAGATATAACAAGGAAATAACA	1	bc
ATACTATATC	GAAACACCGGTGAGAAAGGTAAGACCTAGAAGTTACAAGTTGAAATAGGG	1	bc
GAGATAAGTG	GAAACACCGGTTATCGTTACGGATTTTGTGGGGATAGAGCTAGAAATAGC	1	bc
GCGTTAAGAG	GAAACACCGGTTGTCGTTACTCCTTTAGCTAGAAATAGCAAGGTAACAGA	1	bc
TAACCCCTAA	GAAACACCGGTTTAGTATGTAAGCTAGTGGGGTTAGAGCTAGAAATAGCA	1	bc
GGATCATAAA	GAAACACCCTGGTGTTAGAGCGAGAAATAGCAAGATAACTTAAAACAAGT	1	bc
ATCTCACCCT	GAAACACCGGTTGGCGGAGATTATGCGTGGGGTTAGAGCTAGAAATAACA	1	bc
ACACAACCCT	GAAACACCGGTTGTATGCGCTGGTTTGTGGGGTTAGAGCTAGAAATAGCG	1	bc
GGGCACTCCG	GAAACACCGGTGGCAGCCAGCCACTTGTGGGGTTAGAGCTAGAAATAGCA	1	bc
GTCTATGCCA	GAAACACCGGTACTAGGTACTTACGGGTGGGGGTAGAGAGCGAGATAGCA	1	bc
TGACCAGAGA	GAAACACCGGTCTTCCTGGAATGGAACGTGGGGTAAAGCTAGGAAAAACA	1	bc
CATCAATAAC	GAAACACCGGTGACAAACGTATGTAAGTGGGGTTAGAGCTAGAAATAGCA	1	bc
GTCTTTGTCA	GAAACACCGGTACTAGTTACTTACGGGTGGGGTTAGAGCTAGAAATAGCA	1	bc
AACAACATGA	GAAACACCGGTAATCTATAGATCCATGTGGGGATAGAGATCGAGTTGACA	1	bc
GCGTTAAGAG	GAAACACCGGTTGGCTTTACGCCTTTAGCTATAAACAACATGTTAACCTA	1	bc
CAATAACCGT	GAAACACCGGTGTTCGGAGATTATGCGTGAGAAATAGCAAGTAAACTAAA	1	bc
TAATTCTACT	GAAACACCGGTTTAGTTAGTTAACTAGTGGGGTTAGAGCTAGAAATAGCA	1	bc
AATACCAACA	GAAACACCGGTGGCAATTCGATCTGAGTGGGGTTAGAGCTAGAAGTAGCA	1	bc
CGTTACCACC	GAAACACCGGTTGGCTTTACTCCTTTAGCTATAAATAGCAAGTTAACCTA	1	bc
ATACAAGAAT	GAAACACCGGTTGTAAGCGATGGTTTGTGGGGTTAGAGCTAGAAATAGCA	1	bc
GCATCCCTCG	GAAACACCGGTAATCGTTACGCAGTGTGGGGGGTAGAGCTTGAAATAGCA	1	bc
GACCCCGTAA	GAAACACCGGTATTAGTTACTTATGGGGGTAGATATAGCAATAACAAGTT	1	bc
TTATTACACC	GAAACACCGGTCGCGAGAATGGGCCGGTGGGGTTAGAGCTAGAAATAGCA	1	bc
GCCATAAGCT	GAAACACCGGTAGTCGCCGTGGCGTGAGGTGTGGTTAGCGCTAGAACTAG	1	bc
GGCTTATACA	GAAACACCGGTTCTCATTGTTAGGTCGTGGGGTTAGAGCTAGAAATAGCA	1	bc
TAAACTTACA	GAAACACCGGTTTACGTTAGAGCGATAGATTAATACAAGAAATAGAAAGT	1	bc
ATCACCTGCG	GAAACACCGGTAGAATGCATCCACTTGTGGGGTTAGAGCTAGAAATAGCA	1	bc
CATTAACACC	GAAACACCGGTGGCAATTCGATCTGAGTGGGGTTAGAGCTAGAAATAGCA	1	bc
GATCCATATA	GAAACACCGGTGACCATGGTAAGTCAGTGGGGTTAGAGCTAGAAATAGCA	1	bc
ACCTATGGCA	GAAACACCGGGACGATTTAGCTAGAAGTAGCAAGATAACTAGAGGTTAGT	1	bc
CAGATACTAG	GAAACACCGGTTGTCTTTCATACTTTATCTAGATATAGCTAGTAATAGTA	1	bc
GAATAGGAAA	GAAACACCGGTACTCGTTACTTACGGGTGGGGTTAGAGCTAGAAATAGCA	1	bc
AAACCACTAT	GAGACACCGGTGACGAGAGGACGTTGGTGGGGTTAGAGCTAGAAATAGCA	1	bc
AACATTTTAT	GAAACACCGGTTTTCGATCGTAGGCCGTGGTGTTAGAGCTAGAAATAGCA	1	bc
AAACTCCTGG	GAAACACCGGTTTTGTATGGTGTTAGAGGTGGGAATAGCGAGATAAATAA	1	bc
AAATGAGCGA	GAAACACCGGTGTGCGGAGACTATGCGTGAGAAATAGCACGTAACCTAAG	1	bc
TATACACATT	GAAACACCGGTCTTCTTAGAATCTAGAAATAGCTAGTGATCGAAAGACCA	1	bc
GACCCAAACC	GAAACACCGGTGATCTAAGGATTACAGTGGGGATAGAGCTAGAAATAGCA	1	bc
TTAGACCCAA	GAAACACCGGTTTACTTAGTTAACTAGTGGGGTTAGAGCTAGAAATAGCA	1	bc
ATCACCTACG	GAAACACAGGTGGCAGCCAGCCACTTGTGGGGTTAGAGCTAGAAATAGCA	1	bc
AGACCCCTGC	GAAACACCGGTTTAGTATGGAGGGAAGTGGGGTTAGAGCTAGAAATAGCA	1	bc
GAACATGAAA	GAAACACCGGTTTTCGATCATAGGTCGTGGGGTTAGAGCTAGAAATAGCA	1	bc
TTCTTATACA	GAAACACCGGTGGCGAAAATGAGCGGGAGGGGTTAGAGGTAGAAATAGAA	1	bc
TGACAGGAAA	GAAACACCGGTGTTCTTTGCTTGCGGGGTGGGGTAGAGCTAGAAATAGCA	1	bc
AACTCGCAAC	GAAACGCCGGTTCGACCGGAGTCTTGAACAGGTGGGGGGGTTAGAGCTAG	1	bc
CATTCCTCAT	GAAACACCTTGGGGTTAGAGCTAGAAATAGCAAGTTAACCTAAAGCTAGT	1	bc
GGCATCATCG	GAAACACCGGTGGAAACAAGCAAATTGTGGGGTAAAACTTGGAATTACAA	1	bc
TGCCCAGCGT	GAAACACCGGTCTTCGTGGAATCTAAGGGGGAGAAGAGCTAGAAACAACA	1	bc
TTCTCTTACT	GAAACACCGGTTCCCGTTAGCTCGTGGGGATAGAGCTAGAAATAGCAAGT	1	bc
ACGATAATAC	GAAACACCGGTTGGCTTTACTCCTTTAGCTATAAATAGCAAGTTAACCTT	1	bc
TCAACAATAT	GAAACACCGGTGACGCGAGAACGATGGTGAGGTTAGAAATCGAAATCGAA	1	bc
TTCTAAAAGA	GAAATACCGGTGTGCGGAGATCTTGAGATAGCAATAGCAAGTAACCTAAG	1	bc
ATATCAACGA	GAAACACCGGTGGGGGGAGAGTATGAGTTAGCAATATAACGTAACCTAAG	1	bc
GCAATATCTC	GAAACACCGGTTGGCTTTACTCCTTTAGCTATAAGTAGAACGTTAACCTA	1	bc
GATCCAGTCA	GAAACACCGGTAATCTAGAAATCTACGTGGGGGTAGAGCTAGAAAAAGCA	1	bc
TGTTCAATCA	GAAACACCGGTTATCGTGGCGGAGTTTGTGGGAGTAGAGCTAGAAATAGC	1	bc
CCCTAACCGC	GAAACACCGGTAGAATGGGGTGGGGTTAGAGCTAGAAATAGCAAGTTAAC	1	bc
AAGACGCTAT	GAAACACCGGTCCGGTTAGAGCTATAAATATCAAGCTAACTTAAGGCTAG	1	bc
CAAATCAAAT	GAAACACCGGTTTACTTTATTAATTAGTGGGTTAAGAGCAAGTTAAACTA	1	bc
GAATCACACT	GAAACACCGGTTGTAAGCGATGGTTTGTGGGGTTAGAGCTAGAAATAGCA	1	bc
CTCTCACCCA	GAAACACCGGTGTGAGCAGATTATTCGTGAGAAATAGCAAGTAACCTAAG	1	bc
GTACTGTATC	GAAACACCGGTGATCATGGTTAGAGGTAGAAATAGGAAGTAAACATAGGG	1	bc
AACACTGTCA	GAAACACCGGTACTAGTTACTTACGGGTGGGGTTAGAGCTAGAAATAGCA	1	bc
CCCTATGTAC	GAAACACCGGTACTCGTTACTCATGGGTCTGTATAGAGCTAGTAATAGCA	1	bc
GGAATTTCTA	GCGGAGAGGACGAAACACCGGTTAGCGTTATCTCGTCGTGGGGTTAGAGC	1	bc
ATCCCCCCCT	GAAACACCGGTTGCAAGCGATGTCTTGTGGGGTTAGAGCTAGAAATAGCA	1	bc
GTGAACGACG	GAAACACCGGTGGCAGCCAGCCACTTGTGGGGTTAGAGCTAGAAATTGCA	1	bc
TACAACAAAT	GAAACACCGGTTTACTTAGTTAACTAGTGGGGTTAGAGCTAGAAATAGCA	1	bc
TATCCACAAC	GAAACACCGGTCGTACTGGAATCTGACGGGGGGTAGAGCTAGAAATAGCA	1	bc
ATCTTCATGA	GAAACACCGGTTTAGTATGGAGGGAAGTGGGGTTAGAGCTAGAAATAGCA	1	bc
GATTCCACCG	CTAAACACCGGTTATCGTTACGTATTTTGTGGGGATATAGCTAGTAATAG	1	bc
TTCTTATAAC	GAAACACCGGTCGTGTAAATGCGCGGGTGGGGTTAGAGCTAGAAATAGCA	1	bc
CCCCCACCCC	GAAACACCGGGAGGATAGATCCACAAATAGGGAGATAACTAAAGATAAGA	1	bc
TTATTCTCTA	GAAACATCGGTCGCGATAATGTGCCGGTGGGGTTAGAGCTAGAAATAGCA	1	bc
AGCATTAAAA	GAAACACCGGTTCTAATAGCTAGTTCGTCTGGTTATAGCTAGAAATAGCA	1	bc
TAATCAGATT	GAAACACCGGTCTTCCTGGAATCTTACGTGGGTTAGAGCTAGAAATAGCA	1	bc
AACGTGCTCT	GAAACACCGGTTTTCGATCATAGGTCGTGGGGTTAGAGCTAGAAATAGCA	1	bc
ACCTTACCGC	GAAACACCGGTGTGCTTTGATCCTTCATCTGTAATTAGAAGGAAAATAAA	1	bc
AAAAAAGTCG	GAAACACCGGTGACGCGAGGGCGGTGGTGGGGTTAGAGCTAGAAATAGCA	1	bc
ATACTGCACG	GAAACACCGGTTGTAAGCGATGGGTTGTGGGGTTAGAGCTAGAAATAGCA	1	bc
ATCTTATCAC	GAAACACCGGTCACGAAAGTGTGCCGGTGGGGTTAGAGCTAGAATTAGCA	1	bc
CAGATGATAG	GAAACACCGGTTGTCGATCATAGTTCGTGGGGTTATAGCTAGATATCGCA	1	bc
TAAATAAACT	GAAACACCGGTTTACTTAGTTAACTAGTGGGGTTAGAGCTAGAAATAGCA	1	bc
GAACTATATC	GAAACACCGGTGAGCATGATTAGACCTAGAAATAGCAAGTTAACCTAAGA	1	bc
GGAAACCAAA	GAAACACCGGTGGCAGCCAGCCACTTGTGGGGTTAGAGCTAGAAATAGCA	1	bc
AAAACACAAC	GAAACACCGGTGTTCTTTGCTCGAGGGTGGGGTTAGAGCTAGAAATAGCA	1	bc
GCAAACAACG	GAAACACAGGTGGCAGCCAGCCACTTGTGGGGTTAGTCTCGGCATAAGCA	1	bc
TACCTCACCC	GAAACACCGGTCGCGAAAGTGAGCTGGTGGGGTTAGAGCTAGAAATAGCA	1	bc
AAACCGCTAG	GAAACACCGGTTGTCGGTCATGGGTCGTGGGGTTAGAGCTAGAAATAGCA	1	bc
TAAAAACAGT	GAAACACCGGTTTACTTAGTTAACTAGTGGGGATAGAGAAAGAAACAGAA	1	bc
AAAATGCAAT	GAAACACCGGTTTACGTTCATAACTCGTGGGGTTAGAGCTAGAAATAGCA	1	bc
GACTCCACCA	GAAACACCGGTTATCGTTATGTATTTTTGGGGTTAAGAGTAAGAATAACC	1	bc
GCCACAAGCT	GAAACACCGGTGGCAATCGTGTCTAGGTGGGGGTTTAGATCTAGATATCA	1	bc
GGCTCTTCAA	GAAACAACGGTTCCAGTTAGTGCTGGAAATAGCAAGTGGGGGTAGTGCTA	1	bc
GCCTTGTACC	GAAACACCGGTTCAACTGGTTTCTTGTACCGGTGGCGGGGTTAGAGCTAG	1	bc
TTTTTATCAC	GAAACACCGGTCGCGAAAATATGCCGGTGGGGTTAGAGCTAGAAATAGCA	1	bc
TCGTCACCCC	GAAACACCGGTTAGTTTTAGTCAGTTATATCTATATAGCAAGACAACACA	1	bc
CACCGATGTT	GAAACACCGGTTCCAGCGGTTTCGAAGTGGGGTTAGAGCTAGAAATAGCA	1	bc
TCAGCACACC	GAAACACCGGTGGGGTTAGAGCTAGAAATAGCAAGTTGACCTAAGGATAA	1	bc
GGATTAGATT	GAAACACCGGTCTTCCTGGAATCTAACGGGGGGTAGAGCTAGAGATAGCA	1	bc
ATCTAGCAGC	GAAACACCGGTGTAAGGGGCTTATGGGAGCGGAAGAGGGGGTAGAGTAAG	1	bc
CGCTCAGTAA	GAAACACCTTGACGATAGAGCTAGAGATAGCAAGATAACCTAAGGCTAGA	1	bc
GTGTCTGTAA	GAAACACCGGTACTAGATACTTAGAAGTGGGGTTAGAGCTAGAAATAGCA	1	bc
TCCATTGTAT	GAAACACCGGTGAACACGACTACTTGTACAGATGGCGGGGTTAGAGCTGG	1	bc
ACAACCCAAC	GAAACACCGGTGATCCTAGGTCGGTGGTGGGGTTAGAGCTAGAAATAGCA	1	bc
GAAACACAAA	GAAACACCGGTTTACTTAATTAACGAGTGGGGTTAGAGCTAGAAATAGCA	1	bc
GTTCCAGAAA	GAAACACCGGTTGTAAGCGATTGTTTGTGGGGTTAGAGCTAGAAATAGCA	1	bc
CACAACTCCG	GAAACACCGGTGACAAACGTATGTCAGTGGGGTTAGAGCTAGAAATAGCA	1	bc
AATCGATTTG	GAAACACCGGTCACCGATCTAAGGGCGTGGGGTTAGAGCTAGAAATAGCA	1	bc
ATCCAACAGC	GAAACACCGGTGTGCTTTGCTCGTGGGTGAGGTTAGAGATGGAAATAGCG	1	bc
GTCATTTCTT	GAAACACCGGTGGGCCTGATTCTAGCTAGAACTAGCTAGCTTACCTCTGG	1	bc
AGTCAGTCAC	GAAACACCGGTGACATACGTTTGTCAGTGGGGTTAGAGCTAGAAATAGCA	1	bc
GAGATAAATA	GAAACACCGGTGAGCATGATTCGATCTAGAAATAGCAAGTTAACATAAGG	1	bc
GAGTAAACAA	GAAACACCGGTACTATTTACTCACGGGGGTGGATATAGCAAGATAAAGTA	1	bc
CAATCCCCCG	GAAACACCGGTATTATACAATGGGAACAGGAGATAGAGAGATAAATTAAG	1	bc
TGAAAGCAAT	GAAACACCGGTGTTCTTTGCTCGAGGGTGGGGTTAGAGCTAGAAATAGCA	1	bc
TAAACTTACT	GAAACACCGGTTCCCTTAGGTACCTAGTGGGGTTAGAGCTAGAAATAGCA	1	bc
GAAATATCAA	GAAACACCGGTGAGCATGATAAGAGCTAGAAATAACAGGTTAACCTAGGG	1	bc
AACAGAGCTA	GAAACACCGGTGGGCGGGATTTCGGCGTGGGATAAAGAGTATAAATAGCG	1	bc
GGCCACGACT	GAAACACCGGTGGCAGCCAGCCACTTGTGGGGTTAGAGCTAGAAATAGCA	1	bc
GAACAAATCC	GAAACACCGGTACTCTAAAGATCCCCGTGGGGATAGAGCTAGAAATAGCA	1	bc
GCCAAAAGCT	GAAACACCGGTGGCCGCCGTGGAGAGTGGTGGGGTTAGAGCTAGAAATAG	1	bc
CAGTCCATGG	GAAACACCGGTTTACTATGGGGGAAGTGGGGTTAGAGCTCGACATATAAC	1	bc
ACCTCGATGA	GAAACACCGGTTTAGCATGGAGGGTAGTGGGGTTAGAGCTAGAAATAGAA	1	bc
GCCCCCGCCC	GAAACACCGGTAGTATGGGGTGGGGTGAGAGCTAGAAATAGCAAGTTAAC	1	bc
TACACCGTCA	GAAACACCGGTACTAGTTAGTTACGGGTGGGGTTAGAGCTAGAAATAGCA	1	bc
CGGCAAACAC	GAAACACCGGTGTTCTTTGCTCGAGGGGGGGGTTGGAGCTAGAAATAGCA	1	bc
AAACGGCACA	GAAACACCGGTTGTGGGCGACTCGGTGTGGGAGAAATGGCAAGTTAACCT	1	bc
TTAATCTTTT	GAAACACCGGTGAGCATGATTAGAGCTAGAAATAGCAAGTTAACCTAGGG	1	bc
ATCAAGCCGG	GAAACACCGGTTTTCGATCATAGGTCGTGGGGTTAGAGCTGGAAATTGCA	1	bc
GCCTCTGTCT	GAAACACCGGTACTAGTTACTTCCGGGTGGGGTTAGAGCTAGAAATAGCA	1	bc
AATACAGCAG	GAAACACCGGTGACAATTGTGGGGTTAGAGGTATGGAGATCGAGATAACC	1	bc
CGGTCAGATC	GAAACACCGGTCTTCTTTGATTCTAACGGGGTAAAGAGCTAGAAATAGTA	1	bc
GGGCGGGATA	GAAACACCGGTCGTCGTTCGTAGGGGTTTGAGTTAGAAATAGCAAGATAA	1	bc
GGGCGGGATA	GAAACACCGGTCGTCGTTCGTAGGGCGAGAAGTTACAGCTAAAACTAACA	1	bc
GAGTGGGCCA	GAAACACCGGTTGTGGGGAACTCGGTGTGGGAGAAATAGCAAGTTAACCT	1	bc
CCTTTAAAAA	GAAACACCGGTTGGCTTTACTCCTTTAGCTATAAATAGCAAGTTAACCTA	1	bc
TAACCGCATT	CAAAACACCGGTTTACTTAGTTAACTCCTGGGGTTAAAGCTAGAGAAAGC	1	bc
TAATGCTCAT	GAAACACCGGTTTAGTTAATCACCTTGTGGGGGAAGAGCCAGAATAAGCA	1	bc
CACAAGATTT	GAAACACCGGTGCTAGCGGTTTCGAAGTGGGGTTAGAGCTAGAAATAGCA	1	bc
GAGAACAGCG	GAAACACCGGTGGCAGCCAGCCACTTTTGGGGTTAGAGCTAGAAATAGCA	1	bc
ATGCACCTCC	GAAACACCGGTTCCCGTTAGCTCGTGGGGTTAGAGCTAGAAATAGCAAGT	1	bc
AATTCAGAGA	GAAACACCGGTGGCAATTAGATGTGAGTGGGGTTAGAGCTAGAAATAGCA	1	bc
AAAAATGTCT	GAAACACCGGTGCCCTTCATGGGATCGTGGGGTTAGAGCTAGAAATAGCA	1	bc
ATATAAAAGA	GAAACACCGGTGTGCGGAGATCTTGAGAGAGCAATAGCAAGTAACGCAAG	1	bc
CTGTTAGCAA	GAAACACCGGTCGGATAAACTCAGGGATATATATAGAACAAGTAAATTAA	1	bc
CTGCCAAGAT	GAAACACCGGTTGGAATCGATGGTTTGTGGGGTTAGAGCTAGAAATAGCA	1	bc
AATAAGGTAG	GAAACACCGGTTTTCGTTCAGAGGTCGAGGGGTTAGAGCTAGAAATAGCA	1	bc
AAATTAGCAA	GAAACACCGGTGCTAATAGTTAGCTCGTGGGGTTAGAGCTAGAAATAGCA	1	bc
GCCAAAAGCT	GAAACACCGGGGGTCGCCGTGGAGAGTGGTGGGGTTAGAGCTAGAAATAG	1	bc
AATACTTCCT	GAAACACCGGTTCCCTTTATGGGACCGTGGGGTTAGAGCTAGAAATAGCA	1	bc
ACGCAGACAC	GAAACACCGGTGGTCTTTACTCGTGGAGCTATATATAGCAAGATATAGCA	1	bc
GATACATCCC	GAAACACCGGTGACCCAAAGATGCCCGTGGGGTTAGAGCTAGAAATAGCA	1	bc
GCCAAAAGCT	GAAACACCGGCGGTCGCCGTGGAGAGTGGTGGGGTTAGAGCTAGAAATAG	1	bc
