CCCTAAACGA	GAAACANCGGTGTGCGGAGATTATGCGTGAGAAATAGCAAGTAACCTAAG	1	bc
GATTCAAACA	GACACANCGGTGGCAGTTCGATCTGAGTGGGGTTAGAGATAGAAGTAGCA	1	bc
CCGTCAACCG	GAAACACCGGTTGGCTTAAATCCTTTAGCTATATATAGCTAGTTAACCTA	1	bc
CCTACTGCCC	GAAACANCGGTTCCCCCGGCGGCTTCATCCGGTTGGAGCTATAGATCTCG	1	bc
ACCTTAAAAC	GAAACANCGGTTGGCTTTACTCTTTTACTTATAATTACAAGGTAAACTAA	1	bc
TAAACCATCA	GAAACACCGGTTTCGCGCGGAGGGAGGTGGGGTTAAAGCTAAGAATAGCA	1	bc
GCCTTGTACC	GAAACANCGGTGCAAACGACTACTTGTACCGATGGGGGGGTAAGAGCTAG	1	bc
ACTTTATCAC	GAAACANCGGTTACATTCGCTCCTTAGGGTGTATATAGCTAGTTATCCTA	1	bc
AAAATAAAAG	GTAACANCGGTTTTCTTTCATCGTTCATGGGTTTAGAGCTAGAAATCGTA	1	bc
AACACCCTTC	GAAACANCGGTATTGTATGGAGTCCAGTGGGGTTAGAGCTAGAAATAGCA	1	bc
TTTTGGTCAC	GAAACACCGGTTGCGGGGAACTCGGTGTGGGAGAAATAGCAAGTTAACCT	1	bc
AAACTATATA	GAAACANCGGTGAGCATGATTAGAGCTAGAAATAGCAGGTTAAACTAAGG	1	bc
AGATACCCCC	GAAACANCGGTGGCCTTTGCTCGAGGGTGGGGTTAGAGCTAGAAATAGCA	1	bc
CCCTCCCTCA	GAAACANCGGTTCAATCGGCGTCTTGAAACGGAGGGGGGGCTAGAGCTAG	1	bc
ATTAACGACG	GAAACANCGGTCCTAGAAGCTAGAAATAGCAAGTTAACCTAAGGCTAGTC	1	bc
TGTTCTTACT	GAAACANCGGTTCCCGTTAGCTCGTAGTGGGGTTAGAGCTAGAAATAGCA	1	bc
CCATTAATGC	GAAACANCGGTTGAGTTTACTCCTTTAGGTATAAGTGGTAGAATTAGCAA	1	bc
AACATACAAT	GAAACANCGGTTTTCGATCATAGGTCGTGGGGTTAGAGCTAGAAATAGCA	1	bc
ATCAAACACC	GAAACANCGGTGACCATCGTTAGTGCTTGAGATAGCAACTTGACCTAACG	1	bc
CAACGAACAC	GAAACANCGGTGCTAGTGGTTTCGAAGTGGGGTTATAGCTAGAAATCGCA	1	bc
GAATTATATC	GAAACACCGGTGGGCATGATCAAAACTAGGGGTAGAGCGAGAACTAGCAA	1	bc
GCAACACACC	GAAACANCGGTTCAACAGGCATCTTGAGCCGATGGGGGGGTTAGCGCTTG	1	bc
GGAATAAACA	GAAACANCGGTGCTAATAGGTAGCTCGTGGGGTTAGAGCTAGAAATAGCA	1	bc
AATATAACCC	GAAACACCGGTGCCCTTTATGCGATTGTGGAGTTAGAGCTAGAAATAGTA	1	bc
GATCTATCTC	GAAACANCGGTGACAAACGTATGGCAGTGGGGTTAGAGCTAGAAATAGCA	1	bc
TGAAATTAAT	GAAACANCGGTGCCCGTTGGCTCGGGGTGGGGTTAGAGCTAGAAATAGCA	1	bc
GCATTGCAAA	GAAACANCGGTGCTAATAGTTAGCTCGTGGGGTTAGAGCTATAAATATCA	1	bc
TACTATGTCC	GAAACANCGGTTGTGGTTATTTACGGGTGGGGTTGGAGTTAGAAATGGCA	1	bc
CCGACAACAG	GAAACANCGGTCGGCTTTACTCCTTTAGGTATAAATAGCAAGATAACCTA	1	bc
TTCTCATCCT	GAAACACCGGTCTCGATGATGTGCCAGTGGGGTTAGAGCCAGAAATAGCT	1	bc
CAACTATATA	GAAACACCGGTGAGCGCGGTTACGAGGTAGAGCTAGAGCTAGAAAGTTAA	1	bc
CCACCAAGAA	GAAACACCGGTAGAGTGAGACCTAGAGATAGCAAGGTAATCTAAATCGAG	1	bc
CAACCCATAC	GAAACANCGGTTTAGTATGGAGGGAAGTGGGTTAGAGCTAAGAATAGCAA	1	bc
TCAGACCTGT	GAAACACCGGTGACGCGAGGACGGTGGTGCGATTAGAGCAGGAACTAGAA	1	bc
CAAATAGAGA	GAAACACCGGTGCTTATGATTAGAGCTAGAGATATCAAGTTAATCTAACT	1	bc
TGTCCAGTCC	GAAACANCGGTGTTCCTGGTATCTAATGTGGGGTAGAGTTAGAAATAGCA	1	bc
TACTCCCACC	GAAACANCGGTTTACTTAGTTAATTAGTGGGGTGAGAGCTATAAACAGAG	1	bc
CACTCGGACT	GAAACANCGGTACAAGCGGCGTCTTGAACCGGTGGGGGGGAGAGAGCGAG	1	bc
TGAAATAAAA	GAAACANCGGTGCTAATAGTTAGCTCGTGGGGTTAGAGCTAGAAATAGCA	1	bc
GACAACCTCC	GAAACANCGGTAATCTAAAGATCCCCGTGGGGATAGAGCTAGAAATAGCA	1	bc
GCCGAAAAAA	GAAACANCGGTGGGGGTAAAGCTATAAATAGCATATTAACCGAAATAGAA	1	bc
GAGTCCGTCG	GAAACANCGGTCATCGAAACTGGTAATGGGGAGTTAGCTCAAGAAAGGAC	1	bc
AGCTGCTAAG	GAAACANCGGTGGCAGCCAGCCAGTTGTGGGGTTAGTGCTAGAAATAGCA	1	bc
AGCGACTTCG	GAAACANCGGTGGCAGCTAGCCACTCGTGGGGTTAGAGCTAGAAATAGCA	1	bc
TAGATCATCT	GAAACANCGGTTTAGATAATCAAAAAGTGGGGTTGAGCTAGAAATAGCAA	1	bc
AAGTAAAACG	GAAACANCGGTTATCGTTACTGGTTTTGTGGGGTTAGAGCTAGAAATAGC	1	bc
GAATCAAAGC	GAAACANCGGTGCTACTAGTTAGTTCGTGGGGTTAGAGCTAGAAATAGCG	1	bc
AACACACCAT	GAAACANCGGTGTACGGAGTTTATGAGTGGGGATAGAGCAGGAACTAACA	1	bc
CATGAACACA	GAAACANAGGTGGCAATTAGATCTGAGTGGGCATAGAGCTAGAAATAGCA	1	bc
GAAATATACC	GAAACACCGGTGAGCATGATAACTAGAAATAGCAAGTTAACCTATAGCTA	1	bc
TAAGTCCAAA	GAAACANCGGTGCACTTAGTTAACTCGTGGGGTTAGAGCTAGAAATAGCA	1	bc
AAGATAACAC	GAAACANCGGTTTGCTTTAGTCCTTTGGCTAGAGATAGCAAGTTAAAGTA	1	bc
GATTCAACCA	GAAACANCGGTTATCGTTAAGGATTTTGGGGGGTTAGAGCTAGATATAGT	1	bc
GACAAAAACT	AACAAACANGGGTTGGTTATTTTACTAGAGGTGTTAATAGCAAGATAACC	1	bc
ATCAAAGCCG	GAAACANCGGTCCTCGGAGATTATGCGTGAGAAATAGCATGTAACCTAAG	1	bc
AATCAGCAAA	GAAACANCGGTGTTATTTGCTCGAGGGTGGGGTTAGAGCTAGAAATAGCA	1	bc
AATCTAACCT	GATACANCGGTGTGCGTTGATTCTGCGTGAGAAATAGCCAGGAACCAGAG	1	bc
GAATTAGCTA	GAAACACCGGTTTTAGTAAATGGTGAGTGGGGTTAGAGCTAGAAATAGCA	1	bc
CTCCCGCACT	GAAACANCGGTTCAACCGGCGGCTTTGTCCGGTGGGGGCGATGGAGCTAG	1	bc
CCCACTCACT	GAAACANCGGTTCAACCGACCTCTTAAAGGGGTTGGGGGTATAAATCTCG	1	bc
GACTCGCCCA	GAAACANCGGTTCTAGCGGCTTCTTGGTGAGGTTGGGGGTGTAAAGCTAG	1	bc
AAACTCATCC	GAAACANCGGTTGAGTTTATCAGAGGGTGTAGTGCTGCTAGTAGTAGCAT	1	bc
TAAACCCAAT	GAAACACCGGTTTACTTAGTTAACTAGTGGGGTTAGAGCTAGAAATAGCA	1	bc
GTATTATACC	GAAACANCGGTCGCGAAAATGAGCCGGTGGGGTTAGAGCTAGAAATAGCA	1	bc
AACCCGCCAG	GAAACCNCGGTTTTAGATAATAGGAAGTGGGGTTAGAGCTAGAAATAGCA	1	bc
TAATCAGCTT	GAAACANCGGTATTAGTAAATAATAAGGGGGGTAAGAGCTAGAAATAGCA	1	bc
TGAACAAATA	GAAACANCGGTCGGGCTAGAGCTAGAAATAGCAAGTTAACCTAAGGCTAG	1	bc
CACTGACCTT	GAAACACCGGTGCGCGCGGTTTACGAGTGGGAATAAGCCTGGAACCTACG	1	bc
AATCCGGTTG	GAAACANCGGTTTTCGTTGATAGTTAGGTGAGTTAGAGCTAGAAATAGCA	1	bc
GATTACCACG	GAAACANCGGTGGCAGCCAGCCATTTGTGGGGTTAGAGCTAGAAATAGCA	1	bc
ATCCCATCGC	GAAACANCGGTGACAAACGTATGTCCGTGGGGTTAGAGCTGGAAATAGCA	1	bc
CTGTTCACCC	GAAACACCGGTCGCGTTTACCCCTTATAGCATGATTACCTAGTGAACCTA	1	bc
CTTTCCCACA	GCAACACCGGTGGCAATTCGATCTGAGTGGGGTTAGAGCTAGAAATAGCA	1	bc
GTCTTTTAAA	GAAACANCGGTGCGAGTGACTAAAGGTCGGGATAGGAGGTTAAAATAGGG	1	bc
AATTAACAGA	GAAACANCGGTGGCAATAGATTCTGCGTGGGGTTTAGCATGTAAATTAAG	1	bc
