TGACCGTAAC	GAAACANCGGTGCTCTTTGCCTCGGGGGGGGGTTTAAGCTAGGAAAAGCA	1	bc
GGCTACTCCA	GAAACACCGGGGGGAGACAGCTACTCGTAGGAAGTTAGCCTGAAACTACT	1	bc
AAAAACGCCT	GAAACACCGGTGTACTTTATTGACCAGTGGGGTTAGAGCTAGAAATAGCA	1	bc
CGGCAGTATG	GAAACANCGGTGGTCGCTCGCAGGGCGTGGGGTTAGAGCTAGAAATAGCA	1	bc
ATATCAGCAG	GAAACANCGGTTTTAGTAAATTGTGAGTGGGGTTAGAGCTAGAAATAGCA	1	bc
AGATTGCTCC	GAAACANCGGTTGAGTTAGTCAGAGGGTGGGGTAAGACTAGGAATAGCAA	1	bc
TAAGAAAAAC	GAAACANCGGTGTTCTTTGCTCGAGGGTGGGGTTAGAGCTAGAAATAGCA	1	bc
GACTTAGTCA	GAAACANCGTTACTAGTTACTTACGGGTGGAGTTCGAGCTAACAAAAGGA	1	bc
AATCGAGCTC	GAAACACCGGTGACAGAGCTAGAAATAGCAGGTTAACCTAAGGCTAGTCC	1	bc
GAGTTAGCAG	GAAACACCGGGTGGCTTAAATCGTTTTTGTATAAGTAGCAAATTAACCTA	1	bc
CATCGAGTTA	GAAACACCGGTCGTCATTCGTAGTGCGTGGGGTTAGAGCTAGAAATAGCA	1	bc
TCTGCAACCA	GAAACANCGGTGCGGTTAAAGCTAGAGATGGCATGTTGACCTAAGGATAG	1	bc
GCATATGAAA	GAAACANCGGTACTAGTTGCTTACGGGTGGGGTTAGAGCCAGAAATAGCA	1	bc
CTCAAACCCA	GAAACANCGGTTTGCGGAAATTATGAGTGTGGAATAGCAAGGAAACAGAT	1	bc
CGATGAAAAA	GAAACANCGTTGGGCGTTCATAGGGCGAGAGGTTAGAAATCTAAATAGCA	1	bc
TACTACTTCC	GAAACANCGGTTGAGGTAAGCCAAAAGTGGGGTAGGGGTAGGAAAAGCAA	1	bc
TGTTCATAAC	GAACCANCTTGGGGTTAGAGCTAGAACTAGCAAGTTAACCTAAGGCTAGT	1	bc
GCAAATGTAA	GAAACACCGGTACTAGTTACTTACGGGTCGGGTTAGAGCTAGAAATAGCA	1	bc
ACCTCGTCAC	GAAACACCGGTGAAAGAGCCGTCAAGAACCGGTGGGGGGGAGAGAGCTAC	1	bc
GGGCAGCAAA	GAAACANCGGTGCTCTTTGCTTGAGGGTGGGGTTAGAGCTAGAAATAGCA	1	bc
TTGCCCGATG	GAAACACCGGTCTTCCTGGAATCTAACGTGGGGTTGAGCTTGGAATTGCA	1	bc
ACACTCACGA	GAAACANCGGTTTAGTATAGAACTGGGGCTAGAGCTAGCAATAGCAAGTT	1	bc
CTGTGGGCGG	GAAACANCGGTCGTCGTTGGTAGGGCGTGGGGTTAGAGCTATAAATAGCA	1	bc
CGGTGATTAA	GAAACANCTTTGGGTTAGAGCTAGAAATAGGAAGATAACCTAAGGTTAGT	1	bc
CTGAGCGTTG	GAAACANCGGTCCTCGATGGTAGGTTGTGGGGTTAGAGCTAGAAATAGCA	1	bc
TGTCTAACAT	GAAACANCGGTTGTCCTGGAATCTAACGTGGGATAGAGCAAGAAAAAGCA	1	bc
ATCTATGTGA	GAAACACCGGTCCTAGTTACTTACGGGTGGGGTTAGAGCTAGAAATAGCA	1	bc
CACCGCGCCT	GAAACANCGGTCCTAGAAGTTTCGCGGTGGGGTTATAGCTACAAATTGCC	1	bc
GACTATCTCC	GAAACANCGGTACTAGTTACTTCCTGAACCGGTGAGGGCTATAAATCTAG	1	bc
GAGTCCTCCG	GAAATACAAATTATCGTTACGGCTTTTGCGGGTTCAGAACTAAAAATAGC	1	bc
ATGCAGCACC	GAAACACCGGTGTTATTTGCTCGAGGAGGGGGTGAGAGCTAGAAATAGCA	1	bc
AATACTTCAT	GAAACANCGGTTCCCGACGGATGGCAGGGGGGGTTAGGGTAGGAATTACC	1	bc
ATCCAGGCTG	GAAACANCGGTCGTCGTTCGTTGTGCGTGAGGTTAGAGCTAGAAATAGCA	1	bc
CGGCGGGCAA	AGGGCCGAAACANAGGTGTCGGGGGACTGGGGGGGGGATAGAGAGCGAGT	1	bc
ACTTCAAGCG	GAAACANCGGTTATCATACAAATTATAGGGGGTTAGAGCTAGAAATAGCA	1	bc
GATCCACCCC	GAAACANCGGTTACAGAGCTAGACATGGGAGGTTAGAGCAAGACATAGCA	1	bc
CTACCCCACC	GAAACACCGGTTGTAAGCGATGGTTTGTGGGGTTAGAGCTAGAGATAGCA	1	bc
GAACCCAAAA	GAAACACCGGTTTTGTATGGAAGCGCGGTTAGATCTAGAAATAGCAAGTT	1	bc
CGTTGGGCAG	GAAACACCGGTTGTGGGTCACTCGGTGTGGGGTAAAAGGCAAGATAACCT	1	bc
TTGTAAACGT	GAAACACCGGTTGGCTTTAATTCTTTAGTTATAAATAGCAAGAAAATCCA	1	bc
ATGCCCTCGC	GAAACANCGGTCCTAGAAGCTGGGGTTAGAGCTAGAAATAGCAAGTTAAC	1	bc
GACAACCTCC	GAAACANCGGTAATCTAAAGATCCCCGTGGGGATAGAGCTAGAAATAGCA	1	bc
ATAAAACTCC	GAAACANCGGTAGTCAGCGGTCGCTTGTGGGGTTAGAGCTAGAAATAGCA	1	bc
TATTCATAAC	GAAACANCGGTGGCAAATCGATGTCAGTGGGGTTAGAGCTAGAAATAGCA	1	bc
CCACCCACAA	GAAACACCGGGTTGTTATAGCCGTGAAGTTATAGCTAGCAATAGCACGTT	1	bc
AAATTACACT	GAAACANCGGTTGTAAGCGATGGTTTGTGGGGTTAGAGCTAGAAATAGCA	1	bc
TCAAGGCTAA	GAAACANCGGTTACGGGGGGCTGGGGGTGGGGGTAGTGGCAGAATAAGCT	1	bc
TGCTTAGACC	GAAACANCGGTCGCGAAAATGTGCAGGGGGGGGTAGAGCTAGAAATAGCA	1	bc
CGCAACGATT	GAAACACCGGTGGCCGCTAGTAGGGCGTGGGGTTAGAGCTAGAAATAGCA	1	bc
TACCCCGTAT	GAAACANCGGTCTTCCTGAATCTAACGTGGGGTAGAGCTAGAAATAGCAA	1	bc
TACACAATAA	GAAACANCGGTTTTCGATGATATACAAATAGCAAGCTAACCTAAGCAAAG	1	bc
GAATAAATCA	GAAACANCGGTGCTCATAGTTAGCTCGTGGGGTTAGAGCTAGAAATAGCA	1	bc
TGCTTATCAA	GAAACANCTTGCGCTTAGATCTACAAATAGCAAGTTAACTTAAGGCTAGT	1	bc
GACTCACTAA	GAAACANCGGTCCTAATTACATCCGAGTGGGGTTAGAGCTAGAAATAGCA	1	bc
TGGCCAGAAC	GAAACANCGGTCTTCCTGGCATCTAACGCGGGGTAGAGCTAGAAATAGTA	1	bc
ATCTACCTCT	GAAACACCGGTGGGCGGAGATTAAGCGAGAGAGATAGCAAGTAACCTAAG	1	bc
GAGTTCAACA	GAAACANCGGTGCTAATAGTTAGCTCGTGGGGTTAGAGCTAGAAATAGCA	1	bc
GCCAAAATGA	GAAACANCGGTGGGCGCCGTGGAGACAAGAAGTGGTCGCCTTGGGGGTAG	1	bc
ACTGTGTAAC	GAAACACCGGTACTAGTCACTTACGGGTGGGGTTAGAGCTAGAAATAGCA	1	bc
ACATCGCAAC	GAAACANCGGTGCAACCGGCGTCTTGAAGCGGTGGGGGGTATAGATATAG	1	bc
CGGCTGGTAC	GAAACACCGGTCGTCGTTCGTACGTCGTGGGGTTAGAGCTAGAATTAGCA	1	bc
ATCACACTAG	GAAACACCGGTTGTAGATCATAGTTCGTGGGGTTAGAGCTAGAAATAGCA	1	bc
CGGTGGGCTC	GAAACANCGGTCGCCGTTCGTTGGGGGTGGGGTTAGAGCTAGAAATAGCA	1	bc
AACAAACGCA	GAAACACCGGTAAGCGAAGAATATCCGTGGGAAAAAGGCAAGAAATAAAA	1	bc
AATACGGCCC	CTAAACANCGTTGTCCTTTATGTGTTCGTGGGGTTAGATCTAGCCATCGC	1	bc
CGCCGGGGTC	GAAACANCGGTAGTCGTTCGTCGGGCGTGGGGTTAGAGCTAGAAATAGCA	1	bc
TACGAAGTAA	GAAACANCGGTACTAGTTACTTACGGGAGGGGTTAGAGCTAGAAATAGCA	1	bc
CAACGCGCCT	GAAACANCGGTGCCAGCGGTGTCGCGGTGGGGTTATAGCTAGAAATAGCA	1	bc
CCTCGCCCAC	GAAACANCGGTAGCATGGATCCACGTGGGGGGTTAGAGTTAGAAATGGCA	1	bc
GCCTCATCCT	GAAACACCGGTCGCGGCTGTGTAGACATGGAGCTGTCCACAGCGAGTTAG	1	bc
ATTCCCGTCT	GAAACANCGGTCCTAGAAGCTTGTGTTAGAGGTAGAAATAGCAAGTTAAC	1	bc
GAGTTATGCA	GAAACANCGGTTATCATTCGTATTTTGTGAGGTTAGAGCTAGAAATAGCA	1	bc
