GAGTCAAGCG	GAAACACCGGTTATCGTTACGGATTTTGTGGGGTTAGAGCTAGAAATAGC	2	bc
TTCACCTTCC	GAAACACCGGTTCCCGTTAGCTCGTAGTGGGGTTAGAGCTAGAAATAGCA	1	bc
TCCAGCCACC	GAAACANCGGTAGAGGGGGTAGAGCTAGAAATAGCAAGTTAACCTAAGGC	1	bc
TCAAAACTCA	GAAACANCGGTGACGCGAGGACGGTGGTGGGGTTAGAGATAGAAATAGCG	1	bc
ATTAACGACG	GAAACACCGGACATAGAAGCTGATATAGCAAGGATAGAGCTAGAAATAGC	1	bc
TCCTTAAACC	GAAACANCGGTGAGCATGATAACGTCGTGGGGTTAGAGCTAGAAATAGCA	1	bc
TCCCCCCAAT	GAAACANCGGTTGGGTTATTAAACTAAATAGCATCAAGATAACATAAGGA	1	bc
TACTCATCCC	GAAACACCGGTTCCCGTTATCTCGTAGTGGGGTTAGAGCTGGAATTGGAA	1	bc
CAATTAAACC	GAAACANCGGTTCTGACGATCTCGAAGTGGGGTAAGGCTTAGAATAACCA	1	bc
TCATTCCTCC	GAAACANCGGTGACGCGAGGACGGTGGGGGGTTTCGAGTTAGCAATAGCA	1	bc
AATACCGTCA	GAAACACCGGTCCTAGATGCTGAGTTTGTGGGGTTGGGGTTAGAAATACC	1	bc
GGCCCCTACT	GAAACANCGGTCGCACCCAGCCAATAGCGGGATTAGAGCTAGAAACAGCA	1	bc
TCAGCCACAC	GAAACACCGGTAGGGGGGTTAGAGCTAAAAATAGCAAGATAACCGAAGGC	1	bc
TTACCAGGCT	GAAACANCGGTCTTCCTGGAATCTAACGTGGGGTAGAGCTAGAAATAGCA	1	bc
GAGAACCTTA	GAAACANCGGTAATCTAAAGATCACCGAGGGGATTGAGCTAGAAATAGCA	1	bc
CGACTATTTA	GAAACANCGGTCAGCATGCTAACGTCGTAGGGCTAGAGCTAGAAAGATCA	1	bc
GGTTCAAGAG	GAAACANCTTTGATCTAGAGGTAGTTTTTGGGGTTAGACCTAGGAATAGC	1	bc
GAACATGAAC	GAAACANCGGTGTTCTTTACTTACGGGTGGGGTTAGAGCTAGAAATAGCA	1	bc
ATGCACCACG	GAAACANCGGTGTTAGTTGCTCACGATGTGGGGTTTAAGCCAAAAATAAT	1	bc
TGCCAGCTAC	GAAACANCGGTGATCTTTGCTCCGGGGTGGTGTTAGAGCTAGAAATAGCA	1	bc
CCATAACCAC	GAAACANCGGTTGGCTTTACTCCTTGAGGTATAAATAGCAAGATAACCTA	1	bc
TACAGAGATT	GAAACANCGGTGCTAGCGGTTTCGAAGTGGGGTTAGAGCTAGAAATAGCA	1	bc
AAACAGCCCC	GAAACANCGGTGTTCGTTGCTCGAGGGTGGGGTTAGAGCTAGAAATAGCA	1	bc
TCCGCATCCT	GAAACANCGGTTCCGGTTAGCTTGTAGATAGGATAGTGCTATAAGGCGCG	1	bc
GATCTATATC	GAAACACCGGTGACCATGGTATGGTCGTGGGGTTAGAGCTAGAAATAGCA	1	bc
TATACCCTCA	GAAACANCGGTGGCGAGACGGCGTGGGTGGGGTTAGAGCTAGAAATAGCA	1	bc
GTCAACGTAA	GAAACACCGGTCCAAATTACTAACGTGTGGTGTTACAGCTAGAAATAGCA	1	bc
AACTATTTAC	GAAACANCGGTAGGGGCTGAGTTCGAAAGAGGAAGTTAACCTAAGTCGCG	1	bc
AGGACTGTCT	GAAACANCGGTCCTAGAAGCTGAGTTTGTGGGGTTAGAGCTAGAAATAGC	1	bc
ACTCCATAAA	GAAACACCGGTGACAAAAGAGTTAGAAATAGGAAGTAAACATAAGGATAG	1	bc
TGAGCAGAAT	GAAACACCGGTGTGGTTGGAGTCTGAAGTGGCGAAGTGACAGAAAGAGAA	1	bc
CCCTGACGAC	GAAACACCGGTTGTGGGGTTAGAGCTAGAAATAGCAAGTTAACCTAAGGA	1	bc
CCATCCCTCC	GAAACANCGGTGAAGCCAGGGCGGTGGACCGGTTAGAGCTAGAAATCGCA	1	bc
GACAGCGCCC	GAAACANCGGTTATCGAAAGATCGCCGTGGGGATAGAGCTAGAAATAGCA	1	bc
TCCGCAACCA	GAAACANCGGTGGGCGTAGAGCTAGAAATAGCAAGTTAAACTAAGGCTAG	1	bc
AGTTGATAAA	GAAACANCTTGGGGTTAGAGCTAGGAATAGCAAGTAAACCTAAGGATAGT	1	bc
CCAGGAGAAT	GAAACACCGGTGCTAGCGGTTCCAAAGAGGGGATATAGCCAGAAATAGCA	1	bc
TAATCGATCC	GAAACANCGGTGGGGATGATCACGACGTGGGGTAAGGCTAGGAATAGCCA	1	bc
TAAACACTCC	GAAACANCGGTGAGGCGAGGCCGGTGGAGGGGATCCAGCTACAAATAGCA	1	bc
CAAAGAGTAT	GACACCNCGGTGCTACGGGTTTAGTAGTGGGGTTAGAGCTAGAAATAGCA	1	bc
CATGTGCAGA	GAAACACCGGTCTTCCTGGAATCTAACGTGGGGTAGAGCTAGAAATAGCA	1	bc
TAAACACACA	GAAACANCGGTGGTCTTAGGGCTGGAACTAGCAAGTTAACCTAAGTCTAG	1	bc
TGCACGTCTG	GAAACANCGGTTCCCGTTAGCTCGTAGTGGGGTTAGAGCTAGAAATAGCA	1	bc
CACCGAAGCC	GAAACACCGGTAGTGGGGTTAGAGCTAGAAATAGAAAGTTAACATAAGGC	1	bc
CCAAGCTGTA	GAAACANCGGTGAGCTGGATAACCGGGTGGGGTTAGAGCTAGAAATAGCA	1	bc
ATCTAGCACC	GAAACANCGGTGTTCTTTGTTTGAGGGTGGGGTTAGAGCTAGAAATAGCA	1	bc
TCATTAATCC	GAAACANCGGTTGAGATAATCAAAAAGTGGGGTAGAGCTAGAAATAGCAA	1	bc
ATCATGCTAA	GAAACANCGGTGTTCAATATTAGGTCGTGGGGTTAGAGCTAGAAATAGCA	1	bc
GAATCTGAAA	GAAACANCGGTACTCGTTGCTTACGGGTGGGGTTAGAGCTAGAAATAGCA	1	bc
CGTTCATTCC	GAAACANCTTGGGGTTAGAGCTAGAAATAGCCAGTTTACCTAAGGCTAGT	1	bc
CTGAGCGTTG	GAAACANCGGTCCTAGCAGCTGAGCTTGTGGGGTTAGAGTTAGAAATAGC	1	bc
AAACTATGTA	GAAACANCGGTAAAAGTTACTTACGGGGGGGGTTAGAACTAGAAATAGCA	1	bc
GAAAATTATG	GAAACANCGGTGCCCTTGATGGGGCCGTGGGGTTAGAGCTAGAAATAGCA	1	bc
GAATAGGAAA	GAAACANCGGTCCTAGTTACTTACGGGTGGGGTTAGAGCTAGAAATAGCA	1	bc
GTATTATCTC	GCAACANCGGTTTGCGTAATTGGAGCTCGCCGTCGCAGGTTGACATAGAG	1	bc
AAACAGCATA	GAAACANCGGTGTTCTTTGCACGGGGGTGGGGTTAGAGCTAGAAATAGCA	1	bc
TCAGTTAAGA	GAAACACCGGTGGTAATTCGTAGCGAGTGGGGTTAGAGCTAGAAATAGCA	1	bc
ATGTTAACCC	GAAACANCGGTTGGATTTGATCCTTTAGGTATAAATAGCAAGATAACCCA	1	bc
GTAAAACAGA	GAAACANCGGTGAGCATGATTAGAGCTAGAAATAGAAAGTTAACCTAAGG	1	bc
AGGTAGCGCC	GAAACACCGGTGATCTTTGCTCGTTTTTTGGGGTTAAGCCTGGAAATACC	1	bc
ACACTGACAC	GAAACANCGGTGTTCTTTACTCGAGGGTGGGGTTAGAGCTAGAAATAGCA	1	bc
CGGCGGGTTT	GAAACANCGGTCGTCCTTCGATCTGGTTAGGGGGGGTGGAGCTAGTAATA	1	bc
TACACTTCGA	GAAACANCGGTTCCCGTTAGCTCGTAGTGGGGTTATAGCTAGAAATAGCA	1	bc
AAATGAGAAA	GAAACANCGGTTGTGGGGATCTGGGTGTGGGAGAAGAAGCAAGTTTACAT	1	bc
AGTTCATAAC	GAAACANCTTTGGGCTAGATCTGGGACTGGGAATTTAACTTGAAGCTAGT	1	bc
CCGTTTAGCC	GAAACACCGGTTGGCTTTACTCCTTTAGCTATAAATAGCGAGTTAACCTA	1	bc
AGAACTTACT	GAAACANCGGTTGCCGTCAGCTCGTAGTGGGGTTAGAGCTAGAAATAGCA	1	bc
TGTTCAGTCC	GAAACANCGGTCTTCCTGGAATCTAACGTGGGGTAAAGCTAGAAATAGCA	1	bc
AACCACTTCG	GAAACACCGGTGGCAGACAGAGACATGTGGGGTTAGGGCTAGAAATAGCA	1	bc
CAGTAAGCAC	GAAACACCGGTTATCTATAGATCATTACCCATATAAAGCAAGTAAACCCA	1	bc
TACTTTGTCC	GAAACANCGGTCCTAATTACTTGCGGGTGGGGTTAGAGCTAGAAATAGCA	1	bc
GCGATAATCC	GAAACANCGGTAATCTAAAGATCTTCGTGGAGAAAGAGCTAGATATAGTA	1	bc
TTCTTCTCCC	GAAACANCGGTCGCGAAGATGTGCGGGTGGGGTTAGAGCTAGCAATATAA	1	bc
AGTAATTTAT	GAAACANCGGTGAGCATGATAACGTTGTGGGGTTAGAGCTAGAAATAGCA	1	bc
TACACTGTAT	GAAACANCGGTTCTCGTTAGTTCCGTATAGCTATAAATAGCAAGATAACC	1	bc
AGCCAGCCCT	GAAACACCGGTTCCCGTTAGCTCATGGTGGGGTTAGAGCTAGAAATAGCA	1	bc
CCCCCTCCCC	GAAACACCGGTTCAACCGGCGTCTTGAACTGGTGGGGGGGTTAGAGCTAG	1	bc
ATCCCCCGCC	GAAACANCGGTAGTGGGGGCTGAGCTTGTGGGATTAAGGTAACAAAAGGC	1	bc
GAGACACTCT	GAAACANCGGTGACGCGAGGGCGGTTGGGGGGGTAGAGCTAGGAATTGCA	1	bc
GCAACAAGAA	GAAACANCGGTGGGGTTAGAAATAGCAATAGAACGTTAGCCTAGGCCGAT	1	bc
GAAACATAAA	GAAACANCGGTGACCATGCTAACGTAGTGGGGTTAGAGCTAGAAATAACA	1	bc
ATGACAATAA	GAAACANCGGTCGTGGTATAGCTAGAAATCGCAAGATAACCTATTGCCAT	1	bc
TGACAACATT	GAAACANCGGTGTTCCTGGCTTGTGACGGGGGTTAGAGCTAGAAATAGCA	1	bc
GTGATATTTG	GAAACANCGGTTAGCGTGATAACTTCGTCGGTAACGAGCTACTAATCCCA	1	bc
ATACCAATCC	GAAACACCGGTTGTAATCGTCAGATTGTGGGGTTAGGCTAAGAATTGCCA	1	bc
CAATCAGACT	GAAACANCGGTTCAACCGGCGTCTTGAACCGGTGGGGGGGTTAGAGCTAG	1	bc
TTCTTCTCCT	GAAACANCGGTCCCGATTAGGTGCCAGTGGGGTTAGAGCTAGAAATAGCA	1	bc
CCGATATCTC	GAAACACCGGTTGGCTTTACTCCTTTCGTTATGATTAGCAAGTTAACCTC	1	bc
TGGTTAGATT	GAAACANCGGTCTTCTTGGCATCTAACGCTGGGAATAGCTAGTTATAGCA	1	bc
TTAATACATT	GAAACACCGGTGTGCTTGATTAGCGCGTGGGGTAAGAGGTTGACATAGCA	1	bc
GACCGAGTTC	GAAACANCGGTACTAGCGGGTTCGAAGTGGGGTTAGAGCTAGAAATAGCA	1	bc
TGTTATGATA	GAAACANCGGTCTTAGTTACTTACGGGGGGGGGTAGAGCTAGAAATAGCA	1	bc
CGATTGGAAG	GAAACACCGGTCCTAGTAGTTAGCTCGGGGGGTTAGAGCTTGAAATTGCA	1	bc
