GACTAAGCAG	GAAACANCGGTTCTAGTTACTGACGGGTGGGGTTAGAGCTAGAAATAGCA	1	bc
CTACCAAAAC	GAAACACCGGTTGGCTGCGATGGTTTGTCAGGAAATAGCTAGAAATAGCA	1	bc
AACACACAAT	GAAACANCGGTTGTAAGCGATGGTTTGTGGGGTTAGAGCTAGAAATAGCA	1	bc
CCCTCGGTAC	GAAACANCGGTTCAACCGGCGTATGGAACCGGTTAGGGGGATAAAGCTAG	1	bc
AACTTACAAG	GAAACANCGGTGTTAATTCGTAGGTCGTGGGGTTAGAGCTAGAAATAGCA	1	bc
AAAACCATTG	GAAACACCGGTTTTGTATGGAGGGACTTGTGGGGTTAGATCTAGAAATAG	1	bc
TAAACACCAC	GAAACANCGGTTTCCTTAGTTAACTAGTGAGGTTAGCGCTAGACATAGCC	1	bc
AATTCACAAA	GAAACANCGGTGGCAATTCGATCTGAGTGGGGTTAGAGCTAGAAATAGCA	1	bc
TACTGTTCAC	GAAACANCGGTTGGCTTTACTCCTTTAGCTATAAATAGCAAGTAAAACTA	1	bc
CCGTTACTAT	GAAACANCGGTTTGCTTTACTCCTTTAGCTATATATAGCTAGTTAACCTA	1	bc
GAGTTTGCAA	GAAACANCGGTTCTAGTTACTCATTGGTCTGTATATAGCCAGATAAAGTA	1	bc
TCAACAATCC	GAAACACCGGTGATGTTAGGGCTAGAATTAGGAAAGTAACCTAAGTCGAG	1	bc
CAAAAGGTAA	GAAACACCGGTTTTCGATCATAGGTCGTGGGGTTAGAGCTAGAAATAGCA	1	bc
AGACCTACCT	GAAACANCGGTGTAGTTAGAGCTGGATAGAGCAGGTAGACCTAGGGATAG	1	bc
CCAAGAAGTT	GAAACANCGGTGCTAGCGGTTTTAAAAGTAGGGATTGAGCTAGAGATTGC	1	bc
AACTCGCCAC	GAAACACCGGTTCAACCGGCGTGTCGGTCCGGTGAGGGCGAGAGAGATCG	1	bc
CACCCCATGC	GAAACANCGGTTTAATCTGGAGGGTTTAGCGGGGTTAGAGCTAGAACTAG	1	bc
TCGGTTACAA	GAAACANCGGTGGGGTTTAATCCTTAAGTAATAAATAGAAAGTTAACCTA	1	bc
TAATCCATCT	GAAACANCGGGGCAGCAATAGCAAGGTAACGGATGGAGAGACAGATATCA	1	bc
AGAGTCAATC	GAAACANAGGTTATCGTTACGGATTTTGTGGGGTTAGAGCTAGAAATAGC	1	bc
ACACCAACAA	GAAACANCGGTGGCGATCGTGCGAGAGTTAGGTTGGAGATATAAGGAGCA	1	bc
TCGATACTCC	GAAACANCGGTGGGGTGTAGTCCGTTTGCTGTAAGAAGTAAGTTAAAATA	1	bc
AGACCCGTTT	GAAACANCGGTCTTGCTTGAATGGATCGTGGGGGATAGATCTAGAAATCA	1	bc
GAATCATCAA	GAAACANCGTGTTTTGAGAGTGAGGAGTAGCGTTAGAGCTTGAAATAGCA	1	bc
AGACCACCTC	GAAACANAGGCCATCTAAAGAACCCCGTAGGGATAGAGATAGAAAGAGAA	1	bc
GCCTATGACA	GAAACACCGGTACTAGTTACTTCCGGGAGCGGTTAGAGCTAGAAATAGCA	1	bc
CCCTACCCCC	GAAACANCGGTAATCTTAACTCCTCTGGGGGGAAAGAGCTAGAAAACCCA	1	bc
AACTCATCCC	GAAACANCGGTGACAAACGTGTGTCGGTGGGGTTAGAGCTAGAAATAGCA	1	bc
AGGCGGGATT	GAAACANCGGTCGTCCTTGGAAGGGAGGGGGGGTAGAGCTAGAAATAGCA	1	bc
CGGTGGGCAG	GAAACACCGGTCGTCTTTCGTAGGGCGTGGGGTTAGAGCTAGAAATAGCA	1	bc
GACTCTGACA	GAAACANCGGTACTAGTTACTTACGGGTGGGGTTAGAGCTAGAAATAGCA	1	bc
GGCACCGTCA	GAAACACCGGTGATCTAACGATCCCCGTTGGTTTAGAGCTTGGAGTATCG	1	bc
AAACCAAATA	GAAACANCGGTTTACTATGGATGTATTAATAGGGTTAGAGCTTGAGATAG	1	bc
ATCAAAGTCG	GAAACANCGGTCGTAGCAGAGGAGAGTGGGGGGGTTAGAGCTAGAAATAG	1	bc
GAGCCAGGCT	GAGACANCGGTTTTCGTTACGGCTTACGTGGGGTTAGAGTTAGAATTGGC	1	bc
AAACAACACC	GAAACANCGGTTATATACGGATCTCCGTGGGGATAGAGCTAGAAATAGCA	1	bc
CACTACACCC	GAAACANCGGTAATCTAAAGATCCCCGTGGGGATAGAGCTAGAAATAGCA	1	bc
CAAAGGCGAT	GAAACACCGGTTTACTTAGTTAACTAGTGGGGTTAGAGCTAGAAATAGCA	1	bc
GCGTTAGTAA	GAAACANCGGTTCGCGTTACTCCTGGAGCTAGAAAGAGCAAGTTAAAGTA	1	bc
TTCTAACCCC	GAAACANCGGTCTCCGGAGAGTACCCGTGGGAAATAACCAGGAACCTACG	1	bc
AAAGAAGACG	GAAACACCGGTGACCTTTATGGGACCGTGGGGTTAGAGCTAGAAATAGCA	1	bc
AAAATGATGG	GAAACANCGGTTTTCGATCATAGGGCGAGGGGTTAGAGCTAGAAATAGCA	1	bc
GTAACATTGA	GAAACANCGGTGAGCATGATAACGTCGTGGGGTTAGAGCTAGAAATAGCA	1	bc
TGAACTCATG	GAAACANCGGTTTAATTAGTTAACTAGTGGGGTTAGAGCTAGTAATAGCA	1	bc
TAAATATATC	GAAACANCGGTGAGCATGATTAGAGCTAGAAATAGCACGTTAACTTAAGG	1	bc
ATCTTCTTGC	GAAACANCGGTTTCGTATGTGGGGCTTAGTGGGGTTAAGCTTAGAAATAG	1	bc
TGCTCTGAAT	GAAACANCGGTCCTAGTTGCTTCCAACGGGGGTTAGAGCTAGGAATAGCA	1	bc
CACAGGCTTG	GAAACANCGGTTGTCGTTCGTAGGGCGTGGGGTTAGAGCTAGAAATAGCA	1	bc
GTAACCGCCG	GAAACANCGGTTTTAGAAAATGGGGAATGGGGTTAGAGCTAAAAATAGCA	1	bc
TGTTAAGCTT	GAAACANCGGTCTTCCTGGAATCTGACTGAGAAATAGCAAATAACTTGAG	1	bc
GATTAAGCAA	GAAACACCGGTACTAGTTACTTATGGGTGGGGTTAGAGCTAGAAATAGCA	1	bc
TATTACTCCC	GAAACACCGGTGACAAACGTATGTCGGTGGGGTTAGAGCTAGAAATAGCA	1	bc
GGAACTTACT	GAAACANCGGGGAGCATGATTAGAGTTACAAATAGCACTTTAACTTGAGG	1	bc
AACATCCTGC	GAAACANCGGTTTTCGCTCATAGGTCGTGGCGTTAGAGCTAGAAATAGCA	1	bc
CGGAGGGCCT	GAAACANCGGTCGCCGTTAGTTGGGCGTGGGGTTAGAGCTAGAAATAGCA	1	bc
AGATCATACA	GAAACANCGGGGGGTTAGAGCTAGAAGTAGGAAGATAACCTAAGGTAGGA	1	bc
AAACGCAATA	GAAACACCGGTTTAGGATGGAGGGAATTGTGGGGTTAGATCTAGAAATAG	1	bc
AAATTGATAG	GAAACANCGGTTTTGGATCATAGGTCGTGGGGATAGAGCTAGAAATAGCA	1	bc
CCTTGCTCCC	GAAACANCGGTAGAATGGATCTAGAAATAGCAAGTTAACCTAAGGCTAGT	1	bc
TAAAACCTCG	GAAACANCGGTAACCTAAGGATGGTCGTGGGGTTAGAGCTAGAAATAGCA	1	bc
CGGCTGACTG	GAAACACCGGTCGTCTTTCGTAGTTCGTGGAGTTAGAGCTAGTAAAAGTA	1	bc
AAACCGATAC	GAAACANCGGTTTTGTATGCACGGAGTAGGGGGGAGAGCTAGAAATAGAG	1	bc
TAAACAATCT	GAAACANCGGTTACGCGAGGACGGTGTGGGGGTTAAAAGTAGAAATAAGA	1	bc
CGGCGAGTGA	GAAACANCGGTCTTCGGTCGTGATGCGTGGGGTTAAGGCTAGAAATAAAG	1	bc
AAGAGGCTTG	GAAACACCGGTTTTCGATCATAGGTCGTGGGGTTAGAGCTAGAAATAGCA	1	bc
TGAAATATAT	GAAACANCGGTGAGCATGATAACGTCGTGGGGTTAGAGCTAGAAATAGCA	1	bc
CAAAACCCAT	GAAACANCGGTTTAGTATGGAGGGATTAGTGGGGTTAGAGCTAGAAATAG	1	bc
CAACAACAAC	GAAACANCGGTGTTATTTGGTCGTGGGTGGGGTTAGAGCTAGAAATAGCA	1	bc
GAGTCTACCT	GAAACACCGGTTATCGTTACGGACTTTGTGGGGTTAGAGCTAGAAATAGC	1	bc
AGCTATTCTA	GAAACANCGGTGTGCGGAGATTCGGCGTGGGGAATAGCAAGGAACCTAAG	1	bc
TCAAGAGTCT	GAAACANCGGTGCCAGCGGGACGGAAGTGGGGTTAGAGCTAGAAATAGCA	1	bc
CAACGAGATT	GAAACANCGGTGCTAGCGGTTTCGAAGTGGGGTTAGAGCTAGAAATAGCA	1	bc
AACACTGCCT	GAAACACCGGTGCCCTTTATCTGGCCGTGGGGTTAGAGCTAGAAATAGCA	1	bc
TAAATCAAAC	GAAACANCGGTTTACTTAGCTACTTTGTCGAGAAAGAGCTAGTAATAGTA	1	bc
ATTCTATCCC	GAAACANCGGTCACGAAAGTATGCCAGTGGGGTTAGAGCTAGAAATAGCA	1	bc
AGCCCCTCCT	GAAACANCGGTTTCCTATGGCGGGATTAGAGCGGGTAGTGCTAGGAATAG	1	bc
GACGCACTCC	GAAACANCGGTAATCTAAAATGGCTCGTGGGGTTAGAGCTAGAAATAGCA	1	bc
CAACGAGAAT	GAAACANCGGTGCTAGTGGTTTCGTAGTGGGGTTAGAGCTAGAAATAGCA	1	bc
GGAAAATAAC	GAAACANCGGTGAGCATGATTAGAGGTTGAAGTTGCAAGTTAAACTAAGA	1	bc
CGTCCACCAT	GAAACANCGTTGGGTTAGAGCTAGAAATTGGGATTTAACTCAAAGTTAGA	1	bc
GAAATCCATT	GAAACANCGGTTTACTTAGTTAACTAGTGGGATTAGAGCTAGAAATAGCA	1	bc
ATCGAAACTA	GAAACANCGGTGTGCGGGGAGTATGCGTGAGCAATAGAACGTAACCTAAG	1	bc
ACCCAAATGA	GAAACANCGGTTTAGGATGGAGGTGCGGGGGGATTAGCGCTAGACATAGC	1	bc
ATGTCAGCCG	GAAACANCGGTTTTAGAAGCTGAGGAGAGAGCTTAGAACAGCAAGTTGCA	1	bc
AAAACATTTA	GAAACANCGGTTTGGAATGGAGGGGTTAGAGGGGGTAGAGCTAGATATAG	1	bc
GACTTAGATA	GAAACANCGGTGAGAATGATATAGGGGTGGGGTTAGAGATAGAAATAGCA	1	bc
TAAACAAAAG	GAAACANCGGTTTACTTCATTGACTTGGTGGGTTAAAACTAAAAATCACC	1	bc
ATGTCTGCCC	GAAACANCGGTGACAAACGTATGTCAGTGGGGTTAGAGCTAGAAATAGCA	1	bc
ATAATAGACG	GAAACANCGGTGATCGTAATAACGTTTTGTGGTTATAGATATAAATATCA	1	bc
ATTTAAGCAA	GAAACANCGGTTGTGGGGAACTCGGTGTGGGAGATATAGCAAGTTAACCT	1	bc
TTAATCTTCT	GAAACANCGGTGACGCGAGGTAGGTGGAGGGGTTACAGCTTGAAATAGGA	1	bc
GGAAAGTAAA	GAAACANCGGTGATCTTTACTCGAGGGTGGGGTTAGAGCTAGAAATAGCA	1	bc
GAGACTATGT	GAAACACCGGTACTAGTTACTTACGGGTGGGGTTAGAGCTAGAAATAGCA	1	bc
AGTTAATCGA	GAAACANCTGTGGGTTAGAACTAGAAATGGGAAGTTAACATAAAGCTAGT	1	bc
AGAAAGTAAA	GAAACANCGGTGTTCTTTGCTCGAGGGTGGGTTTAAACCTAAAAATATCA	1	bc
GGCTAGGAAA	GAAACANCGGTACTAGTTACTTACGGGTGGGGTTAGAGCTAGAAATAGCA	1	bc
GCAACAAATA	GAAACANCGGTGGGGTTAGAGCTAGAGATAGGAAGTTAATCTAAAGCTAG	1	bc
CGTCTAGCTT	GAAACANCTGTCTTCTTGACATCTAACGTTGTAAAGAGCAAGATATCCCA	1	bc
CCGATAAAAA	GAAACANCGGTTGGCTTTACTCCGTTATGTATATAGAGCAAGAAAACCTA	1	bc
TCCACAACAA	GAAACANCGGTGGGGTTAGAGCTAGAAATAGCAAGTTAACCTAAGGCTAG	1	bc
CACTCGGCCC	GAAACANCGGTTCACCTGACGTCTTGGTGGGGTTGGGGCTAGGAATAGCA	1	bc
