ACCGTTAGCA	GAAACACCGATTGGCTTTACTCCTTTGTGGGGTTAGAGCTATAAATAGCA	3	bc
CATGCACTTC	GAAACACCGGTTCCCGTTAGCTCGTAGTGGGGTTAGAGCTAGAAATAGCA	2	bc
CACAGCCTAA	GAAACACCGGTAGAATGGATTTACGGGTGGGGTTAGAGCTAGAAATAGCA	1	bc
CGGCCAAGCG	GAAACACCGGTTATCGGAGGTGGCAAGTTAACCTAAAGCTACTCGGTAAT	1	bc
GTACCAAATA	GAAACACCGGTGGGGTTAGAGCTAGAAATAGCAAGTTAACCTAAGGCTAG	1	bc
TAAATCACAT	GAAACACCGGTTTACTTAGTTTAATAGTGGGGTTAGAGCTAATCAAAGTA	1	bc
CCCTTTGCAA	GAAACACCGGTACTCTTTACTTCCGGGTGGGGTTAGAGCTAGAAATAGCA	1	bc
GGATCAACAA	GAAACACCGGTGATAATAGATAGCTCGTGGGGTAAGAGTTAGAAATAGAA	1	bc
TCCCCCCACA	GAAACACAGGTGGTGTTAGAGCTAGAAATAGCCAGTTAACCTAAGGCTAG	1	bc
ATATAAAAAA	GAAACACCGGTGCTCATAGATAGCTCGTGGGGATAGACAAAGAAATAAAA	1	bc
CCCCGCATCA	GAAACACCGGCAAGAACTAGCAATTTAGGGTAAGGCTATTCCATTATCAA	1	bc
GCCAAATATA	GAAACACCGGTTCTAGCTACTTATGGGAGGGTAACCTACTAGAAATACCA	1	bc
TGACCACAAT	GAAACACCGGTTTGCTTAGATGGTTTGTGGGGTTAGAGCTAGAAATAGCA	1	bc
AAGTCAAGGA	GAAACACCGGTTATCGGAAATAGTGAGTTAGCAATAGGCTAGAACGTAAT	1	bc
GGATTAGAAT	GAAACACCGGTGCTCATAGTTAGCTCGTGGGGTTAGAGCTAGAAATAGCA	1	bc
AAACGCAGCA	GAAACACCGGCTAGGAATGGAAGGTTAAGGTAATAGAAGTACAAATTCAA	1	bc
AACTAAGCAA	GAAACACCGGTTCTGGGTACTTCCTGGTGGGAATAGTAATAAAAATAGCA	1	bc
TACTTAAAAC	GAAACACCGGTGCTACTAGTTAGCTCGTGGGGTTAGAGCTAGAAATTGCC	1	bc
TTGAGCCAAT	GAAACACCGGTGTGGTTAGTGATATAAATAGCAAAGTAACCTAAGGCTAG	1	bc
CGTTCACATT	GAAACACCGGTGGCAACTCGATCTGAGTGGGGTTAGAGCTAGAAGTAGCA	1	bc
TATATTACCG	GAAACACCTGTTCCCTTTATCGGACCGTGGGGTAGTGCTTAGAATTACAA	1	bc
GACACTTTCT	GAAACACAGGTACTCGTTAGATCGTAGTGGGGTTAGAGCTAGAAATAGCA	1	bc
TAATCCCCAA	GAAACACCGGTGACAAAAGTATGTCAGTGGGGTTAGAGCTAGAAATAGCA	1	bc
AATCCCTTAA	GAAACACCGGTTTAGTATGTGGGGTTAGAGCTAGAAATAGCAAGTTAACC	1	bc
CCTTCAAAAC	GAAACACCGGTGGCAATTCGATCTGAGTGGGGTTAGAGCTAGAAATAGCA	1	bc
TGAACATCGA	GAAACACCGGTGCACGTAAGCTCGAAGCGGGGATAGAGATAGAAATAGAG	1	bc
AACAGGCCCA	GAAACACCGGTTGTGGGGGACTCGGTGTGGGAGAAATAGCAAGTTAACCT	1	bc
TCAGCACACC	GAAACACCGGTGGGGCTAGAGCTAGAAATGGCAAGATAACCTAAGGCAAG	1	bc
CGATCGTAAC	GAAACACCTGTGATAACAGCCTAGGGATGGGGAGATAGCCTGAAACTGCA	1	bc
TCATCCTCCC	GAAACACCGTTGAGGACAGTACGTCTTTGGGTTAGAGCAAGAAAACGCCA	1	bc
GTACTATCTT	GAAACACCGGTTGTACGCGATGGTTTGTGGGGTTAGAGCTAGAAATAGCA	1	bc
ACACCACAAA	GAAACACCGGTTGTAATCGATGGTTTGTTGGGATAGAGCTATAAATCTCA	1	bc
GATGGCGCGA	GAAACACCGGTGGGGTGCCTCTCGGTGGGGGGGTAACAGCAAGCTAGTCT	1	bc
CCGCGCAGCG	GAAACACCGGCTAGAAATAGCAAGTTAACCTAAGGCTAGTCCGTTATCAT	1	bc
GCCTGTGAGA	GAAACACCGGTACTATTTACTTACTGGTTGTTTTCGTGCTAGAAATAGCA	1	bc
GGCAATTAAA	GAAACACCGGTGGCAGCTACCCACTTGTGGGGTTAGAGCTAGAAATAGCA	1	bc
ATCAAGCTAA	GAAACACCGGTGTCCTGAGATAACCCGAGGGAAATCGGATATAACCTAAA	1	bc
AAGCTTGCAA	GAAACACCGGTTGGCTTTACTCCTTTGTGGGGTTAGAGCTATAAATAGCA	1	bc
AACCCCCCGA	GAAACCCCGGTTTAGTATGTGTGGTTAGAGCTAGAAATAGCGAGTCAACC	1	bc
GGACGAGAAA	GAAACACCGGTGGGGTTAGAGCGAGAAATAGCAAGGTAACCTAAGGCTAG	1	bc
AAAATATAAA	GAAACACTGGTTTTCGATCATAGGACGTGGGGTTAGAGCTAGAAATAGCA	1	bc
GTATTACCAA	GAAACACCGGCGCTAATAGTTTGCTCGTGGGGTTTGAGCTAGAAATAGCA	1	bc
GAGCCGCGAG	GAAACAACGGCTATCTTTGCTAGCAAGTTGACCTAAGGCTAGTCCTATAT	1	bc
ATTCCATCAC	GACACACCGGTTGTAAGCGTTTGTCTGTGGGGTTAGAGCTAGAAATAGCA	1	bc
TTAACACTCA	GAAACACCGGTGACGGGAGATTAAGAGTTAGAAATAGCAAGATAACTAAG	1	bc
CTTTCACCCA	GAAACACCGGTGAGAACAGACTAGGAATAGCAATTTAACCTAAGTCTAGT	1	bc
GGTTATGCAA	GAAACACCTGTACTAGTTATTTACGGGTGGGGTTAGAGCTAGAAATAGCA	1	bc
AACTCTTCAA	GAAACACCGGTACTAAATACTTACGAGTGGGGTTAGAGCTAGAAATAGCA	1	bc
CATTCGCACC	GAAACACCGGTGGCAATTCGATCTGAGTGGGGTTAGCGCTAGAAATCGCA	1	bc
CCTCGTGCCG	GAAACACCGGCTAGCAATAGCAGGTTGAGGTATTACAGCTCGGTTAAGCA	1	bc
CGTCCAACAT	GAAACACCGGTCGTCTTTGCACCTTTGTGGGGTTGAGCCAATAAATACAA	1	bc
CGTTCCCAAC	GAAACACCGGTGAGAACAGACTAGAAATAGCAAATTAACCTAAGGCTAGT	1	bc
AAAATATAAA	GAAACACCGGTTAGAGCTAGAAATACCAAGTTAACCTAATACTAGTCCGT	1	bc
AAAAACCCCT	GAAACACCGGTGTCTTGTGTGGGGTCGTGGGAGTAGAACTAAAAAAAACA	1	bc
CATACACTAT	GAAACACCGGTGACAAAACGATCTTATTGGGGTTAGAGCTAGAAATAGCA	1	bc
AAAGCAATAG	GAAACACCGGTGGGGGTAGATAGAGAGAGGGCATAGTAACCTAAGTCTCG	1	bc
GAGGGTGTGA	GAAACACCGGTGCTGGTAGCGTTAGAGAGAGCATGTTACTCTAAGGCTCG	1	bc
CGCTATTCAA	GAAACACAGGTGAGAACAGACTAGGAATAGCAAGATAACCTAAGGCTAGT	1	bc
AACAAAGCGA	GAAACACCGGTGTGCAGAGATTATGCGTGGGAAATAGCAAGTAACCTAAG	1	bc
TACTTGAAAA	GAAACACCGGTTCTAATAGTGAGCTCGTGGGGGAGAGCTAGAAATAGCGA	1	bc
AAGAACGTCC	GAAACACCGGTAATCTAAGGATCCGCTTGGGGTTAAAGCTAGAAATAAAC	1	bc
CAGATAAAAC	GAAACACCGGTGGGTTTTAATCCATTGTGGGGTTAGAGCCATAAATAGCA	1	bc
TAAGCACAGA	GAAACACCGGTTTGGTTAGAGCTAGAAATAGCTTGTTACTCTAAGGCTCG	1	bc
TCCTCACCAA	GAAACACCGGTGTGGTTAGAGTTAGCGATAGCAATTTCACCTAAGCTTAG	1	bc
GACTCTTTCA	GAAACACCGGTACTAGTTACTTACGGGTGGGGTTAGAGCTAGAAATAGCA	1	bc
TGTCCACCTT	GAAACACCGGTAATCTAAAGATCCCCGTGGGGATAGAGCTAGAAACAGCA	1	bc
CCGTTCCCCC	GAAACACCGGTTGTCTTTACTCCTTTGTGGGGTTAGAGCTATAAATAGCA	1	bc
TCATCCATAA	GAAACACCGGTTGGGTTAGACCTAGAGAGGGCAAGTGAACCTAACACTAG	1	bc
AATTAGGTAC	GAAACACCGGTTGTGTGGAACTCGGCGTGGGAGTAATAGTAAGATAACCT	1	bc
TAATCACACC	GAAACACCGGTGTAATTAGCGCTTGAGTTGGGTTAAAACCATAAATATCA	1	bc
GTACGAGATT	GAAACACCGGTTATAGCTAGAAATAGCAGGGTATCCTGATGCTAATCCGT	1	bc
CACACCCACT	GAAACACCGGTTTACTTAGTTAACTAGTGGGGTTAGAGCTAGAAATATCA	1	bc
GAGTATGGCG	GGAACACCGGTTATCGGAAATAGCAAGTTAACCTAAGGCTAGTCCGTTAT	1	bc
TAAACGCTAA	GAAACACCGGTGACACGAGAGTTAGAGATAGGATGGTCAAGGTAATCTAA	1	bc
GAAAAATATT	GAAACACCGGTGAGAGCGATATCGTACTGGGGGTAGAACTTGGAATTGGA	1	bc
CACTGCCGAA	GAAACACCGGCTAGAAATAGCAAGTTAAGCTAAGGCTAGTCCGTTATCAA	1	bc
GTATGGTATA	GAAACACCGGTTGTGGGGATCTCGGTGGGGGTGGAAATGCAAGTTAACCT	1	bc
ATCAGCCGCG	GAAACACCGGTTAGAAATAGCAAGTTAACCTAAGGATAGTCAGATATCAA	1	bc
CTTTAACCAA	GAAACACCGGTGTGCATTGGTTATGCGTGGGGTTTAGCAAGGAACCTGAG	1	bc
CCCCGGCACT	GAAACACCGGCTAGATATATTAAGTTAACGGGTTGCTAGTCGGTTATCAA	1	bc
GCATTAACTC	GAAACACAGGTTGGCTTTACTCCTTTGTGGGGTTAGAGCTATAAATAGAA	1	bc
GCAACATACA	GAAACAACGGTGGGGGTAGAGCTAGGAATAGCAAGTTAACATAAGGCTAG	1	bc
CATCGATCAT	GAAACACCGGTTTTCGATCATAGGTCGTGGGGTTAGAGCTAGAAATAGCC	1	bc
GAATTGATAG	GAAACACCGGTGCTAATAGTTAGCTCGTGGGGTTAGAGCTAGAAATAGCA	1	bc
GAAACATACA	GAAACACCGGTTAGAGCTGGAAATAGGAAGGTAACCTACGGCAAGTCCGT	1	bc
GCGGCAAACT	GAAACACCGGTGATGGTAGATATAGAATTCGCCTGATAATCGAAGGCTAT	1	bc
ATATGACCGC	GAAACACCGGTAGGCTGTTAGAGTTAGTGATAGCTAGCTAATATCCGAAT	1	bc
GACTTACCAA	GAAACACCGGTGCTAATAGTTAACTCGTGGGGTTAAGGATAGAGCTAGAA	1	bc
CGCCGGGGCT	GAAACACCGGCCATAAAGAGGAAGTTAACGTAATGCCAAGCCATTATCAA	1	bc
TACTCAGAAA	GAAACACCGGTCCTCATTGCTTACTCGTGGGGTTAGAGCTAGAAATAGCA	1	bc
AGTCATGCAC	GAAACACCGGTGCCCTTTGTGGGACCGTGGGGTTAGAGCTAGAAATAGCA	1	bc
GACACAGTCC	GAAACACCGGTCATCTTGGAATCTACGTGGGGTAGAGCTTGAAATAGCAA	1	bc
AATTCAGTAA	GAAACACCGGTCGTAGCGAATTCGGTGTGGGGGAAAGAGCAAGAAAACCA	1	bc
AAATGCCAAT	GAAACACCGGTTTAGTTAGATAACTAGTGGGATTAGAGATAGGATTACCA	1	bc
TCCGCACACA	GAAACACCGGTGGGGTTAGAGCTAGAAATAGCGAGATAGCCTAAGGCATG	1	bc
AACAAGGCAC	GAAACACCGGTTGTGGGGAAATCGGCGTGGGAGAAAAAGTAAGTTAACCA	1	bc
ATGAACGTAA	GAAACACCGGTACTAGTAGCTTAGGGGTAGAGCGAGAGCTAGCAAGAGGC	1	bc
GCGACCCTAA	GAAACACCGGTGACGCTAGAGCTATAAATATCGATTTAACCTAATAACCG	1	bc
GCGGGAACAC	GAAACACCGGTTGGCTTTACTCCTTTGTGGGGTTAGAGCTATAAATAGCA	1	bc
AATACACAAG	GAAACACCGGTGGCAATTCGATCTGAGTTGGGTTAGAGCTAGAAATAGCA	1	bc
ACGTTCATCG	GAAACACCGGTGAGAACAGACTAGAAATAGCAAGTTAACCTAAGGCTAGT	1	bc
GTTGGCGCAC	CTAAACACCGGTGGGGTTAGCGCTAGAAATGGCATGTTAACCTAAAGCTC	1	bc
AGCTCACTAA	GAAACACCGGTTCTAAGCGCTGGTTTGTGGGGTTAGAGCTAGAAATAGCA	1	bc
GAGTGCGAGC	GAAACACCGGTGGAGTTAGAGCTGGAAATAGCAAGTTAACCTAAAGCTAG	1	bc
ATCTGACATA	GCACGGACGAAACACCGGTGTGCGGAGATTATGCTTGAGAAACAGCAAGT	1	bc
GCTGGTGAGA	GAAACACCGGTGGGGTTAGAGCTAGAAATAGCTTGTTAACCTAAGGCTAG	1	bc
TTAGCCGAGA	GAAACACCGGTGGGATTCGTCATAGAAATAGAAAGGCAAGCTAAGGCTAG	1	bc
GATTAAGCAA	GAAACACCGGTTGTGGGGAACTAGGTGTGGGAGAAAAAGCAAGGTAACCT	1	bc
AACACATCAC	GAAACACCGGTTTCCGACGATAGGCCCGGGGGTTTAGAGCTGAAATAGGC	1	bc
TCCTTACGCC	GAAACACAGGTGCTACTGGTTAAGTCGTGGGAATAGCGATATAACTTGAA	1	bc
AGTAATCAAG	GAAACACCGGTGTTCTTTGTGCGAGCGTGGGGGTAAGGGTTAAAATAGCA	1	bc
GGGCAGCGAG	GAAACACCGGTGATCTGTGATAGAGGGTGGGCATAGAGCTAGAAAGTTAA	1	bc
TACTACCAAT	GAAACACCGGTTTTCTTTACTTACTAGTGGGGTTAGAGCTAGAAATAGCA	1	bc
AAGTAACGGA	GAAACACCGGTTATCGGAGATAGCACGTTAGCATAAGGATGGTACGTTAT	1	bc
TGATCATTAA	GAAACACCGGTGAGGAGAGGACGAGAGGGGGATATATCAAGATAACATAA	1	bc
GAATCAACAC	GAAACACCGGTTTTCGTAACTGGTGAGTGGGGTTAGAGCTAGAAATAGCA	1	bc
GTAATATCCC	GAAACACCGGTACTCGTTACTTCCTTGTGGGGTTAGAGCTAGAAATAGCA	1	bc
CCCTCGCAAC	GAAACACCGGTTGAACTGGAGCTAGTAGTGGCATTATAACCTAAAGTAAC	1	bc
CAATGAAACC	GAAACACAGGGTAGAGTTAGAAATAGCATGTTAACCTAACCTAAGTCCGT	1	bc
GAATCCAGCA	GAAACACCGGTTATCGATGTGGGGTTGGAGGTATAGAGATAAAAATAACA	1	bc
GACTGCGTCC	GAAACACCGGCTCGATTTAGCCAGGTAACCTAATGCTAGTCCAATATCAA	1	bc
GCGGCCAAAA	GAAACACCGGTGGGGGGAGAGCTAGAGGTAGCAAATTAACAATTAACTCT	1	bc
AGGTAATCAA	GAAACACCGGTGCGAGCAGACTAGGTGTGGGAATTTAGCCTAAGGTTGGA	1	bc
TCAGCACACT	GAAACACCGGTGGGGTGAGGACTAGAAATCGAGAGTTAACCTAAGGATAG	1	bc
CACTTAAACA	GAAACACCGGTTCTAATAGCTAGTTCGTGGGGTTAGAGCTAGAAATAGCA	1	bc
CCCTCGCACA	GAAACACCTGTTCAACCGGCGTCTTTTGTGGGGATAGAGCTAGAAATAGC	1	bc
TCAGCTACCA	GAAACACCGGTGGGGTTAGAGCTAGAGATAGCGTGGTACAATAAGGCTAG	1	bc
CCCGACCTCC	GAAACACCGGCAATCTAAAGATCCCCGTGGGGATGGTAGTCGAAAAACAA	1	bc
TGACCAGAAT	GAAACACCGGTGGGGTTAGGCTAAAAAAAGGCAGTTAAACTTAGGCTAGT	1	bc
CAATCAACAA	GAAACACCGGTTATCGGAAATAGCAAGTTAACCTAAGGCTAGTCCGTTAT	1	bc
TCGACAAACA	GAAACACCGGTGGGGTTAGCGCTAGAAATAGCAAGTTAACCTAAGGCTAG	1	bc
AATCTATCTA	GAAACACCGGTTAGAGCTAGATATAGGAGGTTTAACTGCGACTAGTCCGT	1	bc
AATTTCTCAA	GAAACACCGGTTGCGGAGAACTCGGGGTGGGGTAAATAGCAAGTTAACCT	1	bc
CACCGACGAC	GAAACACCGGCTAGAAATAGCAAGTTAACCTAAGGATAGACAGTTATCAA	1	bc
AAAACCCTCC	GAAACACCGGTAGTCTAAAGTTCCTCGTGGGGATAGAGCTAGAAATAGCA	1	bc
AAATCCGTCG	GAAACATCGGTCCTAGTAACTGAATTTGGGGGTTTAGAGCTAGAAATAGC	1	bc
GTGACAATCG	GAAACACCGGTTATCGGAAATAGCAAGTTAACCTAAGGCTAGTCCGTAAT	1	bc
GATTCAGTAA	GAAACACCGGTGAGGACTGACTAGGGATAGCGAGATAGCCTAAGGCTACT	1	bc
TAGCCCCACT	GAAACACCGGTTTACTTAGTTAACTAGTGGGGTTAGAGCTAGAAATAGCA	1	bc
CCCTTCTCAC	GATACACCGGTTCTTCTAGCTCTATTTAGGGCTCGAAAGTACAATCTGAT	1	bc
GCCTAGGAAC	GAAACACCGGTACTATTTACTTACGGGTGGGGTTAGAGCTAGAAATAGCA	1	bc
TGGTCAGATG	GAAAAACCGGTTTTCGTGGAATGTAAGTGGAGAAGAGATAGGAATGGAAA	1	bc
CTATCACCAA	GAAACACCGGTTGGAACAGATGATTAATAGCAAGTTAACCTAAGGCTACT	1	bc
AAACGCAGCA	GAAACACCGGCTAGAAATAGCAAGTTCACCTAAGGCTAGTCCGTTATCAA	1	bc
GCAGCGAAAC	GAAACACCGGTGGGGTTAGAGCTAGAAATAGAAAGCTAACCTAAGTCTAG	1	bc
CGGCGGTCTA	GAAACACCGGTGATAACAGACAAGGAATAGCAAGTTAACCTGAGGCAAGT	1	bc
TTGGCTGACT	GAAACACCGGTTAGATGCCTCGAAATGTGGGGTTAGAGTAAGACATAGCA	1	bc
CCCTTACAAC	GAAACACCGGTTCACTTTACTTCCTTGTGGGGTTAGAGCTAGAAATAGCA	1	bc
GTGGGAGCGC	GAAACACCGGTGGGGTTAGAGCTAGAAATAGCAAGTTAACATAAGGCTAG	1	bc
GTGAATGTAA	GAAACACCGGTACTAGATGCTTACGGGTGGGGTTAGAGCTAGAAATAGCA	1	bc
AATGGACAAA	GAAACACCGGTTGTGGGGGACTCGGTGTGGGAGAAATAGCAAGTTACCCT	1	bc
AATCGAGCAC	GTAACACCGGTTGCGGGGGACTAGGAGTGGGAGAAATAGCAGGTTAACCT	1	bc
CGGATATCAC	GAAACACCGGTTCCCGTTACTCCTTTGTGGGGTTAGAGCTATAAATAGCA	1	bc
GTATTATGAA	GAAACACCGGTTATAATTGGTAATAGCTGGGTTTCCTACTAGTAGTAGCT	1	bc
TGAGCACAAT	GAAACACCGGTTTGCTTAGTGTTCTAGTGGGGTTGTAGCTATAAGGCTCA	1	bc
TGAGAACAAC	GAAACACCGGTGGTGTTTGCTCGAGGGTGGGGTTAGTGCAAGAAATAGCA	1	bc
TACGCACTCA	GAAACACCGGTAATGTAAGAATTCCAGTTGGGATATAGCTATAAAGATCG	1	bc
AGTACATCCC	GAAACACCGGTGCGAACAGCCTAGAAATAGCAAGTTAACCTACGGATAGT	1	bc
AAACAGATAC	GAAACACCGGTTGTGTTTATCCAAGAGGGGGGGATAGCTATAGATAGCAC	1	bc
CCAATATAAC	GAAACACCGGTGGGCTTTACTCCTTTGTGGGGTTAGAGCTATAGGTAACA	1	bc
CTGCTAAACC	GAAACACCGGTTGTCTTTGCTCCTTTATGGGGTTAGAGCTAGAAATAGCA	1	bc
CTATCACAAT	GAAACACCGGTGTCCTTTCGTAATGAGTGGGGTTAGAGCTAGAAATAGCA	1	bc
ATTACCCTCA	GAAACACCGGTCCTACAAGGCTCTGGGGGTGAGTAGTACAAGAAGCAAGT	1	bc
GGCTATGAAC	GAAACACCAGTACTAGTTACTTACGGGGGGGGTTAGAGCTAGAAATAGCA	1	bc
TCCACCAAAA	GAAACACCGGTGGGGTTATAGCTAGAAATAGCAAGTTAACCTAAGGCTAG	1	bc
GTCTAAGAGA	GAAACACCGGTGAGATGAGTCAAGGCGTGGGAAATAGAAGGTAACCTAAG	1	bc
TACAACCAAA	GAAACACCGGTTTACTTAGCTAACTAGTGGGGTTAGAGCTAGAAATAGCA	1	bc
AACTATGCGA	GAAACACCGGTACTAGGAGATTACGGGTGGGAATAAGCATGGAACTAACA	1	bc
AAGTTAACAG	GAAACACCGGTTGGCTTTACTCCTTTGTGGGGTTAGAGCTATAAATAGCA	1	bc
GACGCAAAAA	GAAACACCTGTGGGGTTAGAGCAAGAGATAGCAAGTACACATAAGGATAA	1	bc
AGTCAGCCAA	GAAACACCGGTGTTCTTTGCTCGTGGGGGGGGGATAGAGCTAGAAATAGC	1	bc
AATTTTACAA	GAAACACCGGTTGGGTGTACCCAGGTGTGGGAGAAATAGCATAATAACCT	1	bc
CCTCGACGAA	GAAACACCGGCTAGAAATAGCAAGTTAACCTAATACTAGTAGGTTATGAA	1	bc
CACTAGCAAA	GAAACACCGGTTCTAGTTACTTCTGGGTGGGGTTAGAGCTAGAAATAGCA	1	bc
TTAGCACACA	GAAACACCGGTTGGAATCGATCTATTGATAGCTTATAAACCTAAAGCTCA	1	bc
GCGTGCGACA	GAAACACCGGTGGAATTAGAGCTAGAGATAGCACGTTAACCTCAGGCTAT	1	bc
GCATCACACA	GAAACACCGGTTTTAATGACGACTTTGGTGGGGTTAGAGCTAGAAATAGC	1	bc
ACGTTAACGA	GAAACACCGGTTGGCGTTGCTCCTTCGTGAGATTAAACATGTAACTAACG	1	bc
GTATGATCAA	GAAACACCGGTGCGAATAGAACGATCTGGGGCTAGTGCCACTAAGACTAA	1	bc
AAAGAGAAAA	GAAACACCGGTGGTGTTAGAGCTTGTAAGGGCAAGTTAACCTAAGGATAG	1	bc
AATTCCGTAA	GAAACACCGGTTTACTTATTTAACTGGTGGGGTTAGAGCTAGAAATATCA	1	bc
AAAACCATCG	GAAACACCGGTTTTAGAAGAGCTGTTAGTGGTAAAATTAGCTAAGTATCC	1	bc
ATGGCAAAAA	GAAACACCGGTGGGGTTAGAGCTAGAAATAGCAAGTTAACCTAAGGCTAG	1	bc
AGATCATCTA	GAAGCACCGGTGAGAACAGACTAGAAATAGCAAGTTAACCTAAGGCTAGT	1	bc
AGTCCGCATT	GAAACACCGGTCTTCCTTGCATCTACGTGGGGTTGAGCTAGGAAAAACAA	1	bc
AAACAGAAAA	GAAACACCGGTGGGGTTAGAGCTAGAAATAGCATGTTAACCTAAGGATAG	1	bc
ACACGCAGCA	GAAACACCGGCTAGGAATAGCAAGTTGACCTAATACTGGTCCGTTATCCA	1	bc
CTCTTAACGC	GAAACACAGGTGTGCGTAGATTATGTGTGAGAAATAGCAAGTAACCTACG	1	bc
GTAAGAGAGA	GAAACACCGGTGAGGATAGAGCTAGAAGTAGCAATAGAACCTAAAGCAAG	1	bc
GCTAAAACCA	GAAACACCGGTTGTGGCCGACTCGGTGTGGGGTAAATGCCAGGATAACCT	1	bc
CCGCAGAAAC	GAAACACCGGTTGTCTTTGCTCGTTTGTGGGGTTAGAGCTATAAATAGCA	1	bc
GAACAACAAA	GAAACACCGGTGTTCATTCGATCAGGGGGGGGGTTAAGGTAAGAATAACC	1	bc
GATGGCTAGA	GAAACACCGGTGACGATAGACTGTGAGATGGCATTCAGTCTAGAAGTGTA	1	bc
AATTGAACAC	GAAACACCGGTTGTCTTTACGTCTGTGTGGGGTTAGTAGTACGTAGACCT	1	bc
GCGTAACGCG	GACACCCCGGTTATCGGAAATAGCAAGTTAACCTCAGGCTAGTCCGTTAT	1	bc
TCAACTACCA	GAAACACCGGTGGGGTTTAAGCTAGAGCGGGCATGGTGACCTAAGGATAG	1	bc
CGTCCCTCCA	GAAACACCGGTGGGAGCTGGAAATAGGTGGGTTTAGTGCTAGAAATACGA	1	bc
AGGACTTCCG	GAAACACCGGTTCCCGTTGGGTTGTAGTGGGGTTAAGCCTAGAAATAGCA	1	bc
CGACTATATA	GAAACACCGGTTATAGCTAGAAATAGCGAGGTTACCTATGGCTATTCCGT	1	bc
ACAGCGCAAC	GCAACACCGGTGGTGTTTGCGCTAGACCGAGCTTGTTAACCTAAAGCTAG	1	bc
CCCTCACACC	GAAACACCTGTTCACCCGGAGTCTTTTGGGGGGTTAGAGCTAGAAATAAC	1	bc
GCGTGCGCTT	GAAACACCGGTGGGGTTAGAGCTAGAAATAGCAAGTTAACCTAAGGCTAG	1	bc
AAACGCAGGC	GAAACACCGGTTAGAAATAGGAAGTTAAAGTTAGAAATAGCAGTTATAAA	1	bc
ATACACTCCC	GAAACACCGGTGTTCTTTGCTCGAGGGGTGGGGTTAGAGCTAGAAATATC	1	bc
AAATATGTAC	GAAACACGGGACTAGTTACTTACGGGGGGGGTTAAGAGTAAAAATAGCAA	1	bc
AACATACTAA	GAAACACCGGTTATAGCTAGTAGTAGCAAGTTAAACAACTACTAGTCCGA	1	bc
GATAAACTAC	GAAACACCGGTAATCTAAAGATCCCCGTGGGGATAGAGCTAGAAATAGCA	1	bc
GACTCTCACA	GAAACACCGGTACTAATTGCTTACTTGTGGGGTTAGAGCTAGAAATAGCA	1	bc
TAAACCACCT	GAAACACCTGTTTACTTAGTTAACTAGTGGGGTTAGAGCTAGAAATAGCG	1	bc
GAGACAAATG	GAAACACCGGTGATCGGAAATAGCAAGTTAACCTAAGGCTAGTCCGTTAT	1	bc
CATTATGAAA	GAAACACCGGTACTAGTTACTTACGGGTGGGGTTAGAGCTAGAAATAGCA	1	bc
TAAGCAGATA	GAAACACCGGTGGGGGTACAGCGAGAGATAGCAAGTTGACATAAGGAGAG	1	bc
TAGGCCGAAT	GAAAAACCGGTCGAATTAGGTAACTAGAGGGGTAAGAGCTAGAAGTAGCA	1	bc
AAAACCAACA	GAAACACCGGTGGGGTTAGAGCTAGAAATAGCAAGTTAACCTAAGGCTAG	1	bc
AAATCAATCG	GAAACACCGGTTATCGGAAATAGCAAGTTAACCTAAGGCGAGTCCGTTAT	1	bc
CATTCTCGCT	GAAACACCGGTGTCCATTCGATCTGAGTGGGGTTAGAGCTAGAAATAGCA	1	bc
TATCCGGCAA	GAAACACCGGTTTTCGTGGACTCTGCGTGGGGGAAATAGCAAGATAACCT	1	bc
ACACCAAAGA	GAAACACCGGTTTAGTTAGTGCTGTTAGAGCTAGGAATAGCAAGTTCTAC	1	bc
AACAGCAAAA	GAAACACCGGTGGGGTTAGAGCTAGAAATAGCAAGTTAACCTAAGGCTAG	1	bc
CCACTCCACC	GAAACACCGGCGAGCAATATAAAGTTGTCCTGATACAAGTCCATTATCAA	1	bc
AATCCCGCCA	GAAACACCGGTTGTGGGGAACTCGGTGTGGGAGAAATAGCAAGTTAACCT	1	bc
CGGTAGAAAG	GAAACACCGGTGGTCTTTGCTCAGTTGTGGGGGTAGAGCTAGAAATAGCA	1	bc
TAAACACCAG	GAAACACCGGTTTAATTAGTTAACGAGTGGGGTTAGAGCTAGAAATAGCA	1	bc
CCTCGTCGCG	GAAACACCGGCTCGAAATAGCAAGTTAACCTAAGGCTAGTCCGTTATCCA	1	bc
AAAAACCTCT	GAAACACCGGTGACGCGAGGGTTAGAGCTAGAAATAGCAAGTTAACCTAA	1	bc
CCCTGACGAA	GAAACACCGGTTAGCTATAAATAGTTAATCAAAAGCTAGCCCGTTCTCAA	1	bc
GGACCGCCCC	GAAACACCGGTGTTCTTAGCTGGAGAGTGGGGTTAGAGCTAGAAATAGCA	1	bc
AATACGCTAG	GAAACACCGGTGGCAATTCAATCTGCGTGGGGTTAGAGCTAGAAATAGCA	1	bc
CGACAACCAC	GAAACACCGGTGTTCTTTGCTCGTTTGTGTGGTTAGAGCTATAAATAGCA	1	bc
TCCTACCCGC	GAAGCACCGGTGTGCGGAGTTTATGCGTGAGAAATAGCAAGTAACCTAAG	1	bc
ATAACCGTCT	CTAAACACCTGTTTGCTTAGTTAAATAGAGGGGATAGAGATCGAAATAGA	1	bc
CGGCGGGCAG	GAAACACCGGTTGGCGTTAGTACGGCGTGGGGTTAGAGCTAGAAATAGCA	1	bc
CCCTCGTCAA	GAAACACCGGTGAGAACAGACTAGAATTAGCAAGTTAAGCTAAGGCTAGC	1	bc
CCTTATGCCG	GAAACACCGGTGCCCTTTGTGTGTCCTTGGGGTTAGAGCTAGAAATAGCC	1	bc
GATATATATC	GAAACACCGGTTAGAGCTAGATATAGCAAGTTAAACTAAGGCTAGTCCGT	1	bc
GACAAACTTA	GAAACACCGGTAATCTAGAGATACACGTGGGGATAGAGCTAGAAATAGCA	1	bc
AAAGCAAAAG	GAAACACCGGTGGGGGTAGAGCTTGAAATAGGAAGTTAACCTAAGGCTAG	1	bc
TCAGCCACAC	GAAACACCGGTGGGGTTAGAGCTAGAAATAGCAAGTTAACCTAAGGCTAG	1	bc
GACACAATCG	GAAACACCGGTAATCTAAAGATCCCCGTGGGGATAGAGCTAGAAATAGCA	1	bc
GACTCAGAAA	GAAACACCGGTACTAGTAATTTGTGAGTGGGGTTAGAGCTAGAAATAGCA	1	bc
TACTCCCTCT	CTAAACACCGGTGGCAATTCTATCTGAGTGTGGTTAGAGCTAGAAATAGC	1	bc
TTCTTACTTC	GAAACACCGGGTAGCGGTAATTATACGTAGGAAATATCAGGCAACCTCAT	1	bc
CCCACAACCC	GAAACACCGGTGCCCCCCGCGTGGCGTTGGGGCTAGAACTAGCAAGATCA	1	bc
AGACAGGACG	GAAACACCGGTGCTCTTGGCTGGAGGGGAGGTAGTAGAGCTAAGATTAGC	1	bc
AAAGCCAACA	GAAACACCGGAGGTGTTAGATCAAGCGATGGCTAGGCAGTAGAAGGCTAG	1	bc
CGACCACCAA	GAAACACCGGTGTGCTTAGACCAGGAATAGCAATATAACCTAAAACTAGT	1	bc
AATCCATCAC	GAAACACCGGTGACAAACGTATGTCAGTGGGGTTAGAGCTAGAAATAGCA	1	bc
AATAACGTCC	GAAACACCGGTAATCTAAAGATCCCCGTGGGGATAGAGCTAGAAACAGCA	1	bc
CCTACATAAA	GACACACCGGTGGCCATTCGATCTGAGAGGGATTAGAGCTAGAAATAGCA	1	bc
GATTGGTAAA	GAAACACCGGTTGTGGGGATATCGGCGTGGGAGAACTAGTAAGTTAAACT	1	bc
ATACACGACC	GAAACACCGGTGCTAGAAGCTTAGTTAGGGGTGGGGTTATAGCTAGAAAT	1	bc
CCGCTACGAC	GAAACACCGGCTAGAAATAGCAAGTTAACATAAGACTAGTCCATTAACAA	1	bc
GACTGCGCCG	GAAACACCGGTTTTAGTAAACGGTGAGTTGGGTTAGAGCTAGAAGTAGCA	1	bc
AATTAAACCG	GAAACACCGGTTCCCTTTATGGGACCGTGGGGTTGGAGCTAGAATAAGCA	1	bc
GAACCCCCCT	GAAACACCTGTTTTATTAAATCGTTGGTGGGGTTAGAGCTAGAAATAGCA	1	bc
ATCTCACATT	GAAACACCGGTGTTCGGAGATTATGCGTGAGAAATAGCAAGTAACCTAAG	1	bc
TACAACCTAT	GAAACACCGGTTTTCTAAGGTTCCTCGTGGGGATAGAGCTAGAAATAGCA	1	bc
AGAATTAACC	GAAACACCGGGTATAGCTATTAATAGGAGGGGTTCCTAAGGCTAGTCCGT	1	bc
CAGTCATCAG	GAAACACCGGTGAGAGCAGATTAGAAATTGAAAGTTAAAATAAGGATGGT	1	bc
TCAGCCCAGT	GAAACACCGGTGGGGTTAGAGCAAGAGCTAGCAAGTTAACCTAAGGCTAG	1	bc
AACCGCCGAC	GAAACACCGGCTAGAAATAGCAAGTTAACCTAAGGCTAGTCCGTTATCAA	1	bc
AGTACATAAA	GAAACACCGGTGAGAACAGACTAGAAATGGCAAGTTAAACTAAGGATAAT	1	bc
CTGGTCGCGA	GAAACACCGGTTGGCTTTGATCCTTTGAGAGCATATAGCTATAAAGCTCA	1	bc
CCGTTACTCC	GAAACACCGGTGGGCTGTGCTCGTTTGTGGGGTTAGAGCTATAAATAGCA	1	bc
ATCTCAGAGT	GAACCACCGGTCTTGGGGGCTTTTGGGGGGGAAATGGATAGAAAATTAAG	1	bc
CATAAAGAAA	GAAACACCGGTGGCAATTCGATCTGAGTGGGGTTAGAGCTATAAATAGCA	1	bc
GAATCATCAA	GAAACACCGGTTATAACAGACTAGGAATAGCAAGTTAACCTAAGGCTAGT	1	bc
AAACCATCAA	GAAACACCGGTGGTAAGAGATGGTTAGTGGGGTTAGAGCTAGAAATAGCA	1	bc
AAAAGGCAAA	GAAACACCGGTTGTGAGCGACGGGTTGTGGGAGAAAAAGCAGGTTAAGCT	1	bc
TGTCCAGATT	GAAACACCGGTCTTCCTGGGGTAGAGCTAGAAATAGCAAGTTAACCTAAG	1	bc
GAGAACGTAA	GAAACACCGGTACTAGTTACTAAGTGGTGGGGTTAGAGCTAGAAATAGAA	1	bc
GGATATGCAA	GAAACACCGGTACTAGTTACTTACGGGTGGGGTTAGAGCTAGAAATAGCA	1	bc
CACAGCCGCT	GAAACACCGGCTAGAAATAGCAAGTTAACCTAAGGCTAGTACGTTATCAA	1	bc
TGACCATACT	GAAACACCGGTTCCCGTTGGTTCGTAGTGGGGTTAGAGCTAGAAATAGCA	1	bc
GGGGAGGAGA	GAAACACCGGTGGGGTTAGAGCTAGAAATGGGATAGTAATCGAAAGCTAG	1	bc
GACTCTTTCC	CTCCCCCCCGGTACTCTTTCCTTACTGGTTTTTTTAGAGCTATCCCTCTC	1	bc
AGTCCCGTGT	GAAACACCTGTTTTGCTTGAGTGGATGTGGGTAGAAGTTGCAAGTTGCAA	1	bc
GGCGCTTACT	GAAACACCGGTGCCCGGTAGCTCAATGGGGGGTTAGAGCTAGAAATAGCA	1	bc
CTAACCCACT	GAAACACCGGTTTACTTAGTTAACTAGTGGGGTTAGAGCTAGAAATAGCA	1	bc
TTAACACATA	GAAACACCGGGAGCCTTATATAACTAGTGTGGTTAGAGCTAGAAATAGCA	1	bc
TCCACCGTCA	GAAACACCCGTAATGCGTGGTTGCGGGTGGGGTTAGAGCTAGAAATAGCA	1	bc
GGCAATGCCA	GAAACACCGGTACCCGTTAGTTCGTGGTGGGGTTAGAGCTAGAAATAGCA	1	bc
GTCTACCCCA	GAAACACCGGTGTGCGGAGATTATGCGTGAGACATAGCAAGTAACCAAGG	1	bc
AGACCCTTCA	GAAACACCGGTTTCGTATGTGCGCTTAGAGCTAGAAATAGCAAGTTAACC	1	bc
AATCGGGACA	GAAACACCGGTTGTGGGGGACTGGGTGTGGGAGTAAAAGTAAGTTAAGCA	1	bc
TGTGCATAAA	GAAACACCGGTGAGAACAGACTAGAAATAGCAAGTTAAACTAAGGCTAGT	1	bc
GTATAAATAA	GAAACACCGGTTAGAGCTAGAAATAGCAAGTTAACCTAAGGCTAGTCCGT	1	bc
AATTCCCCAA	GAAACACCGGTTGCGAATATGTCCGGGTGGGGTTAGAGCTGGAAATAGCA	1	bc
AATCCATCGC	GAAACACCGGTGACAAACGTATGTCAGTGGGGTTAGAGCTAGAAATAGCA	1	bc
TACGCCCTCC	GAAACACCGGTGACGCGAGTATTAGAGCTAGAAATAACAAGTTAACCTAA	1	bc
AGTTCATACA	GAAACACCGGTGAGAACAGATTGGTTGTGGGGAGATAGCTTGAGATAGGA	1	bc
AGTGGGCGGG	GAAACACCGGTGGGGTTAGAGCTAGAAATAGCAAGTTAACCTAAGGCTAG	1	bc
GACCGAAGCA	GAAACACCGGCTAGAAATAGCAAGTTGACCTAAAGCTAGTCCGTTATCAA	1	bc
GATTCAAGAA	GAAACACCGGTTATCGGAGATAGCATGGTAGCCTAAGCTTAAACCGGTAT	1	bc
GTGGGAACGA	GAAACACCGGTGGGGTTAGAGCTAGAAATAGCAAGTTAACCTAAGGCTAG	1	bc
GTAATATGCG	GAAACACCGGTTAGCGCTAGGAATAGCAGGTTATCCTAAGGCTAATCGGT	1	bc
AAAAATATAT	GAAACACCGGTGAGAGCTAGAAATAGCAAGTTAACGTAAGGATAGTCCGT	1	bc
ATATACCCCT	GAAACACCGGTGACGCGAGAATGGGCGTGGGAAATAAGCAATAACTTACG	1	bc
TAAACAGCAT	GAAACACCGGTTTCCGTAAACTCGTAGTGGGGTTAGAGCTAGAAATAGCA	1	bc
TCCCCCCAAT	GAAACACCGGTTTTCCATGGCAATATGAGGGAAGGCTATATCACTATCAA	1	bc
CTCTCATCCC	GAAACACCGGTGGCAATTCGATCTGAGTGGGGTTAGAGCTGGAAATAGCA	1	bc
CCGTTCAAAA	GAAACACCGGTTGACTTTGCTCCTTTGTGGGGTTAGAACTAGAAATAGCA	1	bc
GAGTCAAATT	GAAACACCGGTGATCGGAGATTGCAAGTTAAGCTAAGGCTATACCGTTAT	1	bc
ACGACAACCC	GAAACACCGGTTGTAATTGCTGCTTTGTGGGGTTAGAGCTAGAAATAGCA	1	bc
CGTTCAGATA	GAAACACCGGTCTTCCTGGGGTAGAACTAGAAATAGCAAGTTAAGCTAAG	1	bc
CCCGCACACC	GAAACACCGGTTCAACCAGCGCTTTTTGTGGCGTTAGAGCCTGAGGCAGC	1	bc
AATCCTGCAG	GAAACACCGGTGCCATTTGTGGGACAGTGGGGTTAGAGCTAGAAATAGCA	1	bc
ACCCGCAGCA	GAAACACCGGCTAGAAATGGCAAGTTAACCTAAAGCTAGTCCATTCTCAA	1	bc
TCTGCATCAC	GAAACACCGGTGAGAATATAGCTAGAGCAAGCTAGTTTACCTCAAGCTAG	1	bc
GTGGCCGTCA	GAAACACCGGTGCGGGTAGATCTAGAAAGAGCTAGTTATCCTAAGTCTAC	1	bc
TAATCTGCAT	GAAACACCGGTTTTAGTAAATGGTGAGTGGGGTTAGAGCTAGAAATAGCA	1	bc
TGTCCAGATA	GGAACACCGGTGCTGTATAGTTAGAAATAGCAAGTTAACCTAAGGTTAGT	1	bc
TACACTTTCA	GAAACACCGGTTCCCGTTAGTTCGTAGTGGGGTTAGAGCTAGAAATAGCA	1	bc
TAAGCCAAAC	GAAACACCGGTGGGGTTAGAGCTAGAAATAGCAAGTTAACCTAAGGCTAG	1	bc
GCCCGACGCG	GAAACACCGGCTAGAGATAATGGTGTGAGGGATTAGTGTTAGAATATCCA	1	bc
GAATCCATGC	GAAACACCGGTTTACATGATAACGTTCGTGGTGGTAGAGCTAGAAATAGC	1	bc
TACTCTCAAA	GAAACACCGGTTTAATTTGCTTACTAGTGGTGTTAGAGCTAGAAATAGCA	1	bc
CAACCCGTTA	GAAACACCGGTTGAGGATGGGGGGGTAGAGCTTAGAATAGCAAGGTAACC	1	bc
CGCTCATCCC	GAAACACCGGTGAGAACAGTCTAGAGATAGCTAGTTAACCTAAGGCTAGT	1	bc
TGAACAACAA	GAAACACCGGTGAGAACAGACCAGGAGTACCAGGTTAACCAAAGGCAAGT	1	bc
TTCGCATCAC	GAAACACCGGTGGCGAAAGTGTGACAGAGGGGTTGGAGCTAGAAATAGCA	1	bc
AGTTACGCCA	GAAACACCGGTTGCGGCCAACTCGGTGTGGGAGTAATAGCAAGATAACCT	1	bc
ATATTATCGA	GAAACACCTGTGTGCGGGGATTATGCGTGAGAGATAGCAAGTGACCTAAG	1	bc
GTAATAGCTG	GAAACACCGGTTATAGCTAGAAATATCAAGGTAACCGAGCTCGAATCTGT	1	bc
AAACCCCGCC	GAAACACGTGCTCGAAATAGCGGGTTAACCTAATGCTGCTACGTTTTCCA	1	bc
CCGATCGCCC	GAAACACCGGTTGGGTTAGATCCTTAGAGGGCATGGAAATCTAAATATAA	1	bc
GAATCCCAAA	GAAACACCGGTGCTAATAGTTAGCTCGTGGGGTTAGAGCTAGAAATAGCA	1	bc
CCTCGTCCCC	GAAACACCGGCTACATTTATGGAATTGACGTAATCGAGCTCGGAATACCA	1	bc
CTCCGCCTCG	GAAACACCGGCTAGAAATAGCAAGTTAACCTAAGGCTAGTCCGGTAACAA	1	bc
TGCAACCACG	GAAACACCGGTGAGGACAGACTAGAAGTTGCACGTTGCCCTATGTCTTGT	1	bc
GAAAATGTCA	GAAACACCGGTACTAGTTACTTACGGGTGGGGTTAGAGCTAGAAATAGCA	1	bc
TCTTCATTAT	GAAACACCGGTGAGGACAGACTTGAAATAACAAGTTAACCTATAGCCTGT	1	bc
AATTCAATGA	GAAACACCGGTGAAGACTGTGTAGAAAGAGCTAGATATCGTAAGTTTACT	1	bc
GCCTTACACA	GAAACACCGGTGCTACTAGTTACTTCTTGGGGTTAGAGCTAGAAATAGCA	1	bc
CTGTCATCAG	GAAACACAGGTGATAGAAGCCGAGATATAGCTAGTTAACCTAAGGCAAGT	1	bc
ACCCGACACC	GAAACACCGGTTGGAAATAGCAAGTTGACCTATGACTAGTCCGTTATCAA	1	bc
CATATATATA	GAAACACCGGTGGCCATTCGATCTGAGTGGGGTTAGAGCTAGAAATAGCA	1	bc
GGGCCAGGCT	GAAACACCGGTCATCGGAGAAACCAAGTTAGCCAGAGCTAGATCCGTCAT	1	bc
CATCGGCCCC	GAAACACCGGCTAGAAATAGCAAGGTGACCTAGGACTAGTCCGTTAACCT	1	bc
CGCTAATCGA	GAAACACCGGTGAGCGCAGACTATACTTGGCAAGTTAAACTAAGGCTAGT	1	bc
TCAATATAAA	GAAACACCGGTGAGAGTAAAAAATAGCATGGTAACCTAACCTAAGGCCGT	1	bc
TAATCACTAC	GAAACACCGGTGGAGATACTAAAAAAGTGGGGTTAGACTAGAAAATAGAA	1	bc
ACCTAGGCAT	GAAACACCGGTTGTGGGCGACGCGGTGTGGGGGTAGTAGTAGGATAAGCA	1	bc
GGGGACCAAA	GAAACACCGGTGGGGTTAGCGCTAGAAATGGCAAGTTAACCTAAATATAG	1	bc
AACTGCGGCC	GAAACACCGGCTAGAAATAACACGTTAAGGTAAAGATAGTCCGTTATCAA	1	bc
CCAGCAAACC	GAAACACCGGTGGGGCTAGAGCTAGATATAGCAGGATAACCTAAGGCTAG	1	bc
GCAGTAGATA	GAAACACCGGTTAGAGCTAGAAATAGCAGGTTAACCTAAGGCAAATACGT	1	bc
AGATTCCAAC	GCAACACCGGTGCTGATCGTTAGCTCGTGGGGTTAGAGCTCGCAATCGCA	1	bc
TACTCTGTCA	GAAACACCGGTACTAGTTACTTCCGGGAATAGTTAGAGCTGTAAATACCA	1	bc
AAACCACAAC	GAAACACCGGTGTACTTTGCTAGCGGGTGGGGTTAGAGCTAGAAATAGCA	1	bc
TAAATAACCT	GAAACACCGGTTCCAATTAGCTCGTAGTGGGGTTAGAGCTAGAAATAGCA	1	bc
TACTGAAACT	GAAACACCGGTTATCGGAATTTGCAAGTGGAGCTAGGGCTAGAAATAGAA	1	bc
TAATCAGTAA	GAAACACCGGTGGGGTTTGAGCTAGAAATGGCATGTTAACCTAAAGCTAG	1	bc
TGCTTTTTCC	GAAACACCGGTTCCCGTTAGCTCGTAGTGGGGTTAGAGCTAGAAATAGCA	1	bc
ACATAAAAGA	GAAACACCTGTGTGGTTAGATTATGAGTTAGAAAGAGCACCTAACCCAAG	1	bc
GAACCAGTAA	GATACACCGGTGCTAATTACTTAAGAGTGGGGTTGGAGCTAGAAATAGAA	1	bc
AAATATATAG	GAAACACCGGTGAGCATGAGCGGGCCGTAGGAAGATAGCTTAAGATAAGA	1	bc
CAAAGACGCC	GAAACACCGGCTATAAATAGCAAGTTAACCTAAGGCTAGTCCGTTATAAA	1	bc
ATGACCGTTA	GAAACACCGGTCTTACATGCTGCGTTTGGGGGGAGAGATAGAGATATAAC	1	bc
CATATACATA	GAAACACCGGTGGGAGCTCGAACTGAGAGGGTAAAGTGCTACAAGTCCGT	1	bc
GGGTGGAGCG	GAAACACCGGTTATCGGACATAGCAAGTTAACCTAAGGCAAGTCCGTTAT	1	bc
GATCCATCCA	GAAACACCGGTGACATACCTCTGTCAGTGGGGTTAGAGCTAGCAATAGAA	1	bc
CGTCCTTCCC	GAAACACCGGTTCCCGTTATCTCGCAGTGGGGTTAGAGCTAGAAATAGCA	1	bc
TTCTAACTCA	GAAACACCGGTGTGGGGAGATTATTCGTGATAGATAGCAAGAAACCTAAT	1	bc
GCTGGCGACC	GAAACACCGGTGGCGTTGGACCCAGAGTGGGGTTAGAACTAGAAAGAGAA	1	bc
GAGCTACGCA	GAAACACCGGCTATCGGAAATAGCGAGTTAAATTACAGCTAGACCTATGC	1	bc
GGACAGTAAA	GAAACACCGGTGATCTTTTCTCGAGGGGTGGGGTTAGATCTAGAAATAGC	1	bc
TTAACCATAA	GAAACACCGGTGGGGTTAGAGCTAGAAATAGCAAGCTAAAATTAGGCTAG	1	bc
CCATTCCCAT	GAAACACCGGTTTGCTTTGCTCCTTTGTGGGGTTAGAGCTATAAATAGCA	1	bc
CATCGCCACC	GAAACACCGGCTAGAAATAGCAAGTTAACCTAAGGCTATTCCGTTAACAA	1	bc
GTTTGAGCGA	GACACACCGGTGGGGTTAGAGCTAGAGATAGCAAGTTCACCTAAGGCTAG	1	bc
TAAAGTTCTT	GAAACACCGGTTCCAGCCGGTTCGAAGTGGGGTTAGAGCTAGAAATAGCA	1	bc
CGGTCGACAC	GAAACACCGGTTGGCTTTGCTCCTTTGTAGGGTTAGAGCTATAAATAGCA	1	bc
AAGTTAACAA	GAAACACCGGTTGGGTGTAATTCTTTGTGGGGGTAGAGCTATAAATAGCA	1	bc
TAGACCGACG	GAAACACCGGTTATCGTAGATAACTAGTTGGCTTAAGGCTAGAACGTTCT	1	bc
CACACTCACA	GAAACACCGGTGGCCGTTAGCTCTTAGTGGGGTTAGAGCTAGAAATAGCA	1	bc
TCATCAACCA	GAAACACAGGTTGTGGTGGACTCAGAGTGGGCGAGATAGCCTGTTACCAT	1	bc
AAATGAGCCA	GAAACACCGGTTGTAGGGAACGGGGTGTGGGGGTAAAAGCAGGAATAGCA	1	bc
AGGATTAGAA	GAAACACCGGTGCTAATAGTTAGCTCGTGGGGTTAGAGCTAGAAATAGCA	1	bc
TAAGCCACAC	GAAACACCGGTTTACTTATTTAACTAGTGGGGTTAGAGCTAGAAATAGCA	1	bc
AACATGCCAG	GAAACACCGGTTTTCGATCATAGGTCCGTGGGGTTAGAGCTAGAAATAGC	1	bc
GATTCATCCA	GAACCACCGGGATTAGAAAATAGAGAGAGGGAGTTAACCTAGGAATAGTC	1	bc
TGCGCCTCGT	GAAACACCGGTTCCCGGTAGCTCGTAGTGGGGTTCTAGCTAGAAATATCA	1	bc
CCAGCGAATG	GAAACACCGGTGGGGTTAGAGCTAGAAATAGCACGTTAACATAAGGCTAG	1	bc
TTGACCGACT	GAAACACCGGTTTACTTAGTTAACTAGGGGGGTTAGATATAGAAATAGCA	1	bc
TCCGCCACCA	GAAACACCGGTCGCGATAGAGCTCGGGATGGCATATTGCCCTAAGTCTCA	1	bc
GAGTCCGTCG	GAAACACCTGTTATCGGAAATAGCAAGTTAACCGAAGGCGAATGCTTTAC	1	bc
CGAACACCTC	GAAACACCGGTCATCTACAGATCCCCGTGGGGGTAGAGCTAGAAACAGCA	1	bc
TTCTCCCAAT	GAAACACCGGTTTACTTAGATAATTCGTGGGGTTTAGCCAGTAACCTGCG	1	bc
TCCGCGACAG	GGGACGCCGTTGGGGGTAGAGATAGAAATGGCAAGTTAACCTAAGGCTAG	1	bc
ACCAAAAGGA	GAAACACCGGTGGTCGCCGTGGATAGGTGGGGATAGAGCTAGAACTCGCA	1	bc
GTGGGAGAAC	GAAACACCGGTGGGGTTAGAGCTAGAGATAGCATGTCGACATAAGGATCG	1	bc
CGATAGTAAA	GAAACACCGGTGTGAACAGACCAGAAATAGGAAGATAACCTGAGGCAAGA	1	bc
CCGCCCATGC	GAAACACCGGTTGTCTTTGCTCTTTTGCTGGGTTTGAGCTATTAATATCA	1	bc
GCCTGAAGCA	GAAACACCGGTTAGAAATAGGAAGTTAAGAGAAGGCTAGTCTGTAATTAG	1	bc
CTCTAACCTT	GAAACACCGGTGTGCGGAGATTATGCGTGAGCAATAGCAAGTAACCTAAG	1	bc
ACACCACAAC	GAAACACCGGTGTTGTTTGCTCTAGAAAGGGCTTGTTACCCTAAAGATCG	1	bc
TACTTTTTCC	GAAACACCGGGTAGAGCTAGAAATAGCAAGGTAAGCTAAGGCTAGTCCGA	1	bc
CCGTTCCTAT	GAAACACCGGTTACGCTTGCTCCTTTGTGGGAATAGAGCTATAAATAGCA	1	bc
GAGATAAACG	GAAACACCGGTTATCGTAAATACCAAGTTAACCTAAGACCTATCAGTTAT	1	bc
GCATTACTCT	GAAACACCGGTGACGCGAGGGATATAGCTAGAAATAGCAAGTTAACCTAA	1	bc
GAGGGAGAGG	GAAACACCGGTGAGGGTAGCGCTAAACATGGCAAGATAGCCTGAGGCTGG	1	bc
AAAGCAACAC	GAAACACCGGTGACGTTAGAGCTACAGATAGCATATTAACCTAAAGATAG	1	bc
CGGCGGGTTG	GAAACACCGGTTCCCGTTAGCTCGTAGTGGGGTTAGAGCTAGAAATAGCA	1	bc
ACAACCCTAC	GAAACACCGGTGACGCGCGGGTTAGAGTGAGGATAGAGATATAAATTTAA	1	bc
CCACCAATAC	GAATCACCGGTTTGGTTTGCTCCTTTGTGGGGTTAGAGCTATAAATAGCA	1	bc
AACATACCGA	GAAACACCGGTGTGCGGTGATTATGCGTGAGAATTAGCAAGTAAACTACG	1	bc
GAGTAAGCAC	GAAACACCGGTAGTCTTTACTTACGTGTGGGGTTAGAGCTATAAACAGCA	1	bc
GGAATGTATC	GAAACACCGGTTATCTCTAGAAATATCAGGTTATCCTAAGGCTAATCCGT	1	bc
GAACGAGATA	GAAACACCGGTTAGAGCGAGTAATAACAAGTTATCCTACTGCTAGTCCCT	1	bc
TCAACAATCA	GAAACACCGGTGGGGTTAGTGCTAGAGAGGGAAAGTTAACCAAATAGCAG	1	bc
TCATCCTCAC	GAAACACCGGTGGCGTTAGTGCTATGGTTGGGATAGTGCCCTAAGTCTCA	1	bc
AAGACAGTCG	GAAACACCGGTTATAGGAGATAAGAAGTGGGCCTAAAGCTAGAAAGAGAA	1	bc
TAAGCCAAGA	GAAACACCGGTGGGGTTAGAGCTAGAAATAGCAAGTTAAACTAAGGCTAG	1	bc
CAACTATATT	GAAACACCGGTTATAGCTGGAAATAGCTGGTTATCCAAAGGGTAGTCCGT	1	bc
TAAAATATCG	GAAACACCGGTTGCGATTATCAAACCGTGGGGTAGAACTAGCAATTGCAA	1	bc
TAAACTTCCC	GAAACACCGGTTCACGTTAGCGCGTAGTGGGGGTAATGCTAGGATAAGCT	1	bc
GAAACATAAC	GAAACACCGGTTAGAGCCAGATATCAGTGGGGTTACAGCTACAAATCGGA	1	bc
AATCTAACAA	GAAACACCGGTGCTAATAGTTAGCTCGTGGGGTTAGAGCTAGAAATAGCA	1	bc
TTTTTCGCAC	GAAACACCGGTCGCGAAAATGTGGGGGTGGGGTTAGAAATAGCAAGTCCA	1	bc
TGTCCAGATT	GAAACACCGGTGAGCCCAGACTCGAAATAGCAAGTTAACCTAAGGCTGGT	1	bc
GATTAGATAG	CTAAACACCGGTTATCTGAACTAGAACGTTCCCTTAAGGCTAGTCAGTTA	1	bc
AGGACATCAA	GAAACACCGGTGAGAACAGACTAGAAATAGCAAGTTAACCTAAGGCTAGT	1	bc
ATGACCGTCG	GAAACACCGGTCCTAGAAGCTGAGTTTGTGGGGTTAGAGCTAGAAATAGC	1	bc
CAGCCAGGCT	GAAGCACCGGTTATGGGAATAAGCCAGTTAACATCAGGCTAGTCCGATAT	1	bc
AAAACCGAAG	GAAACACCGGTTTTAGTAGTTAACTAGGGGGGGTAGAGCTAGAAATAGCA	1	bc
GAATCTGAAA	GAAACACCGGTACTAGTTACTTACGGGAGGGGTTAGAGCTAGAAATAGCA	1	bc
CAATGATCTT	GAAACACCGGTGAGAACGGACTGGGAATGGGAATATAACCTAAAGCTAGA	1	bc
GCGGTCATTA	CTAAACACCGGTGAGAACAGACTAGAAATAGCAAGTTAACCTAAGGCTAG	1	bc
CGATAGTAAA	GAAACACCGGTGAGTACAGACTAGAAGTAGGGAGATAACCTAAAACAGGA	1	bc
CACCTCTGCC	GAAACACCGGCTAGAAATATCAAGTTAACCTAAGGCTAGTCCGTTATCAA	1	bc
GGGTCGGGCG	GAAACACCGGTTATCGGACATAGCAAGTTAACCTAGGGCTAGACCGTTAT	1	bc
TATCTAAACG	GAAACACCGGTGTGCGGAGATTATGCGTGATAAATAGCAAGTAACCTAAG	1	bc
CCTTCACACC	GAAACACCGGTGGTACTTCGATCTGTGTGGGGTTAGAGCTAGAAGTAGCA	1	bc
TCCCCACTCC	GAAACACCGGCTAGGAGAGGACATTAGACCTAGAGCTAGCCCGTTATCCT	1	bc
TGCTCTGTAT	GAAACACCGGTACTCGTTAATTACGGGTGGGGTTAGGGTAGGAATTAGCA	1	bc
CCTTGGACAC	GAAACACCGGTTGTGGGGACCTCGGTGTGGGAGAAATAGCAAGATAACCT	1	bc
GCCTCAAACC	GAAACACCGGTGCTAATAGCTAGTTCGTGGGGTTAGAGCTAGAAATAGCA	1	bc
GAACCAATCA	GAAACACCGGTTTAGTATGTGGGGTTAGAGGTAGAAATAGCAAGATAACC	1	bc
GCATCAACAG	GAAACACCGGTTTTAGTAAATGGTGAGTGGGGTTAGAGCTAGAAATAGCG	1	bc
TACACTTACA	GAAACACCGGTGGCCATTAGCTCGGAGTGGGGTTAGAGCTAGAAATAGCA	1	bc
TCCAAAAAAT	CTAAACACCGGTGGTCGTCGTGGAGAGGTGGGGTTAGAGCTCGAAATAGC	1	bc
TTCAACAAAA	GAAACACCGGTGGGGTTAGAGCTAGAAATAGCAAGTTAACCTAAGGCTAG	1	bc
GATCGGGCGA	GAAACACCGGTTGTGGGGAACCCGGGGTGGGAGAAATAGCAAGTTAACCT	1	bc
AAAAAACCGA	GAAACACCGGTGTGGGGAGATTATGCGTGAGAAATAGGAAGGAAACTAAA	1	bc
CGTTGGGTTG	GAAACACCGGTGGTCGTTCGATCTGAGAGAGCTAAGATCAATAAGTTAAA	1	bc
AGACCGAACC	CTAAACACCGGGTAGAGCTAGAAATAGCAAGTTAACCTAAGGCTAGTCCG	1	bc
AACCTACCCC	GAAACACCGGTGTGCGGAGATTATGCGTGAGAAATAGCAAGTAACCTAAG	1	bc
TAAGAAAGAA	GAAACACCTGTGGGGTTAGAGCTAGAAATAGCAAGTTGACCTAATGCTAG	1	bc
GGCATAACCT	GAAACACCGGTTCTCGTAGTCACGTCGTGGGGTTAGAGCTAGAAATAGCA	1	bc
GAGTTCCCCC	GACACACCTGTTGTCTTTACTCCTTTGTGGGGTTAGAGCTATAAATAGCA	1	bc
AAACGAGTGT	GAAACACCGGTTCAGGCTGTGGCGATAGAGCTGGAAATAGGCAGTAAATC	1	bc
GACTTCAACA	GAAACACCGGTGATGATAGTTAGCTCGTGGGGTTAGAGCTAGAAATAGCA	1	bc
TAGACAAAAG	GAAACACCGGTTTACGTAATGAACTAGAGGTAGAAGAGCTAAGAATAGCA	1	bc
CAGTAAGTAA	GAAACACCGGTTGTGTTTACTCCTTTGTGGGGTTAGAGCTATAAATAGCA	1	bc
ACACCGCCGC	GAAACACCGGCTAGAAATAGCAAGTTAACCTAAGGCTAGTCCGTTATCAA	1	bc
TATTCAGACA	GAAACACCGGTTTTGGTGGACTCTGTGTGGGGTTAATCGAAAGATAACCT	1	bc
ATCTAGGCAA	GAAACACAGGTGTGCGGGGATTATGCGTGGGAGATAGCACGAAACATAAG	1	bc
GCGGCCCAAA	GAAACACCGGTGGGGTTAGAGCTAGAAATAGCAAGTTAACCTAAGGCTAG	1	bc
TCAGCCCACC	GAAACACAGGTGGGGTTAGAGCTAGAACTAGCACGTTACCCTAAGGCTAG	1	bc
TCCGCCACAA	GAAACACCGGTGGGGTTAGAGCTAGCAATAGCAAGTTAACCTAAGTCTAG	1	bc
CCGCGCACTC	GAAACACAGGTTGGACATAGCACTTTAACGTTATACTGGTCCGTTAACCA	1	bc
AAAAACAAAT	GAAACACCGGTTTTCTTAGTTAGATAGTGGGGTTAGAGCTAGAAATAGCA	1	bc
CGATAAAAAA	GAAACACCGGTGCGAATAGATAAGAAGTGGGAAGATAACCTAAAGCAACA	1	bc
ATGCAATTCC	GAAACACCGGTTCCCGTTAGCTCGTAGTGGGGTTAGAGCTAGAAATAGCA	1	bc
TATATAACCG	GAAACACCGGGGTGCGGAGATTATGCGGGAGAAATAGCAAGTAAACTAAG	1	bc
CTTCTTCTTC	GAAACACCGGTTCCCGTTAGCTCGTAGTGGGGTTAGAGCTATAAATAGCA	1	bc
CAGAAAACAC	GAAACACCGGTAATCTAAAGATCCCCGTGGGGATAGAGCTAGAAATAGCA	1	bc
GATTCAACAA	GAAACACCGGTTATCGGAAATAGCAAGTTAACCTGAGGCTAGTCCGTTAT	1	bc
GACTTACTAG	GAGACACCGGTGCTAATAGTTAGCTCGTGTTATTACAGCTAGAAATAGCA	1	bc
ACAGCGGAAA	GAAACACCGGTGGGGATAGAGATAGAAATAGCATGTTAACATAAGGCTAG	1	bc
TGCTATGCAA	GAAACACCGGTACTAGTTACTTACGGGTGGGGTTAGCGCGAGAAATAGCG	1	bc
GGCTAAGCAA	GAAACACCGGTGAGAACAGACTAGAAATGGGAAGATAACCTAAGATTAGA	1	bc
CGTCCCTCAC	GAAACACCGGTGAGCTCAGACTCGAAATAGCAAGTTAACCTAAGGCTAGT	1	bc
GAGACCAAAT	GAAACACCGGTTTACTTAGTTAACTAGTGGGGTTAGAGCTAGAAATAGCA	1	bc
TCATCAAACG	GAAACACCGGTTGGGTTTGAGCTAGTAATTGCATGTTGACCTAGGGCGCG	1	bc
CGATTAACAA	GAAACACCGGTTGGAATAAACAAAAAGTGGGGTGGTAACTAAAAAAAGAA	1	bc
TCAACGAACA	GAAACACCTGTGGTGTTAGAGCTAGAAATGGCATGTTAATCGAAATCTAG	1	bc
AAAAACCTGC	GAAACACCGGTTTAGTATGTGTGGTTAGAGCTAGAAATAGCAAGTTAACC	1	bc
TCTCCCCAAT	GAAACCCCGGTTTCCTTCGTTACCTCGTGGGGTTAGAGCTAGAAATCGCA	1	bc
GAATCCCTAT	GAAACACCGGTTTAGTTAGTTGGCTAGTGGGGTTAGAGCTAGAAATAGCA	1	bc
CAGTTAGAAC	GAAACACCGGTTGGATTTACTCCTTTGTGGGGTTAGAGCTATAAAAAGCC	1	bc
ATCTCACGCA	GAAACACCGGTGTGCGGAACTTGTTATTGAGAAATAGCAAGTAGCCTAAG	1	bc
TACGCAACAA	GACACACCGGTGGGGTTAGAGCTAGAAATAGCAAGTTACCCTAAGGCTAG	1	bc
CTCCTCCCCC	GAAACACCGGCTAGAAATAGCAAGTTAACCTAAGACTAATCCGTTATCAA	1	bc
GCGAAAAACA	GAAACACCGGTGGGCTTCGTGCTGAGGATGGGATATAGCTAGAAAGATCA	1	bc
AATCAAGCAG	GAAACACCGGTGCCCTATGTGTGACCGTGGGGTTAGAGCTAGAAATAGCA	1	bc
AATCCATCAT	GAAACACCGGTGTCCAACGTATATCAGTGGGGTTAGAGCTAGAAATAGCA	1	bc
TGCCGTCGCC	GAAACACCGGCTAGCAATAGCAAGTTAACCTAAGACAAGTCCGTAATAAA	1	bc
ACCCCACACC	GAAACACCGGCTTGAAATAGCAAGTTAACCTAAGGCTATTCCGATATCAA	1	bc
AGAGTATGTA	GAAACACCGGTACTAGTTAATTACGGGTTGGGTTAGAGCTAGAAATAGAA	1	bc
AAGGGAGCAC	GAAACACCGGTGGCGTTAGAGCTAGAAATAGTAAGATAACCTAAGGCTAG	1	bc
GCAACACACC	GAAACACCGGTGGTCTTAGGGTCAGAGTGGGGATATAACTCGAAATCGCA	1	bc
CACCGACACC	GAAACACCGGCTAGAAATAGCAAGTTGACCTAAGACAAGTACTCAAACAA	1	bc
ATGGCCGAGG	GAAACACCGGTCGGGGTAGCGCTAGAAATAGCAAGTTGACCTAAGGCTCG	1	bc
GTCTGCGCGA	GACACCCCGGTGTGCTTAGATTTAGCGATAGCAATTTCACCTAACCCAAG	1	bc
GAGCCAGGTG	GAAACACCGGTCATCGGAAAAACCACGTTGACCAGAGCTAAGTACGTTAT	1	bc
GATTCAGGAA	GAAACACCGGCGATAGCAAAAAACAGGTTGGTCTAATGCTAGTAGTCCGT	1	bc
GACTCTTCAT	CTCACCCCCGGTTCTCTTTCCTTACTGGTTTTTTTAGAGCTATCCCTCTC	1	bc
TTCTCCCCAT	GAAACACCGGTTTGCTTAGTTAACTAGTGGGGTTAGAGCTAGAACTTGCA	1	bc
AATGCAAAAA	GAAACACCGGTTGGGTTAGAGTCAGAGATGGCGAGTTAACATATTGCCAT	1	bc
CCAAGCCGAC	GAAACACCGGCTAGCAATAGCAAGTTAACATAAGGCTAGTCCGTTATCAA	1	bc
AATGCAAAAA	GAAACACCGGTGGGGTGGTAACTGGAAAGGGCAAATTAGCCTAAGGATAG	1	bc
GAATAAGAAG	GAAACACCGGTTTTAGTAGATGGTGAGTGGGGTTAGAGCTAGAAATAGCA	1	bc
TTGAGCGAGT	GAAACACCGGTGGGGTTAGAGCGAGAGATGGCAAAGAGCCATAAGGATCA	1	bc
AGAGTGAAGC	GAAACACCGGTTATCGGAAATATCAAGTTAACCTAAGGCTAGTCCGTTAT	1	bc
ATTAAAGTCG	GAAACACCGGTGCTATTTATAGGATCGGGGGGTTAGAGCTAGAAATAGAA	1	bc
CGTCGCCACA	GAAACACCGGTTAGCAATAGCAAGTTAACGGAAGGATAGACAGTTATCAA	1	bc
TGTTCCTAAA	GAAACACCGGTGTGAACAGACTAGAAGTGGGGATATAACCAGAAGCTAGA	1	bc
ATAACAATAA	GAAACACCGGTGGGGTTAGAGCTAGAAATAGCAAGTTAACCTAAGGCTAT	1	bc
GAATCCAGAG	GAAACACCGGTTATCGGAAATAGCAAGTTGACCTAAGGCTAGTACGATAT	1	bc
CATACTCACG	GAAACACCGGTGCCCTTTCTGGGTGCGTGGGGTTAGAGCTAGAAACAGCA	1	bc
TCCACGTACT	GAAACACCGGTTCCAGCTAGCTCGTAGTGGGGGTAGAGGCAGAAATAGCA	1	bc
TGAAACGCAA	GAAACACCGGTTTTCTTAGTTAACTAGTGGGGTTAGAGCTAGAAATAGCA	1	bc
TAAGCAACCA	GAAACACCGGTGGGGTTAGTGGTAGCGATAGCAAGGTACCCTAAGGATCG	1	bc
ACTCCATCAC	GAAACACCGGTGACAAACGTATGTCAGTGGGGTTAGAGCTAGAAATAGCA	1	bc
GGCAACTAAG	GAAACACCGGTACTAGTAACTTACGGGTGGGGTTAGAGCTAGAAATAGCA	1	bc
CAAAAAAATT	GAAACACCGGTGGTCGCCGTCTAGAGGTGGGGTTAGAGCTAGAAATAGCA	1	bc
ATAAGCAAAA	GAAACACCGGTGGGGTTAGAGCTAGAAATAGCAAGTTAACCTAAGGCTAG	1	bc
CCTTGCGCCA	GAAACACCGGCTGTGAGTAACAAGTTAAGGGAGAGCTAGCCCGTTATCAT	1	bc
GATTGAAGCA	GAAACACCGGTTATCGTGAACTAGTTATGGGAGTAGTAGCAAGTTAACCT	1	bc
AATTCTGTAA	GAAACACCGGTACCAAACGCTTACGGGTGGGGTTAGAGCTAGAAATAGCA	1	bc
TAATGCCTCC	GAAACACCGGTTGGAATTATCAAAAAGAGGGGAGGATCTAGAGTTAGCAA	1	bc
GTATTATACC	GAAACACCGGTTAGAACTAGAAATAGCAGGTTAACCTAAGGCTAGTCCGA	1	bc
CCCCGGCCAC	GAAACACCGGCTAGGAAGAACAAGTTAAGCTAGAGCTAGCACGTTAACAA	1	bc
GTGGGCGCCG	GAAACACCGGTGGGGGTAGAGCTAGAAATGGGATGTTAACCTAAGTCTAG	1	bc
AGATGGCCAA	GAAACACCGGTTTTGGGTGATTCGGTGTGGGAGAAATACCAAGTTAACCT	1	bc
ATCTCACAGC	GAAACACCGGTGTGCGGAGATTATGCGGGAGAAATAGAAAGTAACCTAAG	1	bc
GCCTTGGGCA	GAAACACCGGTTGCGGGGAACTCGGTGTGGGAGATATAGCAAGTTAACCT	1	bc
CGGTGGGCTG	GAAACACCGGTCGGCGGTCATAAGGCGTGGGAATAAGCCAAGAACTTAAA	1	bc
TGAAGCGTCT	GAAACACCGGTGACGCGAGGGTTAGAGCTGGAAATAGCAAGGTAACCTAA	1	bc
TCGACCATCG	GAAACACCGGTTACGGGAGGGGTAGAGCTAGGAATAGCATGTTAATCTAA	1	bc
CAGACCCCAT	GAAACACCGGTTTACTTAGTTACCTAGTGGGGTTAGAGCTAGAAATAGCA	1	bc
CACCCACGCA	GAGACACCGGCTGGAAATCGATCTGTGACCTATGACTGGTACGTTATCCA	1	bc
AGACCGCTCT	GAAACACCGGTGATGCGTGGTCGGTGGGGGGGTTAAAACTAGAAAAAGCC	1	bc
AGAACTTACT	GAAACACCGGTTCCCGTTAGCTGGTAGTGGGGTTAGAGCTAGAAATAGCA	1	bc
GTACAACAAA	GAAACACCGGTGTGCATGGCTCAAAAAGAGGAAGTAGAGCTAGAAATAGC	1	bc
ACCCCCGGCC	GAAACACCGGCTAGAAATAGCAAGATAACCGAAAGGTATACCTATAGCAA	1	bc
TCAGCATCAC	GGAACACCGGTGGGATTAGAGCTAGAAATGGCTAGTTAACCTAAGGCTTG	1	bc
TTAACCAAAC	GAAACACCGGTGGGGTTAGAGCAAGAGTTAGGTAGTTAACCTAAGGATAG	1	bc
CCGCGAAGAC	GAAACACCGGCTAGCAATAGCAAGTTGACCTAAGGCTGGTACGTTATCAA	1	bc
GTGCCACGCG	GAAACACCGGTTATCGGCAATGGCAAGTTAACCTAAGGCTAGTACGATAA	1	bc
CGATCGCCAA	GAAACACCGGTGAGAACAGACTAGAAGTAGCAATATAACCTAAAGCTAGT	1	bc
ATAACCGTCT	GAAACACCGGTGACGCGAGGGTTAGAGCTAGAAATAGCAAGATAACCTAC	1	bc
CTTTTATCCA	GAAACACCGGTGAGAACAGTCTAGAGGTGGCAAGATAACCTAAAACTAGA	1	bc
ATTTCACCAA	GAAACACCGGTGAGGAGAGACTAGAAGTGGGAAGTTAACCTAAGGCTAGT	1	bc
TATTCAGAAT	GAAACACCGGTTGTGCTGGACTCTGGGTGTAGGAAAACCCAGTTTACCCT	1	bc
TCTTCAAAAT	GAAACACCGGTGGGGTTAGAGTTAGAAATTGTATGTTAATCTAAGGCTCG	1	bc
TCGCCAGCTT	GAAACACCGGTCTTCCTGGAATCTACGTGGGGTTGGGGTAGAAATAGGAA	1	bc
AAAACACCAC	GAAACACCGGTGTTCTTTGCTCGAGGGGTGGGGTTAGAGCTAGAAATAGC	1	bc
ACCTAGCACC	GAAACACCGGTGTACGGAGATTATGCGTGAGAGATAGCAAGAGACATAAG	1	bc
AATAAAACCA	GAAACACCGGTTGTCGCCGACTCGGGGTGGGAGTAATACTAAGTTAACCT	1	bc
GTGTGACCGA	GAAACACCGGTGGGGGTAGAGCTAGAAATAGCAAGTTAACCTAACGCTAG	1	bc
AGCTTACCAA	GAAACACCGGTGAGAACAGACTAGAAATAGCAAGGTAACCTAAGGCTAGG	1	bc
ATACTACATA	GAAACACCGGTGTTCTTGACCCGGGAGTGGGGTTATAGCTAGAAATAGGA	1	bc
CTTTCCTCGA	GAAACACCGGTGAGATCCGTCTAGAACTAGCAATATCACGTTAGCCTAGT	1	bc
TCATCAAGCG	GAAACACCGGTTATCGGAAATAGCAATTTAACCTAAAGCTAGAACGATAT	1	bc
AAATTAACAC	GAGACACCGGTTGGTTTTACTCCTTTGTGGGGTTAGAGCTATAAATAGCA	1	bc
CAATAAGAAA	GAAACACCGGTACTAGTTACTTACGGGTGGGGTTGGAGCTAGAAATAGCA	1	bc
GAAATATTCC	GAAACACCGGTTAGCGATAGAAATAGCAGGTTAACCTAAGGCTAGTCCGT	1	bc
CCAGGAGAAA	GAAACACCGGTGGGGTTAGAGGTAGAAACAGCAAGTTATCCTAATACTAG	1	bc
GAAAAACAAT	GAAACACGGGGTTATTTAGTTAACTAGTGGGGGTAAAGCTAGAGATAGCC	1	bc
CCACGACACC	GAAACACCGGCTGGAAATAACAAGTTGTGGGGTTGATAGTCCAATATCAA	1	bc
TCAGCCAACC	GAAACACCGGTGGGGTTAGAGCTAGAAATAGCAAGTTAACCTAAGGCTAG	1	bc
TCGTTCATAT	GAAACACCGGTGAGGTTTGCTCGTTTGTGGGGTTAGAGCTAGAAATAGCA	1	bc
ATAGCAGACG	GAAACACCGGTCCTAGAAGCTGAAGTGGGGGTAGAGCTAGAAATAGCAAG	1	bc
AATTCATCCG	GAAACACCGGTGCCCTTAGACGGTCAGTGGGGTTAGAGCTAGATATAGCA	1	bc
AAATGAGCCA	GAAACACCGGTTGTAAGGGACTGGTTGTGGGGGTAGTAGTAGAAAAATCT	1	bc
CCGCGCAGCG	GAAACACCGGTAGAAGGGATTCACAGGTGGGGCTAGGGCTAGAACGATAT	1	bc
AAATGGCACA	GAAACACCGGTTGTAGGGAATGCGTTGTGGGGGTAATGGTAGGTTTACCA	1	bc
AGCAGCAAAA	GAAACACCGGTGGTGTTAGAGCTAGAAATAGCAAGTTAACCTAAGGCTAG	1	bc
ACCGAAACGA	GAAACACCGGTGGGGTGAGAGATAGAAATAGAAAGAGAACCTAACGTAAG	1	bc
AATCCAGCCC	GAAACACCGGTTGTAGACATATGGGAGTGGGGTTAGAGCTAGAAATAGCA	1	bc
ACAGCACAAC	GAAACACCGGTGGGGTTAGAGCTAGAAATAGCAAGTTAACCTAAGGCTAG	1	bc
TAATTCTAAA	GAAACACCGGTTCTCATAGTTAGCTCGTGGGGTTAGAGCTAGAAATAGCA	1	bc
TCAACCTCCA	GAAACACCGGTGGTCGTAATCTCGTAGTGGGGTTAGAGATAGAAATCGCA	1	bc
CACCCACACA	GAAACACCGGTTCCCGTTAGCTCTGAGTGGGGTTAGAGCTAGAAATAGCA	1	bc
CTCAACCGCG	GAAACACCGGCTAGAAATAGCAAGTTAGCCGAAGGCGAGCCAGATATCAA	1	bc
CGCTTCTCCA	GAAACACCGGTCGCGACAGTCTAGCGATAGGGAGATAACCTAAAACAGGA	1	bc
AGTAGTGCCT	GAAACGCCGGTTCCGGGGAGCTCGGAGTGGGGGTAGTGGCAGGATTAGCT	1	bc
TCCCCGCAGC	GAAACACCGGCTAGAAATAGCAAGTTAACCTAAGGCTAGTCCGTTATCAA	1	bc
GACAACGACG	GAAACACCGGTACTAGCTACTTACGGGTGGGGTTAGAGCTAGAAATAGCA	1	bc
CGCACATCCC	GAAACACCGGTTCACGTTAGCTCGTAGTGGGGTTAGAGCTAGAAATAGCA	1	bc
CCGGCAAAAC	GAAACACCGGTTGGCTTTACTCCTTTGTGGGGATAGGGCTATAAAGAGCA	1	bc
GCAGGCCAGA	GAAACACCGGTGGGGCTAGAGCTAGGAAGGGGATGGTGATCGAAGGATAG	1	bc
TCGACAAACA	GAAACACCGGTCGTGTTAGATCTAGACATAGCTAGTTAACCTAAGGCAAC	1	bc
CCGATACAAC	GAAACACCGGTTGGCTTTACTCCTTTGTGGGGTTAGAGCTATAAATAGCA	1	bc
GACTCACACC	GAAACACCGGTAACATCACGATCCCCGTGGGGATAGAGCTAGAAACAGCA	1	bc
TATCCACAAT	GAAACACCGGTTTGCTTAGTTAACTAGTGGGGTTAGAGCTAGAAATAGCG	1	bc
AGCACTTAAT	GAAACACCGGTTCTCGTTAGCTGGTAGTGGGGTTAGAGCTAGAAATAGCA	1	bc
AATGCACAGA	GAAACACCGGTGACAAGTGGATCTGAGGGGGGATAGAGCTAGGAAAAGCA	1	bc
TGAATTAAAG	GAAACACCGGTGCTAATAGTTAGCTCGTGGGGTTAGAGCTAGAAATAGCA	1	bc
CAACGAGATT	GAAACACCGGTTCTAGCGGCTTCGAAGTGGGGTTAGAGCTAGAAATAGCA	1	bc
GCGTTAGCCC	GAAACACCGGTTGGCTTTACTCCTTTGTGGGGTTAGAGCTATAAATAGAA	1	bc
GACGGCCAGA	GAAACACCTGTTTTGTTAGAGCTAGAAATATCGAGTTAACCTAAGGCTAG	1	bc
GAGACAACCT	GAAACACCGGTTATCGGAAATAGCAAGTTAAGTTAAGGCTAGAAAGCTAT	1	bc
ATCAACCTCG	GAAACACCGGTCCTCTAAAGTTCCCCGTGGGGATAGAGCTAGAAATAGCA	1	bc
TTAGTATAAA	GAAACACCGGTGGGGTCTAAAAATGACATAGTAACCTAAGGCTAGGCCGG	1	bc
AATTACCAAC	GAAACACCGGTGGTCTTTCGATCTGCGTGGGGTTAGAGCTAGAAATAGCA	1	bc
TTAACCTACT	GAAACACCGGTGTTCTTAGTTAACGAGAGAGCTTGGAGATACAAGTAGAA	1	bc
CGTTAAGCAG	GAAACACCGGTGAGCACAGACTAGAAATGGCAATTTAACCTAAAGTTAGA	1	bc
TAATTAACGA	GAAACACCGGGTAGAGCTAGACATAGCAAGTTAACCTAAGGCTAGTCCGT	1	bc
TAATTACTAA	GAAACACCGGTGGCGATACTAACTGAGTGGGGTTAGAGTAAAAATATCAA	1	bc
ATGACCGTCG	GAAACACCGGTCCTAGAAGCTGGGGTTAGAGCTAGAAATAGCAAGTTAAC	1	bc
CTTACCCAAA	GAAACACTGGTGGGAATTCGATCTGAGTGGGGATAGTGATCGAAATCGCA	1	bc
GCAACCCAAA	GAAACACCGGTTAGATTAGGTAATAGCAAGGTAACTTAAGGATAGTCTGT	1	bc
TTACCAAACA	GAAACACCGGTGGGGTTAGAGCTAGAAATAGGAAGTTAACCTAAGGCTAG	1	bc
GAAACCGAAG	GAAACACCGGTTTACGTAGTTGGCGGGGGGGGTGAGAGAAAGAAAAAGTA	1	bc
TCAATAGACT	GAAACACCGGTGACGCGAGGGTTAGAGCTGGAAATTGCACTTTAACCTAA	1	bc
TGTCCAGATT	GAAGCACCGGTCTTCCTGGTGGGGTAGAGCTAGAAATAGCAAGTTAACCT	1	bc
ACCCGGCGCA	GAAACACCGGCTAGAAATAGCAAGTTAACCTAAGGCTAGTCAGTTATCAA	1	bc
CCCCTACTCC	GAAACACCGGCTAGGAATATCAAGTTATGCGAAAGCTAGTCCGTTAGCAA	1	bc
TCGTACATCA	GAAACACCGGTTTACTTAGTTAACTAGTGGGGTTAGAGCTAGAAATAGCA	1	bc
CCTTGGGCAC	GAAACACCGGTTGTGGGGAACTCGGTGTGGGAGAAATAGCAAGTTAACCT	1	bc
GAATTGCAAC	GAAACACCGGTGCTCTTTGCTCGCTCGTGGGGTTAGAGCTAGAAATAGCA	1	bc
GGGCAGAGAG	GAAACACCGGTGTTCGTTGCGCGTGGGGGGGGGTTAGAGCTAAAATTAGC	1	bc
CGTCCAGAAA	GAAACACCGGTCGCAATGCGATCTGAGTGGGATTCGATCTAGAAATCGCA	1	bc
GCGCCCCGCG	GAAACACCGGTTATCGGAAATAGCAAGTTAACCTAAGTCTAGTCCGTTAT	1	bc
CGTTCGTACC	GTAACACCGGTGAAACCAGCCTCGAAATAGGAAGTTAAGCTAGGGCTAGT	1	bc
CGGTGGGTTA	GAAACACCGGTTGTGGGGAACTCGGTGTGGGAGAAATAGCAAGTTAACCT	1	bc
GAATGCGGCC	GAAACACCGGCTTTAGGAAACGAGTGGGCTAGAGGCTGGAACAGTAACTT	1	bc
GACTCTGTCG	GAAACACCGGTTCTAGTAAATTGAGAGTGGGGTTAGAGCTAGAAATAGCA	1	bc
