GCAAAATACA	GAAACCCCGGTCGTCGTACGTAGGGGTGGGGTTAGAGCTAGAAATAGCAA	1	bc
TAACCACCAT	GAAACACCGGTTACCTACGTATGCCAGTGGGGTTAGAGCTAGAAATAGCA	1	bc
AAACCCGCAA	GAAACACCGGTTTAGGGTGACGCGGAGTGGGAGTAGTGCTAGGATTACCA	1	bc
TGCTTATCCT	GAAACACCGGTCTCCATAGAATGTCGGTGGGGAGATAGAAATAGCCAGCT	1	bc
ATATTGCAAC	GAAACACCGGTGCTAGTTGCTCGAAGGGGTTAGTACTGGTATTAGCAAGT	1	bc
AAAACGCTCA	GAAACACCGGTTGCGCGGGGGTTGGAGCTGGAGATAGAGCGATTTACCAT	1	bc
GACAAATACC	GAAACACCGGTAATCTAAAGATCCCCGGGGGGATAGAGATAGAAATAGCA	1	bc
TATTCACTCA	GAAACACTGGTGGCGATTCGATCTGAGTGTGGTTAGAGCTAGAAATAGAA	1	bc
TCAGCCATAC	GAAACACCGGTGGTGTAAGAGTCAGAATTGGCATGTAACTAGAAGGAGAG	1	bc
GAATTAAAGA	GAAACACCGGTGCTAATAGTTAGCTCGTGGGGTTAGAGCTAGAAATAGCA	1	bc
AAATGAGCCT	GAAACACCGGTTGTAGGGAACTCGGTGTGGGGGAAATAGCAAGTTAACCT	1	bc
ATAAACACAA	GAAACACCGGTTTAATTAGTTAACTAGTGGGGTTAGAGCTAGAAATAGCA	1	bc
AGTCCACCAC	GAAACACCGGTGTCCTTTGCACGTGGGTGGGGTTAGAGCTAGAAATAGCA	1	bc
TATTTAAACA	GAAACACCGGTGGAGATAATAAAAGAGTGGGGTTGAACTAAAAAAAAGAA	1	bc
ATGCACCTAC	GAAACACCGGTGTTCTTTGCTCGAGGGTGGGGTTAGAGTTAGAAATAGCA	1	bc
GTTACAGATA	GAAACACCGGTCTTCCTGGCATCTAGAAATAGCAAGTTAACCTAAGGCTA	1	bc
GAATTAAAAA	GAAACACCGGTTATCTTTGCGGATTTGTGGGGTTAGAGCTAGAAATAGCA	1	bc
ATGCCAACCT	GAAACACCGGTTGGCTTCACTGGTTTGTGGGGTTAGAGCTAGAAACAGCA	1	bc
ATAACCGTCG	GAAATACCGGTCGTGGAAGCTCTAGAAGTACTAGGAATAGCTAGTTCTAC	1	bc
TTCTTAACAA	GAAACACCGGTGCTAGTAGTTAAGTCGGGGTAGTGCAAGAAATAACAAGA	1	bc
CCATGCCCCC	GAAACACCGGCTAGAAATAGCATGTTACCCTAAGGCTAGACCGTTATCAA	1	bc
GGACATCAAA	GAAACACCGGTGCTCTTTGCTCGAGGGTGGGGTTAGAGCTAGAAATAGCA	1	bc
GTGAACCTCG	GAAACACCGGTAATATAAGGATCGCCAGGGGGAGAGATATAAAAATAACA	1	bc
CGATCAAAAA	GAAACACCGGTGGGGATAGAGCTAGAAGTGGTAAGATCAACTAAGGCTAG	1	bc
AATCCATGCC	GAAACACCGGTGACCAATGCATGTCTGTGGGGTTAAGGCCAGAAAAAGCC	1	bc
AGGCCAGCAG	GAAACACCGGTAACAAACGGATGTGATTGGGGTTGAAGTAGGAAGTAGCA	1	bc
TTATCCTACC	GAAACACCGGTGCTAGTAGCTGAGGGGGGAGATAGCTAGAAATATCAAGG	1	bc
AGGTCAGCAA	GAAACACCGGTTGTAAAAAAAAGGGGTTGGGTTTAAAGCTAGAAATAGAA	1	bc
AATCCACCAC	GAAACACCGGTTGTAAGCGATGGTTTGTGGGGTTATAGCTAGAAATAGCA	1	bc
AGAATCATCC	GAAACACCGGTTTTAGTGAATGGTGAGTGGGGTTAGAGCTAGAAATAGCA	1	bc
AAACACGTAA	GAAACACCGGTTTAGGATGCGTGGGTAGAGCTAGAAATAGCAAGATAACC	1	bc
AACTTGTCAG	GAAAAAGGGTTTTAGAACATAGCTCGTGGGGTTACAGCTTGAAAAAGCAA	1	bc
CCTCGTGGCC	GAAACACCGGTAGACTTTATCCACGGGTGGGGTTAGAGCTAGAAATAGCA	1	bc
ATATCAGCGA	GAAACACCGGTGTGCGGAGATTCTGCGTGAGAAATAGCAAGTAACCTAAG	1	bc
AACTTGCAAC	GAAACACCGGTTCTACTGGATACTTCTTTGGGGTAAAACTTAAAATAGCA	1	bc
GCCTATGCAC	GAAACACCGGTACTCGTTACTTATTGGTGGGGTTAGAGCTAGAAATAGCA	1	bc
CACAAATACA	GAAACACCGGTGGCTAGACATTTTAAGTGAACTTAAGGCTAGACCTATAT	1	bc
CGACGCCAAC	GAAACACCGGTTAGAAATAAAAGTTTTAGGGAAAGCGAGAGAAATAGCAA	1	bc
TGTCCATATT	GAAACACCGGTCTTCCTGGAATCTCCGTGGGGTAGAGCTAGAAATTGCAA	1	bc
AAACCAAGGG	GAAACACCGGTTTTGTATGCAGGTTTGAGGGGGTAGAAGTAGAAAAAGCA	1	bc
TCCTCCAAAT	GAAACACCGGTGGGGTTAGAGTAAGAGAGAGCATGTTAATCGAAGGCTAG	1	bc
AGATCATACT	GAAACACCGGTTGGAAGCGATCGTTTTGGGGGTTAGAGTTAGAAATGGCA	1	bc
CGCTTACCAA	GAAACACCGGTGAGAACAGAACGTTTGGGGGTTAGAGCTAGAAATTGCAA	1	bc
GCCATGTATC	GAAACACCGGTCGACGTGCGTAGGGTTGGGGTCAGAGCTCGAAATAGCAA	1	bc
CAATGACATA	GAAACACCTGTGGCAATTCGATCTGAGTGGGGTTAGAGCTAGAAATAGCA	1	bc
AAACCCCAGT	GAAACACCGGTTTACTTAGTTAACTAGTTGGGTTAGAGCTAGAAATATCA	1	bc
GCGTGCGCGA	GAAACACCGGTGGGGTTAGAGCTAGAAATAGCAAGTTAACCTAATGCTAG	1	bc
ATATCACCGT	GAAACACCGGTGGGCAGCGATTGTGTGTGGGGTTAGAGCTAGAAATAGCA	1	bc
CCCGCGAAAA	GAAACACCGGTGGAGCCAGCGCCAGATGTGGCGATTGAACTAAAGACAAC	1	bc
GCCATACACA	GAAACACCGGTTCGCCCGAGGTCTTTTTTGGGGGTAGAGCTAGAGCTAGC	1	bc
GAATACATAA	GAAACACCGGTATTAGTTGTTGAGGTGTGGGGATAGATCGAGAAATAGCA	1	bc
CTCTCACACA	GAAACACCGGTGCGCCGGGAGTATTCTGGGGGGTTAGAGCTAGAAATAGC	1	bc
ATATAACAAT	GAAACACCGGTTGTAAGAGCTGGTTTGTGGGGTTAGAGCTAGAAATAGCA	1	bc
ACCCGCCACA	GAAACACCGGTTGAGTTAGAGCTAGAATTAGCAAAGTAACCGAAGGCTAA	1	bc
CCCGCCAGAA	GAAACACCGGTAGAGTTAGACCTCGGGATGGCATAGTGACATAAGTCTCA	1	bc
TCCGCACACA	GAAACACCGGTGGGGTTAGAGCTAGAAATAGCATGTTAACCTAAGGCTCG	1	bc
AATCCAGATT	GAAACACCGGTCTTAATCGAATCTACGTGGGGTTAAAGCTAGAAATACAA	1	bc
AAACCCGCTG	GAAACACCGGTTTAGGATATGGGGGAAGAGGTATAGATCTAAAGATAACC	1	bc
GAATCATCAA	GAAACACCGGTTTTAGTGAATGGTGAGTGGGGTTGAGGCAGGAAATGTAA	1	bc
AAAAGAATGA	GAAACACCGGTTGAGGGGGAGGGGGTAGAGGTGGAATTACAAGTTAAACC	1	bc
GAAAAATATC	GAAACACCGGTAGTCGTTCGTAGGGGTGGGGTTAGAGCTAGAAATAGCAA	1	bc
CAACGAGATT	GAAACACCGGTGATCATGAGGATAGAGGTGGAAATAGAAAGATAAATAAC	1	bc
GTGTCCGCCG	GAAACACCGGTCTTAGAAGCTGATTTGGAGCTTTAGATCTAAAGATAGCC	1	bc
TCAACATACA	GAAACCCCGGTCGTCGTACGTATGGGTGGGGTTAGATCTAGAAATAGCAG	1	bc
TGAACACTAT	GAAACACCGGTGAGGAGAGGGTTAGAGCTGGAAATAGCAAGTTATACTAA	1	bc
GAAACAGTAA	GAAACACCGGTACTAGTTACTTACGGGTGGGGTTAGAGCTAGAAATAGCA	1	bc
TATCCAGATT	GAAACACCGGTCTTCATGGAATCTAAGTGGGGTAGAGGTAGAAAGAGGAA	1	bc
GGATCAAAAA	GAAACACCGGTGAGAATAGAAAGCTTGGGGGGTAAGGGTAGAAAAAGAAA	1	bc
CCATCACACA	GAAACACCGGTGACAAGAGGGTGTGAGCGGGAAATAGCAAGGAAAACTAA	1	bc
CGGGGGACAC	GAAACACCGGTGTGCTTTGCTCCTTTGTGGGGTTAGAGCTAGAAATAGCA	1	bc
GTGTGCCATA	GAAACACCGGTGGGGTTAGAGCTTGAATGAGCAAGTTAACCTAAGGCTAG	1	bc
GACATCTATA	GAAACACCGGTTAGTCTGAGAACGTCGTGGGGAAAGAACGCGCAGGAGCA	1	bc
GCGTCAAACC	GAAACACCGGTTATCGTTAAGGATTTTGTGGGGTTAGAGCTAGAAATAGC	1	bc
GAACTATGTG	GAAACACCGGTCGTCGTTCGTGGGGGGGGGGTTAGAGCTAGAAATAGCCA	1	bc
AACTTACTGC	GAAACACCGGTTGACGTAGATAGTAAGTGAGCCTAAGGCTAGACCGTAAT	1	bc
ATGGGGCAGA	GAAACACCGGTGTGCTTAGCGCTAGAATGGGGAAGGAAATCGAAATATCA	1	bc
AGACAATACT	GAAACACCGGTTGTAAGCGGTGGTTTGTGGGGTTAGAGCTAGAAATAGCA	1	bc
TCGACACAAG	GAAACACCGGTTGCCTTTAGTTCTGAGTGGGGTTAGAGCTATAAATAGCA	1	bc
AAATCATCCC	GAAACACCGGTGACAAACGTATGTCAGTGGGGTTAGAGCTAGAAATAGCA	1	bc
TAATTGGTCA	GAAACACCGGTTGAGGTAAATAGCAAGTGGGAGTAAGACTAACCCGATAT	1	bc
ATGCGCCAGT	GAAACACCGGTTAGATGCGTTAAGTTGTGGAAATAGCACTAGAAATAACA	1	bc
AGTAATAAAT	GAAACACCGGTCGTCGTTAGTAGGGGTGGGGTTAGAGCTAGAAATAGCAA	1	bc
TACTACGTCA	GAAACACCGGTACTGGATACTTGCGGGTGGGGTTAGAGCTAGAAATAGCA	1	bc
GAATCCCCAT	GAAACACCGGTTTAATTAGTTAACTGGTGGGGTTAGAGCTAGAAATAGCA	1	bc
GCCCACCTAC	GAAACACCGGCACTAGATAGCAACGGGACCTAATACAACTCCAAAATCAA	1	bc
CACAATCAAA	GAAACACCGGTACTCTTAGCTTACTAGTGGGGTTAGAGCTAGAAATAGCA	1	bc
AACAAACTAC	GAAACACCGGTAATCTAAGGATGCCCGTGGGGATAGAGCTAGAAATAGAA	1	bc
CAACGCGGCC	GAAACACCGGTTGAGTATGTGGGGTTGGGGGTAGAAATAGAAAGATAACA	1	bc
TACAACGACC	GAAACACCGGTAATCTAGAGATCGCCGGGGGGAGAGAGCTATAGATAGCT	1	bc
GAATTAAAAA	GAAACACCGGTGCTAATAGTTAGCTCGTGGGGTTAGAGCTGGAAATAGCA	1	bc
ACAAAAAGAT	GAAACACCGGTGGTCGTTGCGGGGTTGGGGGTAGAGATAGCAAGCTAACA	1	bc
AACATACTGG	GAAACACCGGTTTTCGATCATAGGGCGTGGGGTTAGAGCTATAAATAGCA	1	bc
ATCTAAACTC	GAAACACCGGTGTGCGTTGCTTATGCGTGAGAAATAGCAAGTAACATAAG	1	bc
TAAACATAAA	GAAACACCGGTTTACTTAGTTAACTAGTGGGGTTAAAGCTCGAAATAGCA	1	bc
CACCCTGGAC	GAAACACCGGTACTAGTTACTTACGTGTGGGGTTAGAGCTAGAAATAGCA	1	bc
TAATCAAGCT	GAAACACCGGTTATCGTTGCGGATTAGATCTAGAAATAGCAAGTTAACCT	1	bc
ATTACGTACG	GAAACACCGGTCCTAGAAGCTGAGTGTGGTTAGAGCTAGAAATAGCAAGT	1	bc
CCTTGGCCAC	GAAACACCGGTTCAACCGGACTCTTTTGGGGGGAAATAGCAAGTTAAACT	1	bc
AGGAAGGAAA	GAAACACCGGTGATCTTTGCTAGAGGGTGGGGATAGAGCTAGAAATAGCA	1	bc
TCCTGCAACC	GAAACACCGGTGGGGTTAATGCACGGGTGGGGTTAGAGCTAGAAATAGCA	1	bc
GAGCCATGAG	GAAACACCGGTTACAAACGTGTGTTTTGGGGGTTTAGACTTGAAATAGGC	1	bc
GACATATATC	GAAACACCGGTCGTCGTTCGTAGGGGTGGGGTTAGAGCTAGAAATAGCAA	1	bc
GAAACACTCG	GGAACACCGGTTACCGGTAGGGGTTTTGGGGGTTTAGGGCTGAAAAAGCC	1	bc
AAACTCACTA	GAAACACCGGTGAGCATGGTAACGTATCAAGTTAACCTAAGGATTGTCAG	1	bc
TCATTCCTAC	GAAACACCGGTTGCGATAGATAGCAAGTTAACTTAAGGCTAGTCCGTTAT	1	bc
ACCCGACACC	GAAACACCGGTTAGAAATAGCAAGTTAAGCTAAGGCTAGTCAGATATCAA	1	bc
GGAAAATACA	GAAACACCGGTCGCCGCCCGCAGGGGGGGGGTTAGAGCTAGAAATAGCAA	1	bc
CCTTGGGCCA	GAAACACCGGTTGTGGGGAATTCAGTGTTGTAGACATAGCAAGTTAACCT	1	bc
AAACACCTCC	GAAACACCGGTAATCTAAAGGGCCCTGGGGGGAGATAGAGAGATATAACA	1	bc
GAAAACTATA	GAAACACCGGTAATCTAAAGATCCTCGTGGGGGTAGAGCTTGAAAAAGCA	1	bc
CCATATCACC	GAAACACCGGTGCACCCGGCGTCTTTGGGGGGGTTAGAGCAAAAAATAGC	1	bc
GAATCCATTA	GAAACACCGGTTTTATGACTGATAGCTATCTAATCGAAAGCCAGATATTA	1	bc
AAGCCGCACC	GAAACACCGGTGATCGTTACGGGTGTTGGGGGTATAGATCTCAAAATAAC	1	bc
ATTCATCCCC	GAAACACCGGTCCTATAAGCTGAGTGGGGGTAGAGCTATAAATAGCAAGA	1	bc
GGGTCCTCAG	CTAAACACCGGTGATAGCTACAGGTTTTGTGGTGATAGCGCTAGATATCA	1	bc
AATGGTGCGG	GAAACACCGGTGCGCTTAGAGGGACCGAGGGGATGGAGCTAGAAATAGAA	1	bc
GTCATTTACA	GAAACACCGGTGAGCATGATAACGTCGTGTGGTTAGAGCTAGAAATAGCA	1	bc
GAGTGAGTCG	GAAACACCGGTCTTAGTAAATGGGGAGTGGGGTTAGAGCTAGAAATAGCA	1	bc
GATTAGTTCC	GAAACACCTGTAATGGAAAGATCTTAGTGTGGGTAGTGTCAGATTAACAT	1	bc
CAATGAGCTT	GAAACACCGGTTTTAGCGAATGGGGAGTGGGGTTAGAGCTAGAAATATCA	1	bc
ATGACCGTCG	GAAACACCGGTGGGGTTAGAGCTAGAAATGGCAAGTTAACCTAAGGCTAG	1	bc
TGTCCAGCTT	GAAACACCGGTCTTCCTGGAATCTACGGGGAGAGGAGCTAGTAATAGGAA	1	bc
ATCAAAAAAA	GAAACACCGGTGGTGTTAGAGCTAGAGATAGCAAGATAAACTAAGGCTAG	1	bc
AACTCGCAAC	GAAACACCGGTTCAACCGGAGCGTTTTGGGGGGATAGCTATAGATAGCAA	1	bc
ACAACAATAA	GAAACACCGGTGGTGTTAGAGCTAGAAATAGCAAGATAACCTAAGGCTAG	1	bc
TTATTATCCA	GAAACACCGGTCCTAGAAGCTGGGTGGGGTTAGAGCTAGAAATAGCAAGT	1	bc
CTACCCCCCC	GGAACACCGGCTATAAATAACAGGTTAACCTAAGGCAAGTCCGTTATCAA	1	bc
GACAACGACA	GAAACACCGGTAATCTAAAGATCCCCGTGGGGATAGTACCAGAAGGCGCA	1	bc
