TTATAAATCA	GAAACACCGGTTGAGGTAGTTAAAAAGTGGGAAATAGCAAGTAACCGAAG	1	bc
AAACAACTAC	GAAACACCGGTGTTAGGGGATAGGGCTAGAGATTAGAGGTTAACCTAGGA	1	bc
GTAATGCACA	GAAACCTAGAAATAGCAAGTTAATCTAAGGGTAGTACGCTATAAACTTGA	1	bc
CACTCCCTCA	GAAACACCGGTGGTATTACTATCCGAGTGGGGATAGAGCTAGAAGTATCA	1	bc
AACTACCCGC	GAAACACCGGTGAGCGGAGATTATGCTTGAGAAATAGCAAGTAACCTAAG	1	bc
TCACGCCACC	GAAACACCGGTGAGGTTAAGGAAATTAACAGCAGGCTAATCCAAAATCAA	1	bc
CTTAAAGCCG	GAAACACAGGTGAGCACTGAACGTTTTTGGGGTAGAGCTAGAAATAACAA	1	bc
TAAATGCAAG	GAAACACCGGTTTTCGTAGATAGGTCGTGGGGTTATATCTAGAAATAGCA	1	bc
AGATCATTAA	GAAACACCGGTTAGAACAGAAGGGTTTGGGGGTAGAGCTAGAAATAGCAA	1	bc
GAATGCGCAG	GAAACACCGGTGGGGTTAGAGCTAGCAATAGCAAGTTAACCTAAGGCTAT	1	bc
GGCAAGTTCC	GAAACACCGGTAATCTACAGATCCACGTGGGGATAGAGCTAGAAATAGCA	1	bc
GACTAAAGAT	GAAACACCGGTGGTCGCCTTGGGGTTAGAGCTAGAAATAGCAAATTAACA	1	bc
CGCACCTCCG	GAAACACCGGTGGCAACCAACCACTTGTGGGGTAAGAGTTAGAAATACCA	1	bc
GAATTGGGGA	GAAACACCGGTTGGGGGGAACTCGGTGTGGGAGAAATAGCAAGTTAACCT	1	bc
GGATCATCAG	GAAACACCGGTTTTCGTAGATGGTGAGTGGGGTTAGAGCTAGAAATAGCA	1	bc
CTATCACATA	GAAACACCGGTGAGCATGCTAACGTCCGTTGGGTTAGAGCTAGAAATAGC	1	bc
GGAAAACATC	GAAACACCGGTGTTCTTGGTTCGAGGGTGGGGTTAGAGCTAGAAATAGCA	1	bc
GGCAAGCACC	GAAACACCGGTGTCATTCATCCACTGGTGGGGTTAGAGCTAGAAATAGCA	1	bc
GTAACGCAAC	GAAACACCGGTGTTCTTAGTTAGAGGGGGGGGTTAGAGCTAGAAATAGCA	1	bc
GACTAATAAA	GAAACACCGATACGCATGATAACGGCCAGCTATACGTGGCAGGTAAAGCT	1	bc
GCCTCATCCG	GCAACACCGGTTTTAGTATATGGTGAGTGGGTTTATATCTAGCAATAGCC	1	bc
ATGACCTCCT	GAAACACCGGTTCTAGATGCTGGGGTGAGAGCTAGAAATAGCAAGTTACC	1	bc
CCGCCGCTCG	GAAACACCGGTGACGCGAGGGTTAGAGGTAGAAGTAGGAAGTTACCCTAT	1	bc
AAACGGGAAA	GAAACACCGGTTGTGGTGGCTTCGGGGTGGGGTTAGAGCTAGAATAAGCA	1	bc
CGACCACAAC	GAAACACCGGTGTCCATTCGTTGTGAGTGGGGTTAGAGCTAGAAATAGCA	1	bc
TAATTCCACC	GAAACACCGGTTTACTTAATTAACAAGTGGGGTTAAGGCTGGAACGATCA	1	bc
TGCTAACCGT	GAAACACCGGTGCGCGGAGATTATGCGTGAGAAATAGCAAGTAAACTAAA	1	bc
ATAATTAAAA	GAAACACCGGTGCTAATAGTTAGCTCGTGGGGTTATAGCTAGAAATAGCA	1	bc
CACACCCACC	GAAACACCGGTTGTAAGCGATGGTTTGTGGGGTTAGAGCTAGAAATAGCA	1	bc
ATCAAACACT	GAAACACCGGTTGTTAGAGATGGTTTGTGGAGCTAGAGCTGGAAATAGAT	1	bc
GGCTAATCAA	GAAACACCGGTGACAACAGACCATTTGGGGGGTAAGAGTTAAAAAAACCA	1	bc
CCCGCACAAC	GAAACACCGGTTCAGCCAGCGCTTTTTTGAGCAAGTAGAGCTAGAGATAG	1	bc
GAGGGAGAAA	GAAACACCGGTGATATGCCTCGAAATGGGGGGTTAACCTAAGGATAATCT	1	bc
GCGCGCCAGC	GAAACACCGGTGAGATGCCTCCAAATAGCAGGTTAACCTAAGGATAGGCC	1	bc
TCAACCCTCT	GAAACACCTGTTTCCTTAGTTAACTAGCGGGGTTAGAGCTAGAAATAGAA	1	bc
AAAAGAGATA	GAAACACCCGTGCTAGCGGTTTCGAAGTTGGGGTAGAGCTAGAAATAGCA	1	bc
CCGTGAAAAA	GAAACACCGGTTGGATTTACTCCTTTGTGTGGTTAGAGCTATAAATAGCA	1	bc
TCCTTCGCAC	GAAACACCGGTTCAACCGGCGTCTTTTTGTGGGGTTAGAGCTAGAAATAG	1	bc
TTCTTATCAA	GAAACACCGGTCGCGAAAGTGTGCTGGTGGGGTTAGAGCTAGAAATAGCA	1	bc
GGATCATCCT	GAAACACCGGTTTTAGTAAATGGTGAGTGGGGTTAGAGCTAGAAATAGCA	1	bc
TGGGGCTCCT	GAAACACCGGTTACCGTTAGCTCATAGTGGGGTTAGAGCTAGAAATAGCA	1	bc
GTAGGAGAGT	GAAACACCGGTGATATGCGTTGAAATGGGGGGTTAGCGCTAGACATGGCA	1	bc
ACGCGCCGAA	GAAACACCGGTCGTCTGGATCCACGGGTGGGATTAAAGCTAGGCATAGCA	1	bc
CCAAGTCCCT	GAAACACCGGTAGATTGGATCTAAGGGTGGGGTTAGAGCTAGAAATAGCA	1	bc
TCATCACACA	GAAACACCGGCGGGGATAAAGATAGAAATAGAAAGTTAGCCTGAGATTAG	1	bc
CCTAAAAACA	GAAACACCGGTGGCCGTTTTAGCTGAATGGGTATAAATATAGAAATAGCA	1	bc
TAATCCCCCC	GAAACACCGGTTTTCGTAATTGGCGAGTGGGGTTAGAGCTAGAAATAGCA	1	bc
TCAATAGTCC	GAAACACCGGTTGAGATAATCAAAAAGTGGGGTAGAGCTAGAAATAGCAA	1	bc
AAATTAACAC	GAAACACCGGTGCTAATCGTTAGCCAGTGGGGTTAGAGCTAGAAATAGCA	1	bc
GATCTCAACG	GAAACACCGGTGTGCGTAGCTTATGCGTGGGGATAGAGAAATAAACAGAG	1	bc
AACTGTTCCA	GAAACACCGGTTGCGGGTAACTCGTTGTGGGAGAAATAGCAAGTTAACCT	1	bc
AACCAACGAC	GAAACACCGGTAGTGGTGGGGTTAGAGCTAGAAAGAGCAAGTAAAGCTAG	1	bc
GTTAGTTCTA	GAAACCCCGATATAGCATGTCACCCTGTGGCTAGTCCGTTAACATATTGT	1	bc
GAACAAGCAG	GAAACACCGGTTTTCGTTGCTGGAGAGTGGGGTTAGAGCTAGAAATAGCA	1	bc
TCCGCAACAC	GAAACACCGGTGGGGTTAGAGCTCGAAATAGCAAGTTAACCTAAGGCTAG	1	bc
CATACGCACC	GAAACACCGGTTCAATCGGCGTGGGGTTAGAGCTAGAAATAGCAAGATAA	1	bc
AATACATCGA	GAAACACCGGTGACAAACGTATGTCAGTTGGGTTAGAGCTAGAAATAGCA	1	bc
GACCCCTACG	GAAACACCGGTTTCAGCCAGCCACTTGTGGGGTTAGAGCTAGAAATAGCA	1	bc
TCAGGCGAGA	GAAACACCGGTGGGGTTAGAGCTAGAAATAGCAAGTTAACCTAAGGCTAG	1	bc
ACAACGCGAT	GAAACACCGGTGCTAGCGGTATCGAAGTGGGGTTAGAGCTAGAAATAGCA	1	bc
GTTTGCGCAA	GAAACACCGGTGAGATGCCTCGAAATAGCACATTAACCTAAGGTTAGTCC	1	bc
GAAAGATCTA	GAAACCTAGAAAGAGCAGGTTTACCTGTGGCTGGTACGTTATCATCTTGT	1	bc
CGGTGTGTAA	GGAACACCGGTTGCTGGTTGCTGTGGGGTGAGAGTTGGAATTAGCATGGC	1	bc
TAACCATAAT	GAAACACCGGTGACTAACGTATGTCAGTGGGGTTAGAGCTAGAAGTAGCA	1	bc
TGCTAATACG	GAAACACCGGTGAAAACCAGCCACTTGGGGGGTAAGAGCAAGAATAGGCA	1	bc
ATTCCATAAA	GAAACACCGGTGACAAACGTATGTAAGGTTGGGTTAGAGCTAGAAATAGC	1	bc
TCAACCCTCC	GAAACACCGGTAATCTAAGGACTACCGATAGCATAGTAATCTAAATATAA	1	bc
CAATCACCCC	GAAACACCGGTTTAAGCAAATTGTTATGGGGGGTTAGGTTTGAAAATAGA	1	bc
GAAAACTATC	GAAACACCGGTGAGCTTGATAACACCGCGGGGGTATAGCGCGAAATATAG	1	bc
ATTTGGTATA	GAAACACCGGTGGGCGGGAACTCGGCGTGGGATAGATAGAAAGTTAACCG	1	bc
GCAAAAGATA	GAAACACCGGTGGGCTTTATGACAGCGAGGGGTTAGAGCTAGAAATAGCA	1	bc
AACACATTAC	GAAACACCGGTGATAAACGGATGTCAGTGGGGTTAGAGCTAGAAATAGCA	1	bc
TCACCAAACT	GAAACACCGGTGGTGTTAGAGCGAGAGATAGCAAGTTACCCTAAGGCTAG	1	bc
TAACATTCTA	GAAACACCGGTTTTCGATCATAGGTCGTGGGGTTAGAGCTAGAAATTGCA	1	bc
GGGTGAGAGA	GAAACACCGGTGAGAGGCATCGAAATAGCAAGTTAAACTAAGGCAAAGCC	1	bc
TGATTATCAA	GAAACACCGGTGAGAACAGTACGAATTGGGGTTAGAGCTAGAAATAGCAA	1	bc
CCAGGGAACA	GAAACACCGGTCGGGGTAGAGCTAGCGATGGCACGTTGACCTAAGGCTCG	1	bc
GCATCAACAG	GAAACACCGGTTTTATTAAATGGTGAGTTGGGTTAGAGCTAGAAATCTCA	1	bc
ACTTGGGCCC	GGAACACCGGTTGTTGGGGACTCGGTGTGGGAGTAATAGCAAGTTAACCT	1	bc
GAAAGCCAGT	GAAACACCGGTGTACTTAGTTAACTAGGGGGGTTAGAGCTAGGAATAGCA	1	bc
CAACCGTCAC	GAAACACCGGTGTTCTTTGCACAAGAGTGGGGTTAGAGCTAGAACTAGCA	1	bc
CCTGCATATA	GAAACACCGGTCCAGCCAGTGAACCTAATGGTAGTCTATTATCAACTTGA	1	bc
GCCTATCTCA	GAAACACCGGTACTAGTTACTTACGGGTGGGGATAGAGCTAGAAATAGCA	1	bc
CAGAGCCGCC	GAAACACCGGTAGAATGGATACAAGGTTGGGGTAAGACCAAGAAATAGAA	1	bc
ACGGCGGGGT	GAAACACCGGTCGACGATCGTAGTTGGGTTAGAGCTAGAAATAGCAAGTT	1	bc
TCCAGCTCCT	GAAACACCGGTTCGCGATAGCTCGTAGTGGGGATAGTAGTAGGAATACCA	1	bc
CAACCAGAAC	GACACACCGGTGTTCTCTGATTAGTAGTGGGGTTAGAGATAGAAATTGCA	1	bc
GTAATCGACA	GAAACACAGGTCCTAGTAGGTAGGGTTAGAGCTAGAAATAGCAAGTTAAC	1	bc
GCATCACCCC	GAAACACCGGTTTTAGCAGATGGTGAGTGGGGTTTGAGCTAGAAATAACA	1	bc
CACTCAAACG	GAAACACCGGTTATCGTTACGGATTTGTGGGGTTAGAGCTAGAAATAGCA	1	bc
AATTCAACAA	GAAACACCGGTGGGGGTGGAGCTAGAGGTAGCAAGTTAACTTAGTAATAT	1	bc
CGGCCGGCCT	GAAACACCGGTCGCCGTTAGCTCGGAGTGGGGCTAGAGCTAGCAAGAGAA	1	bc
GTCAAATATG	GAAACACCGGTGGGCATGATTAGCAAGGTGGGGTAAGGGCGAGACATAAT	1	bc
AAAATTACAA	GAAACACCGGTGTTCTTTGCTCGTGGGTGGGGTTAGAGCTAGAAATAGCA	1	bc
CAATTGCTCC	GAAACACCGGTTCAAAAAATGTCTATTTGTGGTGTAAGCAGTAAAATAAG	1	bc
TAGGTAACCT	GAAACACCGGTTGGCTTTACTCCTTTGTGGGGTTAGAGCTATAAATAGCA	1	bc
GTGTGAGCGA	GAAACACCGGTTGTATTAATTAGTTTGTGGGGTTAGAGCTAGAAATAGCA	1	bc
GAACGCCGCT	GAAACACCGGTTGAATGGATTCACGGGTGGGGTTAGAGCTAGAAATAGCA	1	bc
CTCTTCACAC	GAAACACCGGTCGCGTAAATGTCCCGGTGGGGTTAGAGCTATAAATAGCA	1	bc
TTCTTACCAC	GAAACACCGGTGTGGATAGTGTGTGGGTTGGGTTAGAGATAGAAATAGCA	1	bc
TGATTAGTTT	GAAACACCGGTTTTCATGGTCAATACGTGGGGTAGAGCTAGAAATAGCAA	1	bc
CCGTCCCGCG	GAAACACCGGCTAGCGATACGAATTTAACGTATGGCTAGTACGTTATCAA	1	bc
AAGTTAACCC	GAAACACCGGTTGGCTTTACCCCTTTGTGGGGTTAGAGCTATAAATAGCA	1	bc
TTATTACTCT	GAAACACCGGTTGTAAGCGATGGTTTGTGGGGTTAGGGCTGGAAATAGCA	1	bc
TAAACACCGA	GAAACACCGGTTTGCGGAGATAATTAGCGGGGATAGAGCTAGAAATTACA	1	bc
GAATCCATAA	GAAACACCGGTGCTGATAGTTAGCTCGTGGGGTTAGAGCTAGAAATAGCA	1	bc
GTAACCTCCA	GAAACACCGGTGAGCCTAGGACGGTACGGGGAGATAGAGCTAGATATCGC	1	bc
GGGTAGGACG	GAAACACCGGTGGTCGGTAATGGTGGGGTAAGATATGGAAATAACGAGAT	1	bc
TACACACTAA	GAAACACCGGTTTTCGATCATAGGTCGTGGGGTTAGAGCTAGAAATAGCA	1	bc
AAATCACCGT	GAAACACCGGTGTGCGGAGATTATGAGTGAGAAATAGAAAGTAACCTAAG	1	bc
ACCAAACGAT	GAAACACCGGTGTTCTACGTACGTGGAGAGGTATAAAAAGGAGAATAAGC	1	bc
GCACCCATCC	GAAACACCGGTAGAGAATATGCGCAGGTGGGGTTAGAGCTAGAAATAGCA	1	bc
AAGCCAACTA	GAAACACCGGTTTAGTAAAGAGGGGTTAGAGTTAGAGATAGAAATATAAC	1	bc
AAATTCCTCC	GAAACAACGGGTGAGATAATCAAAAAGGGGGGTAGAGCTAGAAATAGCAA	1	bc
GCCTTAAAAC	GAAACACCGGTTCAACCGGCTTGTTTGTGGGGGGAGAGAGCTAGATATAG	1	bc
ACGACAGAAA	GAAACACCGGTCCTAGTTGCTGAGTTGGGGGTATAAATAGCGAAATAACC	1	bc
AAACCAGATG	GAAACACCGGTGTTGTTGGTAGGTAAGAGGGAATGATAGCAAAATAACCT	1	bc
CTTCGCCACT	GAAACACCGGTAGAATGGATCCACGGGTGGGGTTAGAGCTAGAACAAGCA	1	bc
ACGCTCACAA	GAAACACCGGTTGACTTTGCACGTTTGTGGGGTTAGAGCTATAAATAGCA	1	bc
TAATTACCGC	GAAACACCGGTTGAGATAATCAAAAAGTGGGGTAGAGCTAGAAATAGCAA	1	bc
TCCACGCAAC	GAAACACCGGTTCAATTGGTGTCTTTTTGGGGGGTTAGAGCTAGAAATAG	1	bc
TCACGGGATA	GAAACACCTGTGGGGTTAGAGCTAGAAATATCAAGTTAACCTAAGTCAAG	1	bc
ATCTTGCCCC	GAAACACCGGTGGCGAAAATGTGCCGGTGGGGTTAGAGCTAGAAATAGCA	1	bc
CCAACACACA	GAAACCTAGAAATAGCAAGTTAACCTAAGGCTAGTCCGTTATCAACTTGA	1	bc
GGGTGATAAA	GAAACACCGGTGAGAGGACTAAGCGGGGGGGTTAGAGCTAGAAAAAGCAA	1	bc
ATACCGCAGC	GAAACGCCGGTGTTCTTTGCTCGCGGTTGGGGTTAGAGATAGAAATAGCA	1	bc
