AATTGGACCC	GAAACACCGGTTGAGGTGATCTAGGTGTGGGGGAGATCGCAAGTTAACAT	1	bc
ATCAAACACT	GAAACACCGGTTGTAAGCGATGGTTTGTGGGGTTAGAGCTAGAAATAGCA	1	bc
GATTCCCTCC	GAAACACCGGTGATCTATAGATCTCCGTGGGGTTAGAGCTAGAAATAGCA	1	bc
AAACCTTTCT	GAAACACCGGTTTAGGATGGGGGGTTAGAGCGATAAATATCAAATTAACC	1	bc
GGATCTTCCT	GAAACACCGGTTCCCGTTAGCTCGGGTTAGAGCTAGAAATAGAAAGTTAA	1	bc
CAGCTCATGA	GAAACACCGGTTGGCTTTACTCCTTTGTGGGGTTAGAGCTATAAATAGCA	1	bc
ATATGAGATA	GGAACACCGGTGTGATGAGATTATGCATGAGAAATAGCAAGTAAACTAAG	1	bc
ACGATACCAC	GAAACACCGGTTGGCTTTACTCCTTTGTGGGGTTAGAGCTATAAATAGCA	1	bc
GTACAACACC	GAAACACCGGTCGTCTACAGTGGCTTGGGGGGTTAGAGCTATAAATAGCA	1	bc
AATTCAATGA	GAAACACCGGTTTAGTATGTGGGGTTAGAGCTTGAAATCGCAAGATAACA	1	bc
GAGGGCGTCC	GAAACACCGGTGGGGTTAGAGCTAGAAATGGCAAGTTAACCTAAGGCTAG	1	bc
AAACCGCTAC	GAAACACCGGTTTTGTATGCTGGGGTAGAGGTAGAGATAGCAAAATAGCC	1	bc
TGCTTAAAAA	GAAACACCGGTTCCCGTTAGCTCGTAGTGGGGTTAGAGCTAGAAATAGCA	1	bc
AAAAACATGC	GAAACACCGGTTTAGTATGGGTGGTTAGGGGTATAAATAGAGAAATAACA	1	bc
GTCACCGTCG	GAAACACCGGTACTAGAAGCTGACCTGTGGGGTTAGAGCTAGAAATAGCA	1	bc
AATCCCGTCG	GAAACACCGGTGTAGTATGTGGGGTTAGAGGTATAAATATCAAGTTAGCC	1	bc
TAAACCCCCG	GAAACACCGGTTTAAGTAGTTAACTAGTGGGGTTAGGGCTAGAAATATCA	1	bc
CCTACTCCCG	GCAACACCGGTGCCCTTTATGGGACCGTGGGGTTAGAGCTAGAAATAGCA	1	bc
ATAACCCTCT	GAAACACCGGTCCTAAACGCTGGGTTTGGGGGGTAAAGGCTAAAATTACC	1	bc
GAGTCAAGCG	GAAACACCGGTTATCGTTACGGATTTTGTGGGGTTAGAGCTAGAAATAGC	1	bc
GAGAGGGTGA	GAAACACCGGTGGGGTTAGAGCTAGAAATAGCATGGTAACATAAGTCTAG	1	bc
AATCCCGCCG	GAAACACCGGTGTTCTTTGTAGGGAAGTGTGGTTAGAGCTAGAAATAGCA	1	bc
GGAATCTACG	GAAACACCGGTGCCTAGAAATAGCAAGTGAGCCTGAGGCTAGACCGATAT	1	bc
AGCCCTTTCT	GAAACACCGGTTTCCGTTAGCTGGGGGTAGAGCTAGAAATAGCAAGAGCA	1	bc
ACACAACAGA	GAAACACCGGTTTTAAGTGATGGGCTGTGGGGTTAGAGCTAGAAATAGCA	1	bc
TTCACCCACT	GAAACACCGGTCTTAGAAGTTGAATCTAGAAGTGGGGTTAGAGCAAGAAA	1	bc
GAGGGAGAAA	GAAACACCGGTGGGGTTAGAGCTAGAAATAGCAAGTTAACCTAAGGCTAG	1	bc
AGAGACTACC	GAAACACCGGTGGCCTTTACGGCAAGAAAGAGCTAGTGAACCTAAGGGTA	1	bc
GACCCCTCCT	GAAACACCGGTAATCTAAAGATCCCCGTGGGGATAGAGCTAGAAATAGCA	1	bc
AACTTAATGC	GAAACACCGGTTGGGATAGTCTATACGTGGGGTATAGCTAGTAATATCAA	1	bc
CCCTGGCGAA	GAAACACCGGCTAGAAATAGCAAGTTAACCTAAGGCTAGTCCGTTATCAA	1	bc
AATTCTGCAG	GAAACACCGGTGGCCATTCGGGCTGAGTGGGGTTATAGCTAGAAATAGCA	1	bc
CATTCACCCG	GAAACACCGGTGGCAATACATTGTGAGTGGGGTTAGAGCTAGAAATAGCA	1	bc
GAAATCATCC	GAAACACCGGTAATCATAATCACACCGTGGGGTATAAGTAGAAAAAACAA	1	bc
ACAGAAAAGA	GAAACACCGGTGGGGTTAGATCTTGCGATAGGAATAGCAAGTAAAGTAAG	1	bc
GAATGAAACC	GAAACACCGGTTGGGTTAGTGATAGAGAGAGGAAGATATAGTAATGCCAA	1	bc
TACACGCTCT	GAAACACCGGTTTTCGTTAGTAGGTCTTGGGGTTAGAAATAGAAAGAGAA	1	bc
ATTTGGGCCT	GAAACACCGGTTGTTGGGAACTCGGTGTGGGACAAATAGCAAGTTAACCT	1	bc
ATAACCCTCT	GAAACACCGGTTGCGCGAGGTGGTTTGAGGTAGTAGAGCTAAGTTAAGCA	1	bc
AGTCCATAAC	GAAACACCGGTGTTCTTTGCTCGAGGGGTGGGGTTAGAGCTAGAAATAGC	1	bc
TAAACAGCAG	GAAACACCGGTTTAATTAGTTGGGGTTTTGGTTTGTGGCGAGAAAGCGAG	1	bc
ATGACCGTCG	GAAACACCGGTCCTAGAAGCTGATGGGGTTAGAGCTAGAAATAGCAAGTT	1	bc
TACCTCCGCC	GAAACACCGGTTGAGATAATCAAAAAGTGGGGTAGAGCTAGAAATAGCAA	1	bc
GACGGTGTGA	GAAACACCGGTACTATGTGGTTACGGGGGGGGTTAGAGCTAGTAAACCTA	1	bc
ACACTACAAC	GAAACACCGGTTGGAAGCGATGGTTTGTGTGGTTAGAGCTATAAATAGCA	1	bc
CCTTTTGCAG	GAAACACCGGTTGGCTTTACGGCTTTGTGGGGTTAGAGCTAGAAATAGCA	1	bc
CAGCGGGTTG	GTAACACCGGTTGTCGTTCATAGGGCGTGGGGTTAGAGCTAGAAATAGCA	1	bc
CCCCCCCTGA	GATACACCGGTTTAGTCTGGAGGGTTTTGGGGTTAGCGCTAGAAATAGCA	1	bc
CAATCAAACC	GAAACACCGGTTGAAACAAGCAATAAGTGGGGTTGAGCTAGAAAAAACAA	1	bc
GGCAATTCCA	GAAACACCGGTTCCCGTTAGCTCGGGTTAGAGCTAGAAATAGCAAGTTAA	1	bc
AATCTAGCAC	GAAACACCTGTGCTAAACGTTTGTTAGTGGGGTTAGAGCTAGAAATAGCA	1	bc
GAGTAAAGCG	GAAACACCGGTTATCGTTACGGCTATAAATAGCATGTTAACCTAAGTCTA	1	bc
TAAGCAAAAC	GAAACACCGGTGTTCTTTGCTCGAGGGGTTGGGTTAGAGCTAGAAATAGC	1	bc
AAATCCGTGG	GAAACACCGGTTTTAGAAGATGGGGTATGGGGAGAAATAGAGAGATAACC	1	bc
TTCTTAATGC	GAAACACCGGTTGAGGTAATCAAAACGTGGGAAATAGCTAGAAATATCAG	1	bc
GAAACACAGA	GAAACACCGGTTTACGTAGATAACTAGTGGGGATAGAGAAAGAAATAGAA	1	bc
GATTCCCACA	GAAACACCGGTGTCACGTCGATCTGGGTGGGGTTAGAGCTAGAAATAGCA	1	bc
AAGTCCGTCG	GAAACACCGGTTTTAGTTAATTGTGGGGGGGGAGCTAGAAAGAACAAGTA	1	bc
GGCAACTACG	GAAACACCGGTAATAGAAAGACCCTCGTGGGGATAGAGCTAGAAATAGCA	1	bc
GGCAAATTAC	GAAACACCGCTGAGAAGAGTTAGAGCTTGAAATAGCAAGTTAAACTAAGG	1	bc
AGCACGCCCC	GAAACACAGGTGTCCGTTGGTTCGGGGTGGGATTAGAAATAGAAATTTAA	1	bc
TGAACATACT	GAAACACCGGTTCCAATTGGCTCGGGTTGGGGCTAGAAATAGCAAGATAA	1	bc
CCTTCACCAC	GAAACACCGGTGGGCTTTCGACCTGAGTGGGGTTAGAGCTATAAATAGCA	1	bc
GACAAATTAC	GAAACACCGGTAATCTAAGGACCCCCGTGGGGATAGAGCTAGAAATAGCA	1	bc
GCAAACCTCG	GAAACACCGGTGATGTGAGGACGTTAGTGGTAGAAATAGCAAGAAAAGCT	1	bc
AAAAATAACG	GAAACACCGGTGCCGTTTGTGGGGCCGTGGGGTTAGAGCTAGAAATAGCA	1	bc
GGCACGTACT	GAAACACCGGTTCCCGTTCGCTCGGGTTGGGGCTAGAAATAGCAAGTTAA	1	bc
TCCTTAACAT	GAAACACCGGTTGCCTTTACCTCTTTGTGGGGTTAGCTCGAAATAGATCG	1	bc
AGCACACCCA	GAAACACCGGTTCGCGGAGGTTCGGGTTAGAGCTAGAAATAGAAAGTAAA	1	bc
GACACTTCAT	GAAACACCGGTTCCCGCTAGAAATAGCAAGGTAAACAGATACTAATACCA	1	bc
ACTCGAGAAA	GAAACACCGGTTTTGGGGGAATCGACGTGGGAGAAATAGCGAGATAACAT	1	bc
TCAGCAAAAA	GAAACACCGGTGGTGTTAGAGCTAGAAATAGCAAGTTAACCTAAGTCTAG	1	bc
CACTAACCAA	GAAACACCGGTAATCTAAAGATCCTCGTGGGGATAAAGCTAAAAATACCA	1	bc
CCGTCAACCT	GAAACACCGGTTGGTCTTACTCGTTTGTGGGGTTAGAGCTATAAATAGCA	1	bc
AAGCGCTCAC	GAAACACCGGTGGCGTTAGAGCTAGAAATAGCAAGGTAACCTAAGTCGAG	1	bc
ATCTCATCAC	GAAACACCGGTGCTAGAAGCTGGATCTAGGGGTGGGGGCAGGAATTTACA	1	bc
CCCACAACCT	GAAACACCGGTTGGCGTTAGTCCTTTGTGGGGCTAGAACTATAAATAGCA	1	bc
AAACAACTCC	GAAACACCGGTAGTCTAAGGTGGCTTGTGGGGATAGAGCTAGAAATAGCA	1	bc
CTCCTACGTA	GAAACACCGGTGGGCTGGATCCATGTTTAGGTCTAAATAGCGCATTTAAC	1	bc
TGGTCATCAT	GAAACACCGGTTCGCTTTAGCTAGTGTTAGGGCTAGAAATAGAAAGTGAA	1	bc
CCCTCACAAC	GAAACACCGGTGCCAACGGCATCTTATTGGGGGTTGAGGCTGGAAATGCC	1	bc
GTCTAAGTGA	GAAACACCGGTACTCGGTGCTTACGCGTGGGGATAGAGCTAGAACTTAAA	1	bc
ACCCGCCTGC	GAAACACCGGCTAGCAATAGCAAGGTAACCTAAGGCTAGTCCGTTATCAA	1	bc
AATTCCCTAA	GAAACACCGGTTTACAATGAATCTTTGTGGGGTTAGAGCTAGAAATAGCA	1	bc
GACACACACC	GAAACACCGGTAATATAAGGATCCCCGTGGGGATAGAGCTAGAAATAGCA	1	bc
GTTGCCGACA	GAAACACCGGTGGGTTAAGCCTAGAAGTGGGGTGTTACCCTAAATTCGCA	1	bc
GAAACCAACG	GAAACACCGGTTTACTGAAATAACTAGTGGAGTTAGAGCTAGAAATAGCA	1	bc
GGCAACTACG	GAAACACCTGCGGCTAGGAATCGCAAAATAACCAGTTAATCTAACGCTAT	1	bc
ACCCCGATGA	GAAACACCGGTTTAGTATGTGGGGTTAGAGCTAGAAATAGCAAGTTAACC	1	bc
ATTATATATT	GAAACACCGGTGCACTTTATGACACCGTGGGGTTAGAGCTAGAAATATCA	1	bc
AATTCGCACA	GAAACACCGGTTGTGCGGGACTCTGTGTGGGGGGAAAGGGAAGTAAACCT	1	bc
TCAACCTTCT	GAAACACCGGTGACGCGAGGACGTTAGAGGTAGTAGAACCAGGAAAACCT	1	bc
TCAACAATCT	GAAACACCGGTGACCCTAGGACCTTAGTGGTAGAAATAGCAAGTTAACCT	1	bc
ACTAAAACCG	GAAACACCGGTGCCCTTTATGCGACCGTGGGGTTAGTGATAGAAAGAGCA	1	bc
CCCTCGCACC	GAAACACCGGTTCAACCGGCGTCTTTTGTGGGGTTAGAGCTAGAAATAGC	1	bc
AGAAATTACT	GAAACACCGGTTGTAGTCACTGGCTTGTGGGGTTAGAGCTAGAAATAGCA	1	bc
AAACAATGAC	GAAACACCGGTTTAGTATGTGGGGTTAGAGCTAAAAATAGCAAGTTAACC	1	bc
AACCCCTTGG	GAAACACCAGTTTAGGATGGGGGGTTAGGGCTATAAATAGCAAGTTAGCC	1	bc
TCAACAAAAA	GAAACACCGGTAATCTAAGGATCACAGAGAGGAAGGTAATCTAAATCGAA	1	bc
CCCTATATAA	GAAACACCGGTCCTAGTTACTTCCGTGTGTGGTTAGAGCTAGAAATAGCA	1	bc
TGTCCAGCTT	GAAACACCGGTCTTCCTGAATTCTGCGTGGGGGATAGCTATAAATATCAA	1	bc
ATGAGAGTCG	GAAACACCGGTTGTAGAAGACGCGGTGAGGGAGAGATAGCAAGAGATACT	1	bc
ATTCATTCCT	GAAACACCGGTTCCCATTATGGGATCGTGGGGTTAGAGCTAGAAATAGCA	1	bc
GACTCCGAAA	GAAACACCGGTACTAGTTACTTACGGGTGGGGTTAGAGCTATAAATAGCA	1	bc
CCACTAAACT	GAAACACCGGTTGTATGCGATGGTTTGTGGGGTTAGAGCTAGAAATAGCG	1	bc
GACACTGCCT	GAAACACCGGTTCTCGTTAGCTATGGGTAGAGTTAGAAATAGAAAGTTAA	1	bc
AACAACTGAC	GAAACACCGGTTTTGTATGTGGCGTTGGGGCTAGAAGTAGCAAGTTAACC	1	bc
GATCATTCAC	GAAACACCGGTACTAGTTGCTTACGGGTGGGGTTAGAGCTAGAAATAGCA	1	bc
GACCATCTCA	GAAACACCGGTACTAGTTACTTACGGGTGGGGTTAGAGCTAGAAATAGCA	1	bc
AATTCGTCCT	GAAACACCGGATGTGGTTAACTCGGTGTGGGGGTAATAGCAAATTAAGCT	1	bc
TAATCGCAAA	GAAACACCGGTTTACTTAGTTAACTAGTGGGGTTAGATCTAGAAATAGCA	1	bc
AATTCCCACA	GAAACACCGGTGGCGATTGGATCTGAGTGGGGTTAGAGCTAGAAATAGCA	1	bc
GAGGGTGTAA	GAAACACCGGTACTGGTAGCTTTAGTGTGGGGATGGAGCTAGAAATAGCA	1	bc
AAAAAGGCAG	GAAACACCGGTGACCTTTATGGGAGCGTGGGGTTAGAGCTAGAAATAGCA	1	bc
GGTTTAGAAA	GAAACACCGGTCCTCCTAGTTTCTTCGTGGGGTTGAGGTTGGAAATACAA	1	bc
TCCTAATCAC	GAAACACCGGTGTTCTTTGCTCGAGGGGTGGGGTTAGAGCTAGAAATAGC	1	bc
GAACCAAAGA	GAAACACCGGTTTGCATGGTGGGGTCATGGGTATAGATAGCGAGTTAGCC	1	bc
ATGACCGTCG	GAAACACCGGTACGGGTTACTCACGGGTGGGGATAGTGCTAGAAATAGCA	1	bc
TCAACCCTCT	GAAACACCGGTGACGAGCGGACGTCAGAGCTAGAAATAGCAAGTTAACCT	1	bc
CCCCGACCCA	GAAACACCGGCTAGAAATAACAAGTTAACCTAAGGCTAGTCCGTTATAAA	1	bc
TGCAATCCCA	GAAACACCGGTTCCAGTTAGCTCGGGTTAGAGCTAGAAATAGCAAGTTAA	1	bc
AATTCATCAC	GAAACACCGGTGACGAACGTATGTCAGTGGGGTTAGAGTAAGAAATAGAA	1	bc
TCCGCACAGA	GAAACACCGGTGAGATTAGAGTTAGCCTGAGCATAGTACCCTAACGATAG	1	bc
GAATGCGAGA	GAAACACCGGTTTTGGTAGATGGGGATTTAGGAAGTTGGCTTAGAGCTAG	1	bc
TAGACCAGAG	GAAACACCGGTTTACTTAGGTAACTAGTGAGAATTAGGCTGTAAATAGAA	1	bc
CGGCGGGTTG	GAAACACCGGTCGTCGTTCGTAGGGCGTGGGGTTAGAGCTAGAAATAGCA	1	bc
GAGTGTGAGA	GAAACACCGGTGGTGTTAGAGCTAGAAATGGCATGTTAACCTAATTCTAG	1	bc
TTACGCCGCC	GAAACACCGGCTAGAAGCAGCAAGTTTACCGAAGGCTAGACCGTTATCAA	1	bc
AACCTGATAA	GAAACACCGGTTTTCTATGATAGGTTAGAGCTAGAAATAGCAAGTTAACC	1	bc
AATCGCGTAA	GACACACCGGTTGTGGAGAACTCGGTGTGGGTGTAATAGCAAGTTAACCC	1	bc
TGACCAGATT	GAAACACCGGTTTTCCTGGATACCTCGTGGGGTAAAGGCTGAAAATGCCA	1	bc
AGCCCCTTCG	GAAACACCGGTCGTAGCTGGTAGGTTGTGGGTTTAGAGCTCGAAATAGCC	1	bc
GGCACTGTCT	GAAACACCGGTTCTCGTTACCTCGTAGTGGGGTTAGAGCTAGAAATAGCA	1	bc
TAAGCAAAAA	GAAACACCGGTGGGGTTAGAGCTAGAAATAGCAAGTTAACCTAAGGCTAG	1	bc
AAAACGCATG	GAAACACCGGTTTAGGATGTGGGGGTAGAGCTAGAAATAGCAAGTTAACC	1	bc
AATTGACCAC	GAAACACCGGTTGTGGGGAACTTGGTGTGGGGGTAATAGCAGAATAAGCT	1	bc
TAATCCATAC	GAAACACCGGTTGAGATAATCAACAAGTGGGGTAGAGGTAGAAATAGCCA	1	bc
AATCCATGAC	GAAACACCGGTTATCGACACGTGTCTGTGGGGTTAGAGCTAGAAATAGCA	1	bc
CCCCAACACC	GAAACACCGGTTTTATTTAATAGTGTGTGGGGTTAGAGCTCGAAATAGCA	1	bc
AGACCAGACG	GAAACACCGGTGTTCTTTGCTCGAGGGTGGGGTTAGAGCTAGAAATAGCA	1	bc
TAATTCCTAC	GAAACACCGGTTGAGATAATCAAAAAGTGGGATAGAGCTAGAAATAGCAA	1	bc
CCCTCGCACC	GAAACACCGGTTCAACCGGCGTCTTTTGGGGGGTTAGGGCTAGAAATAGA	1	bc
TTTACTTCCC	GAAACACCGGTTCCCGTTAGCTCTGGTTAGAGCTAGAAATAGCAAGTTAA	1	bc
CAACGAGATT	GAAACACCGGTAAGCGTTAGAACGGGGTAGAGGTAGAAATAGGAAGTAAA	1	bc
GCGTGGCAGA	GAAACACCGGTGCAGCCAGCGCCTTATGTGTGGTTAGAGCTAGAAACAAC	1	bc
CTTCACATGA	GACACACCGGTTTAGTATGTTGGGTTAGAGCTAGAAATAGCAAGTTAACC	1	bc
GGTGGCGCAC	GAAACACCGGTGGGGTTAGAGCTAGAAATAGCAAGTTAACCTAAGGCTAG	1	bc
TCTTGGGTCA	GAAACACCGGTTGCGGGGAACTCGGGGTGGGAGTAGTAGCAAGTTAACCT	1	bc
AATCCAACAC	GAAACACCGGTGACCATCACATGTCGGTGGGGTTAAAGGCATAAATAGCA	1	bc
AACAACGTAA	GAAACACCGGTACTCTCGATTTCGACGTGGGGTTAGAGCTAGAAATAGCA	1	bc
CGAACGCAAC	GAAACACCGGTTTACTTAGCTAAATAGTGGGGTTAGAGCTAGAAATAGCA	1	bc
ATCTCACAAC	GAAACACCGGTGTGCGGAGAGCTAGCGTGAGCAAGTGAACGTAACTCTAG	1	bc
GTAACAGTCG	GAAACACCGGTTTTAGCAAATGGGTTTTGAGTAAGTGGTGATAGAGCTAG	1	bc
TACAACGTAC	GAAACACCGGTAATCTAAAGATCCCAGTGGGGATAGATCTAGAAATAGCA	1	bc
TAACGAAAAT	GAAACACCGGTGGGGGTAGAGCTAGAGATAGGATGGTAACCTAAAGAGCA	1	bc
TCCTTGCTCC	GAAACACCGGTTCAGCCGGCCACTTTTGGGGGTATAGCTCTAGATAGAGC	1	bc
TAATATGTAC	GAAACACAGGTAGTGATAATCAAAAAGTGGGGTAGAGCTAGGAATAGCAA	1	bc
AGCCCTTCAT	GAAACACCGGTTCCCGTTAGCTGGTAGTGGGGTTAGAGCTAGAAATAGCA	1	bc
TCACCAAACA	GAAACACCGGTTGTAAGAGATGGATAGTGGGGATAGTGACAGAAATAGCA	1	bc
AAACCAAATA	GAAACACCGGTGTGGTGGGTTGGGGTAGAGCTTGACATAGTAACTTAAGG	1	bc
TAAATCCACC	GAAACACCGGTTGAGATAATCAAAAAGTGGGGTAGAGCTAGAAATAGCAA	1	bc
AACACTGCCT	GAAACACCGGTTGCCGGGAACTCGGGGTGGGAGTAGAAATATGAAGTTAA	1	bc
AATCCCTTAC	GAAACACCGGTGTCGAATGTGGGGCTAGGGCTAGAGATAGCAAGATAACC	1	bc
TCATCAAACC	GAAACACCGGTTGAGATAGAGCGAAATGTGGGAAGAGATAGAAATACCAA	1	bc
GACAAGCTAA	GAAACACCGGTAATCTACAGATCCCCGTGGGGTTAGAGCTAGAAATAGCA	1	bc
GACACTTCCC	GAAACACCGGTAATCTAAAGATCCCCGTGGGGATAGAGCTAGAAATAGAA	1	bc
AAGTTAAAAC	GAAACACCGGTTGTCTTTACTCCTCTGTGGGGTTAGAGCTATAAATAGCA	1	bc
CCTTCGCACC	GAAACACCGGTTGAACTTCGATCTGAGTGGGGTTAGAGCTAAAAATAACC	1	bc
AGAATTAGAA	GAAACACCGGTGCTAATAGTTAGCTCTAGAAATAGCAAGTTAACCTAAGG	1	bc
GAACGAGATT	GAAACACCGGTGCTAGTAGGGATAGAGCTAGCAATATCACGTTAACCTAA	1	bc
CACCGCGGCA	GAAACACCGGTTGTGGGGAACTACTGGTGGGATAAGTACTGAGAATATCA	1	bc
GCGGACAAGA	GAAACACCGGTGGGGTTCGAGCTAGAAATAGCACGTTAAGCTGAGGCTAG	1	bc
TGATCAGATT	GAAACACCGGTATAAATAGCAAGGTAATTAATAAGTGTTGCTTGAGCTAG	1	bc
GAAATAATTA	GAAACACCGGTGGGGATGATAACGTTCGTGGGGTTAGTGATAAAAATAGC	1	bc
ATGACCGTCG	GAAACACCGGGGGGGGTTAAACTTGGAATTACCAATTTAACTTAGGCTTA	1	bc
TCGATAAAAC	GAAACACCGGTTGGCTTTACTCCTTTGTGGGGTTAGAGCTATAAATAGCA	1	bc
GAATCAGTAA	GAAACACCGGTACTAGTTGCTTACGGGTGAGGATAGAGCTAGAAATCGCA	1	bc
TAAGACATCC	GAAACACCGGTAATCTAACGCTCCCCAAGGGGATAGAACTAGAAATAGAC	1	bc
TTCTTAAACA	GAAACACCGGTCCTAGAAGATGGACCTAGAGGTGGGGATAGAGATAGAAA	1	bc
CTCTTATCCA	GAAACACCGGTCGCGAAAATATGCCGGTGGGGTTAGAGCTAGAAATAGCA	1	bc
TTACAAGACT	GAAACACCGGTTGAAAGCGATGGGTTGTGGGGTGAGATCGAGAGATAGCA	1	bc
GTGGCAGCAA	GAAACACCTGTGACGATAGAGCTAGAAATGGCAAGATAACTTAAAACTAG	1	bc
CCCTCGCACC	GAAACACAGGTTCAACCGGCGTCTTTTGGTCTAGAAATAGCAAGTTAACC	1	bc
GAATTCCCAC	CTCCACACCGGTGCTAATATTTAGATCTATACATCGCAAGTTAAACTAAG	1	bc
ACATTCACTA	GAAACACCGGTGGCAATTCGATCTGAGTGGGGTTAGAGCTAGAAATAGCA	1	bc
GGGGGGGGGA	GAAACACCGGTGGGGTTAGAGCTAGAAATAGCAAGTTAACCTAAGGCTAG	1	bc
AATCCATCAC	GAAACACCGGTGACAAACGTATGTCAGTGGGGTTAGAGCTAGAAATAGCA	1	bc
AATTAGCAAC	GAAACACCGGTGGCCATTGGATCTGAGTGGGGTTAGAGCTAGAAATAGCA	1	bc
CACTCGCACC	GAAACACCGGTGGGGCTAGAGCTAGAAATAGCAAGTTAACCTAAGGCTAG	1	bc
TTCTAATCAC	GAAACACCGGTCATAGAAGCTGGATCTAGAGGTAGGGTTAGATATAGAAA	1	bc
CCCTCGCACA	GAAACACCGGTGGAACTTCGATCTGAGGTGTGTTAAAGCCAGGAAAAACA	1	bc
AATTCAACAC	GAAACACCGGTGACAATTACATGTCTGTGGGGTTAGAGCTAGAAATAGCA	1	bc
CAGTTAGCCC	GAAACACCGGTTCGAGTTGCTCCTTTGTGGGGTTACAGCTATAAATAACC	1	bc
GAAACCCACC	GAAACACCGGTAATCTAAAATGCTCCGTGGGTATAGAGATAGAAATCAAG	1	bc
CAACCCCATG	GAAACACCGGTTTAGTCTGTGGGGTTAGAGCTAGAAATAGCAAGTTCACC	1	bc
TCAACCCTCT	GAAACACCGGTGACGCGAGGACGTTAGAGCTAGAAATAGCAAGTTAACCT	1	bc
CATTCCATGA	GAAACACCGGTTTAGATTGGATGTTTGGAGGTATAGAGAGAGAGTTAACA	1	bc
AAATGAGTAA	GAAACACCGGTTGAGAGAAACTATGTGTGGGATAAATAGCAAAATAACCA	1	bc
ATCACCGTCA	GAAACACCGGTTCCAGATAGCTCGGGATAGAAATAGAAATAGCAAGTTAA	1	bc
TACACTCTAT	GAGACACCGGTACACTTTGCTTACGAGTGGGGTTAGAGCTAGAAATAGCA	1	bc
GAGTCAAGCG	GAAACACCAGTTATCGTTACGGATTTGTGGGGTTAGAGCTAGAAATAGCA	1	bc
AAATAAATGA	GAAACACCGGGTTAGTATGTGGGGTTAGAGCTAGAAATAACAAGTTAACC	1	bc
AAACGGGACT	GAAACACCGGTTGTGGGGAACGGGGTGTGGGAGTAAAAGCAAGTAAACCA	1	bc
TGAACCTTCT	GAAACACCGATGCGCGTTAACGCGAGATCGGGATATAGAAAGCTAGATAA	1	bc
AGACAGTATA	GAAACACCTGTGTTCTTTGCTCGAGGGGTGGGGTTAGAGATAGAAATAGC	1	bc
CCATAAAACC	GAAACACCGGTTGGCTTTACTCTATTGAGGGCATAGAGATATAAATAGAA	1	bc
AATCCATCAC	GAAACACCGGTTGTGGAGGAATCGGTGTTGGAGTAATAGTAGGTTTACCT	1	bc
AATTAACAAC	GAAACACCGGTGGCAAATCGATCTGAGTGGGGATAGAGCTAGAAATAGCA	1	bc
GGCAACTACG	GAAACACCGGTGGCTAGCAATCACATGTTGGCCTAGGGCTGGTCCGATCT	1	bc
CAATCAAAGA	GAAACACCTGTGTCGATTGTATCTGAGGGGGGAGAGAGCGAAAAACAACA	1	bc
GAATCAATCT	GAAACACCGGTTGTAATCATTAACTGGTGGGGTTAGAGCTAGAAATAGCA	1	bc
CATACCTTCA	GCAACACCGGTGATCTTAAGATCCCCGGGGGTTTAAGGCTAGAACTGGCA	1	bc
GTGTTAGAGC	GAAACACCGGTTGGATGCCCTACTTTGTGGGGTTAGAGCTAGAAAGAGCA	1	bc
CCAATAAAAC	GAAACACCGGTTGGCTTAACTCATTTGTGGGGTTAGAGCTAGAAATAGCA	1	bc
GGCAACTCCG	GAAACACCGGTGGCATCCAGCCACTTGTGGGGTTAGAGCTATAAATAGCA	1	bc
AATACTGGAG	GAAACACCGGTGCCCTTTATGGGACCGTGGGGTTAGAGCTAGAAATAGCA	1	bc
AGAATCCGCC	GAAACACCGGTTTTGGAAGCTGGGGTTTTGGTAGGTGGGGCTAGATCTAG	1	bc
CGCATTCACA	GAAACACCGTTGGCAATTCGATCTGAGTGGGGTTAGAGCTAGAAATAGCA	1	bc
CATTACCACG	GAAACACCGGTGGCAATTCGCTCTTAGTGGGGTTAGAGCTAGAAATAGCA	1	bc
GTAACACACA	GAAACACCGGTGGGAACCGAGGGTTTGTGGGGTTAAAACCAGATATAGCA	1	bc
ACTGCTGCAA	GAAACACCGGTGCCGTTTATGCTAGCGTGAGGTTAGAACTAGAAGTCTAG	1	bc
AAACACCTGC	GAAACACCGGTTTAGCTTGCGGGAGTGGAGGTAGTAGAAGTAAGTTAACC	1	bc
CATACCGTCA	GAAACACCGGTTGTGGGAGACTCGGTGTGGGATAAAGCTAAAAAAAACCA	1	bc
CACTATGACC	GAAACACCGGGGTTAGAGCTAGAAATAGCAAGTTAACCTAAGGCTAGTCC	1	bc
TCCTTACTCC	GAAACACCGGTTGAGATAATCAAACATGGGGGGATAGCTAGAGATAGCAC	1	bc
ACACCAACAC	GAAACACCGGTTGTAAGTGATGGTTTGGGGGGTTAGAGCTAGAAATAGCA	1	bc
CTGACCGTCG	GAAACACCGGTCCTAGTTACTTATGGGTGGGGTTAGAGCTAGAAATAGCA	1	bc
ATGACCGTCG	GAAACACCGGTTGTGGGGAACTCGGTGTGGGAGAAATAGCAAGATAACCT	1	bc
TTTATTGCCG	GAAACACCGGTCGCCTTTCTGGGCCCGTGGGGTTAGAGCTAGAAATATCA	1	bc
TATTTTGCCC	GAAACACCGGTTCTCTTGATGTGTACGTGGGGTTAGAGCTAGAAATGCAA	1	bc
GTGGCCGCGT	GAAACACCTGTGCCCGTAAAGTTAGATTTGGGCTGTAAACCGAAGGCTAG	1	bc
