TTCGTCGCGC	GAAACACCGGTCGCATAACTGAGCCGGGGGTAGAAGTAGTAAAAATAGCA	1	bc
CGCCGCTCCG	GAAACACCGGTGGCAGCCCGCCACTTGTGGGGTTAGAGCTAGAAATAGCC	1	bc
CGCTCACCAC	GAAACACCGGTGAGAACAGAGCGTTAGAGGTAGTAAGAGCTAGTAAACCC	1	bc
ATCTTGGCCC	GAAACACCGGTCGTGGAGATGTCGCGGTGGGGGTAGTGGTAAGATAACCA	1	bc
CCGATCACAA	GAAACACCGGTTGCCTTTCCTCCTTTGTGGGGTTAGAGCTATAAATAGCA	1	bc
CAGTTAATAA	GAAACACCGGTTGGCTTTACTTCTTTGTGGGGTTAGAGCTATAAATAGCA	1	bc
GTCAAACATA	GAAACACCGGTGATCATGAGATCTTCGTGGTTAGAAATATCAAGTTAACC	1	bc
GTATATGTCA	GAAACACCGGTACTAGTTACTTACAGGTGGGGTTAGAGCTAGAAATAGCA	1	bc
GAAGGCCAGA	GAAACACCGGTTAGATTCGTCAAGTGGTAGAAATAGCGATATAACCTACA	1	bc
AAATCGCAAA	GAAACACCGGTGTCAATTGGTTCTGGGTGGGGTTAGAGCTAGAAATAGCA	1	bc
ACATGGGAAA	GAAACACCGGTTGTGGGGAACTCAGAATGGGCGAGATAGCCTGATACCAT	1	bc
GAATCCCTCA	GAAACACCGGTGCTGCTAGTTAGCTGGTGGGGTTAGAGCTAGAAATAGCA	1	bc
CGTTACTCCA	GAAACACCGGTAAGAACAGTCCGTTAGAGGTGGTAATAGCAAGTATACCT	1	bc
ATTTCAGATT	GAAACACCGGTCTTCCTGGAATCTACGTGGGGTATAGCTAGAAATAGCAA	1	bc
ATTTCACAGA	GAAACACCGGTGTGCGGAGATTATGCGTGAGAAAAAGCAAGTAAACTAAG	1	bc
ATACCGCCAC	GAAACACCGGTGATCTATGCTCGTTTGCGGGGATAGAGCTAAAAATAGCA	1	bc
ATATTAAAAT	GAAACACCGGAGGTAAGAGTTAGCTCGTGGGGTTAGAGCTAGAAATAGCA	1	bc
ACCAGCAGCC	GAAACACCGGTAGAGTGGATCCACGGGTGGGGTTAGAGCTAGAAATAGCA	1	bc
GATTAGCTCC	GAAACACCGGTTATCTAGAACTCCCCGTGGGGATAGAGCTAAAAATAGCA	1	bc
TCAAACCTCT	GAAACACCGGTGGCACGAGGACACTAGTGGTGGTAATAGCAGATTAACCT	1	bc
TCATTCGTCC	GAAACACCGGTTGGATTCCTCAAGAGTGGTTAGGACCTGGAATTGCCAGG	1	bc
AGATAGCTCC	GAAACACCGGTGTTCTTTGCTCGAGGGTGGGGTTAGAGCTAGAAATAGCA	1	bc
TGACAAGAAC	GAAAAACCGGTCTTCCTTGGATCTACGTGGGGTTGAGCTAGGAATAGCAA	1	bc
GGGAACAAAG	GAAACACCGGTGGCAGTCAGCCACTTGTGGGGTTAGAGCTAGAAATAGCA	1	bc
AAGCCCGTGG	GAAACACCGGTCTTGGATGTGGGGGTTGGGCCTGGAATTACCAGGTTAAC	1	bc
AAGCCAAGAC	GAAACACCGGTGACAAAGCTAGAATTAGGGAGTTAACGTTAGAATAAGCA	1	bc
AATACACTCC	GAAACACCGGTAATATAAGGATCCCAGTGGGGATAGAGCTAGAAATAGCA	1	bc
GAATCATCAA	GAAACACCGGTTTTAGTAGATGGTTAGTGGGTTTAAACTTAGAAATGCCA	1	bc
CCCCGAGGTT	GAAACACCGGTGCTAGCGGTTTCGAGTGGTGTTAGAGCTAGAAATAGCAA	1	bc
ACTTCCCACA	GAAACACCGGTGGCAATTCGATCTGAGTGGGGTTAGAGCTAGAAATAGCA	1	bc
AGATAACCTA	GAAACACCGGTGTGCGGGGATTATGCGTGAGGAAGAGCAAGTAACCTAAG	1	bc
CAATGACATA	GAAACACCGGTGACCATGAGATCTGAGTGGGGGTAGAGCTAGGAAAAGCA	1	bc
TTAATATTCA	GAAACACCGGTGCGCATGATAACGTAAGGGGCAAGAGTACCAAGTTAAAA	1	bc
GTATTATCCA	GAAACACCGGTGATCATGATAACGTCTCGGGGGTTTATCTCTAGAAAGAG	1	bc
GAAAATGAAT	GAAACACCGGTTTTCGTAGCTTACTAGTGGGGTTAGAGCTAGAAATAGCA	1	bc
ATGACACTAG	GAAACACCGGTCCTAGAAGCTGGGGTTAGAGCTAGAAATAGCAAGTTACC	1	bc
ATACGCCACC	GAAACACCGGTAGAATGCATCGACGGGTGGGGTTAGAGCTAGAAATAGCA	1	bc
ATGACAGAAG	GAAACACCGGTCCTAAAAGCTGGGGTTAGAGGTATGAGTAACAAGTTAAC	1	bc
CCCTCACCAA	GAAACACCGGTGAGAACAGAACGTTGTAGAGCTAGAAATAGCAAAATAAC	1	bc
AGCCTGCAAA	GAAACACCGGTGTTCTATGCTCGAGGGTGGGGTTAGAGCTAGAAATATCA	1	bc
AACCTGCTCT	GAAACACCTGTTGTAGATGATGGGTTGTGGGGTTAGAGCTAGAAATAGCA	1	bc
GACCACGTAT	GAAACACCGGTGGTAGTCATGTAGGGGTGGGGTTAGAGCTAGAAATAGCA	1	bc
GGAATAGATG	GAAACACCGGTCTTCGTTCGTAGGGGGTGGGGTTAGAGTTAGAAATAGCA	1	bc
CAAAAAGCCT	GAAACACCGGTGCTCTTTATTGGGACGTGGGGGTAGAGCTAGAAATAGGA	1	bc
TAGGGCGAAA	GAAACACCGGTGAACTGCCTCAACATGTCGGGTTAGCGTTAGACTAGTCA	1	bc
CACACACTAA	GAAACACCGGTGGTAAATCGATCTGCGTGGGGTTAGAGCTAGAAATAGCA	1	bc
CGCACATCAT	GAAACACCGGTTGCTGTTAGCTCGTAGTGGGGTTAGAGCTAGAAATAGCA	1	bc
GGATTGCAAA	GAAACACCGGTGCTATTTGTTCGCTGGTGGGGTTAGCGCTAGAAATAGCA	1	bc
TCAACACACA	GAAACACCGGTGGGGTTAGAGCTAGAAATCGCAAGTTAACCTAAGGCTAG	1	bc
CGTTCGTAAC	GAAACACCGGTGAGCTCAGCACGTTAGGGCTTGGAATAGCACGTTCACCT	1	bc
GAATCATCAA	GAAACACCGGTGCTAATAGTACGTTAGTGCGGGAAGAGGCAGGTTAACCA	1	bc
CCCCGAAGAC	GAAACACCGGTTGGCTTTACTCCTTTGTTGGGTTAGAGCTATAAATAGCA	1	bc
TACTCCCAGT	GAAACACCGGTTTACGGAGTTAATTAGTGGGAATAGAGCTAGAACTAACG	1	bc
AGTCCAGAAC	GAAACACCGGTGTTCTTGGAATGTACGTGGGGTGGGGCTAGAAATAACCA	1	bc
GATCGCTAGC	GAAACACCGGTGACATGCGTCGAAATATGAGGTTAGCCTAAGGCTAGTCC	1	bc
AATGACCGTT	GAAACACCGGTCCTAGAAGCTGGGGTTAGAGCTAGAAATAGCAAGTTAAC	1	bc
GAATTTTACC	GAAACACCGGTGTCCATTCTATCTGAGCGGGGTTACATCTAGCTATACCA	1	bc
GTGGGGGGGG	GAAACACCGGTGAGATGCCTCGAAATAGCAAGTTAACCTAAGGCTAGTCC	1	bc
TGCATATCCC	GAAACACCGGTTCGCATGATCACGTGGGTGGAGAGCTAGAAAGAGAAAGC	1	bc
GGCACATCCC	GAAACACCGGTGACAAACGTACGTTAGTGGGGTTAGAGCTAGAAATAGCA	1	bc
TCAGCTACCA	GAAACACCGGTTTTCGATCCTAGGTCGTGGGGTTAGAGCTATAAATAGCA	1	bc
TGCTTTTCCA	GAAACACCGGTTCTAATAGTCAGGTGGGGGGGGTTCTAGCTAGAACAAGC	1	bc
CGGTGACAAA	GAAACACCGGTGGCAATTCGATCGGAGTGGGGTTAGAGCTAGAAATAGCA	1	bc
ATATCTGACA	GAAACACCGGTAGTAATTGTTGCCTTGTGGGGTTAGAGCTAGAAATAGCA	1	bc
CGCAGGTCCG	GAAACACCGGTGGCAGCCAGCGGCGTGAGGGGTTAGAACTAGAAATAAAA	1	bc
TGCAGTGACT	GAAACACCGGTTCCCGTTAGCAGGTAGAGGGGTTAGAGCTAGAAATAGCG	1	bc
GCGACCGACA	GAAACACCGGTGGTCGCCGTGGAGAGGTGGGGTTAGAGCTAGAAATAGCA	1	bc
CGAATATCTA	GAAACACCGGTGAGCACAGAACGTTAGAGCTAGAGATGGCAAGTTAACCT	1	bc
AAAATACAAG	GAAACACCGGTGTTCAATCAAAGGTCGTGGGGGTAGAGGCAGAAATAGCA	1	bc
TTCTACCCCA	GAAACACAGGTCGCGAAAATGTGCCGGTGGGGTTAGAGCTAGAAATAGCA	1	bc
CGACAGGAAT	GAAACACCGGTGCTCTCTGCTCGAGGGTGGGGTTAGAGCTAGAAATAGCA	1	bc
CTCTCACAGC	GAAACACCGGTGCGAGGGGCTTATGCGTGAGACATGGCAAGGAACCTAAG	1	bc
CGGCTGTATG	GGAACACCGGTCGCCGTTCGTAACTCGTGGGGTTAGAGCTAGAAATAGCA	1	bc
TCCACCCTCT	GAAACACCGGTGGTCTCCGTGGTGAGGCTGGAATTGATCTATTAACATCA	1	bc
CCGACAACAT	GAAACACCGGTTGGCTTAATTCCCTTGTGGGGTTAGAGCTATAAATAGCA	1	bc
GAAATACAAT	GAAACACCGGTGTGCATGGTTAACTTGGGGGGATAGAGCTCAAGATAACC	1	bc
GGTTATTACA	GAAACACCGGTGGCAGCCACCCACTTGTGGGGTTAGAGCTAGAAATAGCA	1	bc
AATTAACACC	GAAACACCGGTTCCCTTTACTGGTCTGTGGGGTTAGAGCTATAAATAGCA	1	bc
TCAGGCCAAA	GAAACACCGGTGAGATGCCTCGAAATAGCAAGTTGACATAAGGCTAGTCC	1	bc
CATCCATCTT	GAAACACCGGTGCCAACCGTTTCTAAGTGGGGTTAGAGCTAGAAATAGCA	1	bc
GACTACGCCG	GAAACACCGGTTTTAGCCAATGGCGTGTGGGGTTAGAGCTAGAAATAGCA	1	bc
ACGTTACCCC	GAAACACCGGTGAGCTCTACACGTTAGAGCTAGTAGAAGCATGTTTACCT	1	bc
AGAGGGCGAG	GAAACACCGGTGCGATGCCTCGAAAAAGCAAGTTAAACTAAGGATTGTCA	1	bc
GGGCGCGATA	GAAACACCGGTGAGATTTCTCGGAAGGGCGGGTTAAAGCTAGAAAAGGCC	1	bc
AAGAAAGCCA	GAAACACCGGTGTTCTTTACTGGAGGGGGGGGGTTAGAGCTAGAAATGGC	1	bc
GACTTTGTCC	GAAACACCGGTACTGGTTATTTACGGGTGGTGTTAGTGCTAGAATAACAA	1	bc
TAATCAAAAT	GAAACACCGGTTTACTTAGTTAACTAGTGGGGTTAGAGCTAGAAATAGCA	1	bc
TCAACCCTCT	GAAACACCGGTGACGCGAGGACGTTAGAGCTAGAAATAGCAAGTTAACCT	1	bc
GGGGGGGCAA	GAAACACCGGTGAGATGCCTCGAAATAGCAAGTTAACATAAGGCTAGTCC	1	bc
ACCCGCAGCA	GAAACACCGGTAGAATGAGTCAGCTTGGGGGGTTAGAGCTCGAAATAGCA	1	bc
GAATCAGATT	GAAACACCGGTCTTCGTAGAATCTACGTGGGGTTGAGCCAGGAATAGGCA	1	bc
GAACTCTATA	GAAACACCGGTGAGCATGGTAACGTTAGAGCTAGAAATAGAAAGTTAACC	1	bc
CGGCAGAAAC	GAAACACCGGTTGGCGTTAGAGCTAGGAGTGGCAAGTTAAACTAAGACTA	1	bc
TAAACATGTA	GAAACACCGGTTTAATTAGCGTGGTTATGGCTATAAATAGCAAATTAACC	1	bc
TTCCTCGCTC	GAAACACCGGTCGCGAAAATGTGCCGTTGGGGTTAGAGCTAGAAATAGCA	1	bc
AAGTGGACAC	GAAACACCGGTTGTGGGGAACTCGGTGTGGGAGAAATAGCAAGTTAACCT	1	bc
CGCTCACACA	GAAACACCGGTGAAAACGGCACGTTAGTGGTGGTAGTAGCAGGATGACCT	1	bc
ATCATTAATA	GAAACACCGGTTGAGATCATTAAAAGGTGGGGTCAGGGTAAAAAAAGCAA	1	bc
AGCACTCCAT	GAAACACCGGTTTTCGTTCACTGGTCGTGGGGTTAGAGCTAGAAATAGCA	1	bc
TCATCGGACC	GAAACACCGGTTCAACTGGCGTCTTTTGGGGGGATAGAGATAGAAATAAC	1	bc
CAGCGCCGCG	GAAACACCGGTTAGAGCTAGAAATAGCAAGTTCAGCTGAGGCTAGTCCGT	1	bc
GAACATCAAC	GAACCACCGGTGTTCTTTGCTCGAGGGTGGGGTTAGAGCTATAAATAGCA	1	bc
CGTTCCTCCC	GAAACACCGGTAATCACAGGACGTTAGAGCTAGAAATAGCAAGTTAACCT	1	bc
CGACGGGCTC	GAAACACCGGTGTTCGTTATAGGGTTCTGGTTTTAAATCTCCAGATAACC	1	bc
GGAATATCTT	GAAACACCGGTGAGCGTGATAACGTCTCGTGGGGATAGAGCTAAAACTAG	1	bc
ATGACAATCA	GAAACACCGGTCCTAAAAGCTGGGTCTAGAGCTAGAAATAGCAAATTAAC	1	bc
AGATAGCCAA	GAAACACCGGTGTTCTTAGATTGTGCGTGGGATTAGAGCTAGAACCAGCA	1	bc
TGCACATATT	GAAACACCGGTTTCCGTTAGATCGTCGTGGGGTTGGAGCTAGAAATAGAA	1	bc
TCATCATCCC	GAAACACCGGTCGCGAAAATGTGCCGGTGGGGTTAGAGCTAGAAATAGCA	1	bc
CCCTCATCCT	GAAACACCGGTTCTCGCGGGTTCGGAGCTAGGTTTAGCATGTAAATCTCA	1	bc
AGGCTAAAAC	GAAACACCGGTGGGCTTTGCTCGTTTGTGGGGTTAGAGCTATAAATAGCA	1	bc
GGATCAGAAT	GAAACACCGGTCTTCCTGGAATCTACGTGGGGTAGAGCTAGAAATAGCAA	1	bc
CACCGCGCTT	GAAACACCGGTGCTCGAGGCTTCGCCGTGGGGTTAGAGTTAGAAATAGCA	1	bc
CAGTGAGTCG	GAAACACCGGTTAGAGCTCGAAATAGCAGGTTAAGCTAAGGCTAGTCCGC	1	bc
TCAGGAAAGC	GAAACACCGGTGGGGTTAGAGCTAGAAATAGCAAGTTAACCTAAGGCTAG	1	bc
AGAAACCACT	GAAACACCGGTTTACTTCGTTAACTTGTGGGGTTAGAGCTAGAAATAGCA	1	bc
AAATTCACAA	GAAACACCGGTGGCAATTCGATCTGAGTGGGGTTAGAGCTAGAAATAGCA	1	bc
CCGGGAACAA	GAAACACCGGTGGGGTTAACGCTTTCGATGGCAAGTTAACATAAGGATCG	1	bc
ATAAAAGACG	GAAACACCGGTTGTATGTAATGGTTCGTGGGGTTAGAGCTAGAAATAGCA	1	bc
AGTGGGGAAC	GAGACACCGGTTGTTGTGGACTCGGTGTGGGAGAGAGAGCGAGTTAACCT	1	bc
TATCTAGTCT	GAAACACCGGTTTTCCTGGACTCAACGTGGGGTAGAGCTAGAAATAGCAA	1	bc
TATTCCCCAA	GAAACACCGGTGGCAATTCTATCTGAGTGGGGTTAGAGCTAGAAATAGCA	1	bc
CATCGGGCTA	GAAACACCGGTCGTGGGGAACTCGGTGTGGGCGAGATAGCACGTTATCCT	1	bc
TCTTGAGAAA	GAAACACCGGTGGTGGTTAACTCGGAGTGGGAGTATTAGCATAAATATCT	1	bc
TGTACTTAAT	GAAACACCGGTTCTCGTAGGCTCGTCGTGGGGTTAGAGCTAGAAATAGCA	1	bc
AGTGACCGTT	GAAACACCGGTCCTAGTAGCGGGGGATAGAGCTAGTAATAGCAAGTTTAC	1	bc
TCAGCCCTGT	GAGACACCGGTGAGGCGCGGACGAAAGAGCTAGAGATAGAGAGTTAGCAT	1	bc
AAGACAATCG	GACACACCGGTTAGAGCTAGAAATAGCAAGTTAACCTAAGGCTAGTCCGT	1	bc
