CAACGAGATT	GAAACACCGGTGCTAGCGGTTTCGAAGTGGGGTTAGAGCTAGAAATAGCA	3	bc
ACCGACAACA	GAAACACCGGTTGGCTTTACTCCTTTGTGGGGTTAGAGCTATAAATAGCA	1	bc
GAGGCAAGAA	GAAACACCGGTTATCGTTAAGGATTTGTGAGGATAGAACTAGAACTAGCA	1	bc
CGGTGAGTAG	GAAACACCGGTGGTAATTCGATCTGCGTGGGGTTAGAGCTAGAAATAGCA	1	bc
AGACCAAAAC	GAAACACCGGTGTTCTTTGCTCGAGGGTGGTGTTAGAGCTAGAAATAGCA	1	bc
GAGTACCGCG	GAAACACCGGTTATCGTTGAGGATTTGTGGGGTTAGAGCTAGAAATAACA	1	bc
GAATAAGTAG	GAAACACCGGTACTAGTTACTGACGGGTGGGGTTAGAGCTAGAAATAGCA	1	bc
ACTGCAGAAA	GAAACACCGGTGGGGGTGGACCTAGAAAGGGAGAGTTAACCAATTAATAG	1	bc
GATAATGCTA	GAAACACCGGTGAGCGTGATAACGTTATGGGTGTAAATAGCAAATTACCC	1	bc
GATCCAGCCC	GAAACACCTGTGACAAACGTATGTAAATGGGGTTAGAGCTAGAAAAAGCC	1	bc
TGCTTTTCAC	GAAACACCGGTTCCCTTTAGCTCGATATGGCAATAGAGCTTAAAACAAGT	1	bc
GAGGCAAGAA	GAAACACCGGTGATGGTTAAGGATTTGTTGGGTTAGATCTAGAAATAGCA	1	bc
TAAAGGGAAA	GAAACACCGGTTGTGTTAGATTACGAGTGGGTGAAATAGCATAATAAGCA	1	bc
AAAAACGAAT	GAAACACCGGTTTAATTAGATAGTTTACTTAGATTACTTAGTAACTAAGT	1	bc
CGACCACAAA	GAAACACCGGTGTGATTTGCACGAGGTGGGGGTAGAACTAGAAATTGCAA	1	bc
TGTCCCTCTT	GAAACACCGGGCGATAGCCTGAGATGGCAGGTTTACCTAAGGCTAGTCCG	1	bc
CGGCAAGCTG	GAAACACCGTTCGTCGTTCGTAGGGCGTGTGGTTAGAGCTAGAAACAGCA	1	bc
CCTTCACGCA	GAAACACCGGTGGCAATTCGATCTGAGTGGGGTTAGAGCTAGAAATAGCA	1	bc
TGCAACCTCC	GAAACACCGGTTCTCGTTAGCTAGAAATAGCAAGTTAACCTAAGGCTAGT	1	bc
GTATCACAGA	GAAACACCGGTGAGCATGATATCTTCTCGTGGGGTTAGAGCTAGAAATAG	1	bc
CCACGATGTC	GAAACACCGGTAGGATGGATCCACGGTTGGGGTTAGAGCTTGACATAGCA	1	bc
ATACCAAAAA	GAAACACCGGTTGTAAGCGATGGTTTGTGGGGTTAGAGCTAGAAATATCA	1	bc
CGTTTAACAT	GAAACACCGGTTGGCTTTACTCCGTTGGGGGGACAGAGATATAACTAGCA	1	bc
CGCTTGTACC	GAAACACCGGTTCAACCTGCGTCTTTTGGGGGGTTAGAGCTAGAAATAGC	1	bc
AGTAAATCAG	GAAACACCGGTGCGCACAATGGGATTTGGGGTTTAGGGCAGGAAAAAGCA	1	bc
GATTAATGAA	TGGGGGAAGGGACGAAACACGGGTGAGGATGCGGGTTTGGGGGGAGAGAG	1	bc
GTGCTCTATA	GAAACACCGGTGAGCATGATAACGTTAGAGCTAGAAATAGAAAGTTAACC	1	bc
AATCATTCCC	GAAACACCGGTGCCCTTTGTGGGACCGTGGGGTTAGAGCTAGAAATAGCC	1	bc
TTAACACTCA	GAAACACCGGTGACGCGAGGACGTTAGAGCGAGTAATGGCAAGATAACCT	1	bc
CAACCATCTC	GAAACACCGGTGACAACCGTATGTAAGTGGGGTTAGAGCTAGAAATAGCA	1	bc
ATTAGCGTTT	GAAACACCGGTCCTAGCAGCTGCGAGGGGGTATTAGTGCTAGTAATAGCA	1	bc
CCGTTCATCC	GAAACACGGGTTGGTTTTACTCCTTTGAGCGGTTAGAGCTATACCTATCA	1	bc
TAACCCCTGT	GAAACACCGGTTTACTTAGTTAACTAGTGGGGGTAGAGCTAGAAATAGCA	1	bc
CCGCCGATTG	GAAACACCGGTCGTGTTTGATCTTGCAATGGGTTAGTTCTCTAAATCTCA	1	bc
ATCTACAGGC	GAAACACCGGTGTGCGGAGATTATGCGTGAGAAATAGCAAGTAACCTAAG	1	bc
ACCTAGCCCC	GAAACACCGGTTCGACCGGCGTCTTTTGTGGGGTTAGAGCTAGAAATAGC	1	bc
ACGATAATAC	GAAACACAGGTTGTCTTTACTCCTTTGTGGGGTTAGAGCTATAAATAGCA	1	bc
AGATCACCAA	GAAACACCGGTGATGGTTTAGAGCTAGACTTAGCAAGTTAACCTACAGCT	1	bc
GAATTATATC	GAAACACCGGTTTGCTTAATTCGTGTGTGGGGTTAGAGCTATAAATAGAA	1	bc
GTGACCAGCG	GAAACACCGGTTATAGTTGCGGATTTGTGGGGTTAGAGCTAGAAATAGCA	1	bc
GAAATAGAAC	GAAACACCGGTGAGCGTGCTACCGTCTCGTGGGGATAGAGCTAGAAATCG	1	bc
ATGACATACG	GAAACACCGGTGAGCATGATAACGTAGCAAGTTAACCTAAGACTAGTCCG	1	bc
GCCTCACCCG	GAAACACCGGTTTTAGTGCATAGTGAGTGGGGTTAGCGCTAGACATAGCC	1	bc
AGATAGTCCC	GAAACACCGGTGTCGTAAGTTCGGGGGGGGGGATAGAGCTCGAAATAGCA	1	bc
GGACTAACAA	GAAACACCGGTGCTAATAGTTAGCTCGTGGGGTTAGAGCTAGAAATAGCA	1	bc
AATAACCCCC	GAAACACCGGTTGTCGAAAAATCGGCGTGGGGGCAATAGCACGTAAACCT	1	bc
ATTACCTCAA	GAAACACCGGTGAGGGAATAGGGCTAGCAACAGCAAGATAACATAAGGCT	1	bc
AATGGAACAA	GAAACACCGGTTGTGGTAGAGCTGGAGATGGCAAGTTAGCCTAAGGCTAG	1	bc
TGACCGCAAA	GAAACACCGGTGTTGTTTGCTCGGGGGTGGGGTTAGAGCTAGAAATAGCA	1	bc
AAGACAGAAA	GAAACACCGGTGTTCTTTGCTCGAGGGTGGGGTTAGAGCTAGAAATAGCA	1	bc
GAACCATCCC	GAAACACCGGTTTTAGTAAATGGTGAGTGGGGTTAGAGCTAGAGATAGCA	1	bc
CCCCCCCTCA	GAAACACCGGTTGAATGGAGCCACTTGTGGGGTTAGAGCTAGAAATAGCA	1	bc
ACGATAACCC	GAAACACCGGTTGACTTTAATCCATTGTAGGGTTAGAGCTATAAATATCT	1	bc
GGTGAGCAAC	GAAACACCGGTGATCTTTGCTCGAAGGTTGGGTTAGAGCTAGAAATCGCA	1	bc
CGAAAATATA	GAAACACCGGTGAGCATGATAACGTCTCGTGGGGTTGGAGCTAGAAATAG	1	bc
TTTCTATATA	GACACACCGGTGAGCATGATAACGTTAGAGCTAGAAATAGCAAGTTAACC	1	bc
GGAACAGCCT	GAAACACCGGTTTTAGTTAGTGGTGAGGTGAGAGCTAGAAATAGGAAGGT	1	bc
AATTCAAACA	GAAACACCGGTGGTAATTCCGTATGAGTGGGGTTAGAGCTAGAAATAGCA	1	bc
AAGTCACACG	GAAACAGCGGTTCGAGCTAGAAATAGCAAGTTAACATTAGGCTAATCCGA	1	bc
GTATTTTTAA	GAAACACCGGTGAGCATGATAACGTCTCGTGGGGTTAGAGCTAGAAATAG	1	bc
GAATCCTATA	GAAACACCGGTGATCATGATAAGGTTAGGGCTAGAAATAGACAGTTAAAC	1	bc
GCAATCTTTA	GAAACACCGGTGAGCCTGATAACGTTAGGTGTAGAAATAGCAAGTTAACC	1	bc
AATATATCAA	GACACACCGGTGAGCATGATATAAATAGCAAGTTAGCCTTAGGCAAGTCC	1	bc
GGACCGGCAC	GAAACACCGGTGTTCGTTAGTCGAGGGTGGGGTTAGAGCTAGAAATAGCA	1	bc
AATTCATCCA	GAAACACCGGTGAGTGGTTAGAGCTAGAAATAGCAAGTTAACCTAAGGCT	1	bc
AAATAAGAAA	GAAACACCGGTGGAAAATGGAGGTGAGTGGGGTTAGAGCTAGAAATAGCA	1	bc
GCATCAAGAA	GAAACACCGGTGATCTTAGAGCTTTTGTGGGGTTAGAACTAGAAATCGAG	1	bc
AATTCGCAAG	GAAACACCGGTTTTCGTTCATAGTTCGTGGGGTTAGAGCTAGAAATAGCA	1	bc
GAGAAAAAAA	GAAACACCGGTGATAATAGATAGCTCGTGGGGTTAGAGCTAGAAATAGCA	1	bc
TACAACCTCC	GAAACACCGGTAACCTAAGGACGTCCGAGGGAGAAATAGCAGGTTAACCT	1	bc
AAATAGGCAC	GAAACACCGGTGGTGGTTGCTTGAGGGTGGGGGTAGAGCCAGAAATAGCA	1	bc
TCCTCAACAA	GAAACACCGGTGGGGTTAGAGCTAGAGATAGCATGTTAACCTAAGGCTAA	1	bc
GATTTAGCAA	GAAACACCGGTTGTGGGGCGCTCGGTGTGGGAGAAATATCAAGTTAACCT	1	bc
CTGTGGGATG	GAAACACCGGTCGCATTCCTTAGGGCGTGGGGTTAGAGCTAGAAATAGCA	1	bc
ACGTCGGACC	GAAACAGGGGTTAGAGCGACAAATATCTAGTCAACCTACTGCTAATCCGA	1	bc
AAAATATAAA	GAAACACCGGTGAGCAAGATAACGTTAGATCTATAAATAGCAAGTTGACC	1	bc
ATAACCTATA	GAAACACCGGTGAGCATGATAACGTTAGGGCTAGAAATAGCAAGTTAACA	1	bc
AGACATCACG	GAAACACAGGTGTTCTTTGCTGGAGGGTGGGGTTAGAGCTAGAAATAGCA	1	bc
GATTGGAAAA	GAAACACCGGTTGTGGTGGACTCGTCGTGGGAGAAATATCAAGTTAACCT	1	bc
GATTATGTCG	CTAAACACCGGTGCTCTTTATGGGCCCGTGGGGTTAGAGCTATAAATAGC	1	bc
CAAAGATATC	GAAACACCGGTTGTGGGGAAATCTGTGGGGTAGAAATAGCAAGTTAACCT	1	bc
CATACTGACG	GAAGCACCGGTGCCCTTTATGGGATCGTGGGGTTAGAGCTAGAAATAGCA	1	bc
TAATTACAAC	GAAACACCGGTTGTGATATTGGGGTAGAGGTAGAAATAGCAAGTTAACCT	1	bc
CCCCGGCGAA	GAAACACCGGTAGAATGGAACCACGGGTGGGGGTAGTTGCAGAAATAGCT	1	bc
AGTATTATAG	GAAACACCGGTGAGCATGGAAACGTCACGAGGAGTTAGAGCTAACAACAT	1	bc
ATCTACAGGC	GAAACACCGGTGTGCGGAGATTATGCGTGGGAAATAGCAAGTAACCTAAG	1	bc
AACCACCTGA	GAAACACCGGTTTAGTATGGAGGGAAGTGGGGTTAGAGCTAGAAATAGCA	1	bc
TAGACAAAAT	GAAACACCGGTTTACTTAGTTAGTTTGCTTGGTTTACTCAGTTACTAAGT	1	bc
AGAATTAGAA	GAAACACCTGTGCTAATAGTTAGCTCGTGGGGTTAGAGCTAGAAATAGCA	1	bc
AAATTGTGCA	GAACCACCGGTTGTGGGGAACTCGGTGTGGGAGTAATAGCAAGTTAACCT	1	bc
TGCTTTTACT	GAAACACCGGTTCTCGTAATTGCCTAGGGGGGTTAGAGCTAGAAATTGGA	1	bc
CGTTCGGATC	GAAACACCGGGTTAGAGGTAGTATTATCAAGTTAACCTAAGAGTAATCCG	1	bc
ATCAAACAAA	GAAACACCGGTGTTCTTTGCTCGAGGGTGTGGTTGGAGCTAGAAATAGCA	1	bc
TCAGCCACCA	GAAACACCGGTGGGGTTAGAGCTAGAAATAGCAAGTTTACCTAGGGCTAG	1	bc
GGACAATAAA	GAAACACCGGTGCTCTTTATACCAGGGTGGGGTTAGAGCAGGTAGTAATA	1	bc
CATCGTGCTG	GAAACACCGGTCGTCTTTCGTAGGGCGTGGGGTTAGAGCTAGAAATATCA	1	bc
ATCACACTCA	GAAACACCGGTGACGCGAGGATATTCGAGCTAGATAGCAAGTAACATCAG	1	bc
GACACTTACT	GAAACACCGGTTCTCGTTAGCTAGAAATGGCAAGTTAACTAGAGGCAAGA	1	bc
GCCTTAAACA	GAAACACCGGTGCTAATAGTTAGCTCGTGGGGGTAGAGCTAGAAATAGCA	1	bc
GTGGGCGTCC	GAAACACCTGTGAGGTGAGTCGAAATAGCAGATTAACCTAAGTATCGTCC	1	bc
GAAACCCACC	GAAACACCGGTGAGCTTGATAACGTCGTGTGGGTAGGGCGCGAGATATCA	1	bc
GACTATTTAA	GAAACACCGGTACTAGTTACTTACGGGTGGGGTTAGAGCTGGAAATAGCA	1	bc
ATAAAATAGA	GAAACACCGGTCTGCGGAGATTATGCTTGGGAAATAGCAAGAAACCTCAG	1	bc
TGCTCTTCAA	GAAACACCGGTGCCCGTAAGCTAAAATTAGCAAGTTAACCTAAGGCTAGC	1	bc
CCAATACATA	GAAACACCGGTGAGCATGATAACTGCGCGGGTGGATATAGCTATAGATAG	1	bc
AGACATCCCC	GAAACACCGGTGTTCTTTGCTCGAGGGTGGGGTTAGAGCTAGAAATAGCA	1	bc
GAGTTAAGAT	GAAACACCGGTTGTCTTTACTCCTTTGTGGGGTTAGAGCTATAAATAGCA	1	bc
GTACTATCTC	GAAACACCGGTGAGCATGATAACGTCTCGTGGGGTTAGCGCTAGAAATAG	1	bc
CGGTCCAGCG	GAAACACCGGTTATCGTTGCGTATTTGTGGGGTTAGAGCTAGAAATAGCA	1	bc
GCGTCAAACA	GAAACACCGGTTATCGTTGCGGATTTGTGGGGTTAGAGCTAGAAATAGCA	1	bc
TATTTCTAAA	GAGACACCGGTCGTAATTCGATCTGACTGGGAATAGCGCTAGAAACTGAG	1	bc
ACACCCCCCT	GAAACACCGGTTGTAAGCGATGACTTGTGTGGTTAGAGCTAGAAATAGCA	1	bc
CAACGAGATT	GAAACACCGGTGCCCTTTATGGGACCGGGGGGGTAGAGCTAAGAATAAGA	1	bc
CATTCCCCCC	GAAACACCGGTGGCAATTCGATCTGGGTGGGGTTAGAGCTAGAAATAGCA	1	bc
ATTTTGTCAA	GAAACACCGGTTGTGGGGAACTCGGTGTGGGAGAAATAGCAAGTGATCCT	1	bc
GACATAAAAG	GAAACACCGGTGGTAATAGTTAGCTCGTGGGGTTAGAGCTAGAAATAGCA	1	bc
CAACGAGAAA	GAAACACCGGTTCTGGGGGATTCGGCGTGGGAGTAGCACTAAGAAAAGCC	1	bc
AATATGGTAA	GAAACACCGGTTGTGTGTAACTCGGTGTGGGAGAAATAGCAAGTTAACCT	1	bc
CATACTGCAG	GAACCGGACGAAACACCGGTGCCCTTTCTGTCACCGTGGGGTTAGAGCTA	1	bc
AGAAATAAAA	GAAACACCGGTGAGCATGATAACGTCTCGGGGGGATGGAGCTAGAAATAG	1	bc
AACCGGCGCA	GAAACACCGGTAGAGTGGAACTAGGGGTGGGGGTAATAGTAAGATAAGCA	1	bc
GACAACCTCC	GAAACACCGGTAATCTAAAGATCCCCGTGTGGATAGAGCTAGAAATAGCA	1	bc
ATATCACAGA	GAAACACCGGTGGGCGGCGATTATGTGTGGGGAATAGAAAGTAACTTAAA	1	bc
CAACAGCAAA	GAAACACCGGTGTTCGTTGATCGCTGGTGGGGTTCGCGCTAGAAATAGCA	1	bc
AAGGGGGAGA	GAAACACCGGTGAGCTGCCTCGAGATGGGAGGTTAGAGTAAGGCTAGTCC	1	bc
ATTTCACACA	GAAACACCGGTGGCAATTCGATCTGAGTGGGGTTAGAGCTAGAAATAGCA	1	bc
ACCTCAACCA	GAAACACCGGTGTGCGTAGAGGAAGGGTGAGAAAGAGCTAGTAATCCAAG	1	bc
CAACCCAAAA	GAAACACCGGTTTAGTATGTAGGGAAGTGGGGTTAGAGCTAGAAATAGCA	1	bc
AAAATGTTTA	GAAACACCGGTTTGCGTGCTGAGGTCTCGGGGTGATAGAGCTAGATAGAA	1	bc
AATATAGCCT	GAAACACCGGTGCTCTTGATGGGGCCGTGGGGATAGAGCTAGAAATAGCA	1	bc
GGACTAAACA	GAAACACCGGTGCTAATAGTTAGCTCGTGGGGTTAGAGCTAGAAATAGCA	1	bc
CATTCAGCAG	GAAACACCGGTGGTAGTTCAATCTGAGTGGGGTTAGAGCTAGAAATAGCA	1	bc
AAACAACAAG	GAAACACCGGTTATCGTTACGGATTTGTGGGGTTAGAGCTAGAAATAGCA	1	bc
GGAACATCTA	GAAACACCGGTGAGCATGATAACGTCTCGTGGGGTTAGAGCTAGAAATAG	1	bc
GTGGCCTGAG	GAAACACCGGTGATATTCATCGAAATGGGGAGTTAAAGTAAGGATAAGCC	1	bc
ATACAACAGA	GAAACACCGGTGTGCGGAGATAAGTTAGGACAAATAACAGCTAATCTAAC	1	bc
AAAAATGTGG	GAAACACCGGTGTCCTTTTAGGGAGCGTGGGGTTATAGCTAGAGATAGCA	1	bc
ATACCTGACA	GAAACACCGGTTGTAAGCGATGGCTTGTGGGGTTAGAGCTAGAAATATCA	1	bc
CAAAGAGATT	GAAACGCCGGTGCTAGCGGTTTCGAAGTGGGGTTAGAGCTAGAAATAGCA	1	bc
ACGTGGGCAG	GAAACACCGGTTGTGGTGGACTCGGTGTGGGAGAAAAAGCAAGTTAACCT	1	bc
AGGCAACTAT	GAAACACCGGTGGCAGCCAGCCACTTGTGGGTTTATAGCTAGAAATAGCA	1	bc
CACTCACCCA	GAAACACCGGTGGCAATTCGATCTGAGTGGGGTCAGAGCTAGAAATAGCA	1	bc
GAATAACACG	GAAACACCGGTTTTAGTAGATGGAGGGTGGGGTTAGAGCTAGAAATAGCA	1	bc
TAATTCATAA	GAAACACCGGTTGAGATGGTGGGGTAGAGCTAGAAATAGCAAGTTAACGT	1	bc
GACATATATC	GAAACACCGGTGAGCATGATAACGTCTCGGGGTGTTAGAGCGAGAAAGAG	1	bc
TATCAAGCAT	GAAACAACGGGATAGGGATAGAAATAGCGGGGTAACATAAAGAAAGTCCA	1	bc
AATACCACGC	GAAACACCGGTTGTAAGCGATGGTTTGTGGGGTTATAGCTAGAAATAGCA	1	bc
AAATAGAAAC	GAAACACCGGTGTTCTTTGCTCGAGGGTGGGGTTAGAGCTAGAAATAGCA	1	bc
ACAGCAGCCA	GAAACACCGGTGGGGTTAGAGGTAGAAATAGCATGTTAACCTAAGGCTAG	1	bc
GGATTATCAA	GAAACACCGGTGAGAATAATATGGTTGGGGGGTTAAAGAGAAAATAAACA	1	bc
ATACGACCGA	GAAACACCGGTGTGCGGAGTTTATATGGGGGAGATAGCGCTAGAAATAAC	1	bc
GTCATTTCTT	GAAACACCGGTGCGCGTGATATAGTCGTGGGGGGATAGCGATAGACAGCG	1	bc
GGCACCAAGG	GAAACACCGGTGGCAGCCAGCCACTTGTGGGGTTAGAGCTAGAAATATCA	1	bc
TTGTCCAGCT	GAAACACCGGGGTAGAGCTAGAAATAGCAAGTTAACCTAAGGCTAGTCCT	1	bc
GAGTAAAGGA	GAAACACCGGTTAGCGTTGCGGATTTGTGGGATTAGAGATATAAATATCG	1	bc
TGACTATATA	GAAACACCGGTGAGCCTGATAACGGTGGGGGTAGAAACAGCAAGTTAACC	1	bc
AATACACACC	GAAACACCTGTTGTAAGCGATGGTTTGTGGGGTTAGAGCTAGAAATAGCA	1	bc
AAGGCGGGTT	GAAACCCCGGTCGTCGTTGGTAGGTTGCGGGGTAAGAGGTAGAAATAGCA	1	bc
GACTATGTAA	GAAACACCGGTACTAGTTACTTACAGGTGGGGTTAGAGCTAGAAATAGCA	1	bc
GTTACCTCCA	GAAACACAGGTGGGGGCCTAGAGCTTGTGGGAGCAGATCTACATAAAGCA	1	bc
AACATAAGCG	GAGACACCGGTTATCGATCCTGGGTCGTGGGGTTAGAGCTAGAAATAGCA	1	bc
AACAAGCTGA	GAAACACCGGTTTTCGATCATAGTTCGTGGGGTTAGAGCTAGAAATAGCA	1	bc
TCAGTCACCC	GAAACACCGGTGGGGTTAGAGCTAGAGAGGGCATGTTAACCTAAAGATAG	1	bc
GCACTCTATA	GAAACACCGGTGAGCATGATAACGTCTCGTGGGGTTGGAGCTAGAAATAG	1	bc
AAACCATATA	GAAACACCGGTGAGCGTGATAACGTTAGAGCTAGAAATCGAAAGTTAACA	1	bc
GAGTATGGAA	GAAACACCGGTACTAGTTACTGACGTTGTGGGGTTAGAGCTAGAAATAGC	1	bc
TGCACATACG	GAAACACCGGTGGGAGCAGACCACTTGTGGGCTTGTTAATCGAAATCGAA	1	bc
ATATAACCCT	GAAACACCGGTTGTAAGCGATGGTTTGTGGGGTTAGAGCTAGAAATAGCA	1	bc
CCCTCGGATA	GAAACACCGGTACAAGCGGCGTCTGTTGGGGGGTTAGAGCTGGAAATCGA	1	bc
CATAATCCCC	GAAACACCGGTGCCCTTTATGGGACCGTGGGGTTAGAGCTAGAAATAGCA	1	bc
GAGGGAGAAA	GAAACACCGGTGAGATTCCTCGAAATAGCGAGTTAGCCTTAGGCTAGTCC	1	bc
TGCATCAGCA	GAAACACCGGTTTTAGTAGATGGAGAGTGGGGATATAGCTAGAAATAGCA	1	bc
GCCAAGCAAC	GACACACCGGTTCAACCGGGGTCTCTTGGGTGGTTAGAGCTAGAAATAGC	1	bc
AAAGCAGCAA	GAAACACCGGTGGGGGTAAAGCTGGAGATGGCGAGTTAGCATGTTACTCG	1	bc
TACACTTTCC	GAAACACCGGTTCCCGTTAGCTAGAAATAGCAAGTTAACCAAAGGCTAGT	1	bc
AATTGCACGA	GAAACACCGGTTGAGGAGGTCTCGGTGGAGGTAGAATAGCAAAGTAAACT	1	bc
AATCTATCTA	GAAACACCGGTGACCATCATATGTCAGCGGGGGGAGAGCTAGAGATATCG	1	bc
GTACTATCTC	GAAACACCGGTGAGCATGATAACGTCTTGGAGTTGCAAGTTAACATAGGG	1	bc
CGCCAGCACC	GAAACACCGGTGTTCTTTGCTTGAGGTTGGGGTTAGAGCTAGCAAGAGCA	1	bc
TGTACAGTCT	GAAACACCGGGGAAGAGATAGAAATAGCAAGTTAACCTAAGGCAAGTCCG	1	bc
GTGTGCGCAA	GAAACACCGGTGAGCTGCCTCGAAATTGAAGGTTAACCTAAGTCTAGTCC	1	bc
AAGACAGGAA	GAAACACCGGTGTTCTTTGCTCGAGGGTGGGGTTAGAGCTAGAAATAGCA	1	bc
AGATAGGCAG	GCAACACCGGTTTTAGTCAATGGTGAGTGGGGTTCGCGCTCGAAATAGCA	1	bc
CAAAGAGATT	GAAACGCCGGTGCTAGCGGTTTCGAAGTGGGGTTAGAGCTAGAAATGGCA	1	bc
GTCTAATATA	GAAACACCGGTGAGCATGACAACGTCAGGGCTAGAAATAGAAAGTTAACC	1	bc
GATATATAAA	GAAACACCGGTGAGCATGAGAACGTCTCGGGGGGATAGCTATAGAAAGCG	1	bc
GACAAAACCG	GAAACACCGGTTTTCGTAAATGGTGAGAGGGTTTGGAACTAGAAATTGAC	1	bc
AGAAAGGAAA	GAAACACCGGTGTTCTTTGCTCGAGGGTGGGGTTAGAGCTAGAAATAGCA	1	bc
TAATCTAAAA	GAAACACCTGTGCTGGTAGAGTAAGAAATAGCATGTTAATCTAAATCTCG	1	bc
AATATATAAA	GAAACACCGGTGAGAGGGGTATGTCAGAGGAATAAGAGCTAAAACTAACA	1	bc
