AACATGCTAG	GAAACACCGGTTTTCGATCATAGGTCGTGGGGTTAGAGCTAGAAATAGCA	2	bc
TTCTCCCCCT	GAAACACCGGTCGCGAAAATGTGCCGGTGGGGTTAGAGCTAGAAATAGCA	2	bc
ATAAACACAA	GAAACACCGGTTTACTTAGAGTGGGGTTAGAGCTAGAAATAGCAAGTTAA	2	bc
GCCCGAGGCC	GAAACACCGGTAGAAGGTACCTACGGGTGGGGTTAGAGCTAGAAATAGCA	1	bc
AAAACAATCC	GAAACACCGTGGTGGTAGATCTAAAAATGGGAAGTTAACATAAGGCTAGA	1	bc
TTCTCCCCCT	GAAACACCGGTAGCGAAAATGTGCCGGTGGGGTTAGAGCTAGAAATAGCA	1	bc
GAGTCACAAG	GAAACACCGGTTTTCTTTGCGGATTTGTTGGGGTTAGAGTTAAAAATGGC	1	bc
AACTGGCAAA	GAAACACCGGTTCAGCGGGCGTCTGTGTGGGAGTAGAGCTAGGAAAAGCA	1	bc
CAGTGTACAA	GAAACACCGGTTGGGGTAGAGTCATAGAGAGAGAGATAACCAGATAACCT	1	bc
AACTACTGCC	GAAACACCGGTGACCTTTATGGGGCCGTGGGGTTAGAGCTAGAAATAGCA	1	bc
GTGTGAGACA	GAAACACCGGTTATCGTTACGGATTTTGTTGCGTTATAGCTAGAAATAGC	1	bc
TAAATCAAAA	GAAACACCGGTTAACTTAGAGAGGGGTTAGAGCTAGAGAGAGAAAGATAA	1	bc
GGCTCTGTTT	GAAACACCTGTCCTCGTTGCTTACGGGTGTGGTTAGAGCTAGAAATAGAA	1	bc
CCCGCACCCC	GAAACACCGGTTCAACCGGCGTCTTTGTGGGGTTAGAGCTAGAAATAGCA	1	bc
AGCAAGCACC	CTAAACACCGGTGTTCTTTACTCGGTGGTGGGGTTAGAGCTAGAAATAGC	1	bc
TTCCTATACC	GAAACACCGGTCGTGAATGTGTGCCGGTGGGGTTAGAGCTAGAAATAGCA	1	bc
ATTGGGCCAC	GAAACACCGGTTGTGGGGAACTCGGTGTGGGAGAAATAGCAAGTTAACCT	1	bc
GAGACCGACT	GAAACACCGGTTATCTTTGTGAACTTTTTGGGGTAGAAGTAGAAATTAGC	1	bc
AAATGAATAA	GAAACACCGGTGGCAATTCGATCTGAGTGGGGTTAGAGCTAGAAATAGCA	1	bc
GAGTCCCTCT	CTCCCCCCCGGTTATCCTTCCGGATTTTTTTTTTTTAGAGCTCTCCCTCG	1	bc
CCTTTGACAA	GAAACACCGGTTGTGGGGACCTCGTTGTGCGATAAGTGCCAAGTTAACCT	1	bc
ACCTAGGACC	GAAACACCGGTTCAATTGGTGTCTTTGTGGGGTTAGAGCTAGAAATAGCA	1	bc
ACCTGGTCCA	GAAACACCGGTTGTGGGGAACTCGGTGTGGGAGAAATAGCAAGTTAACCT	1	bc
TTGACAGACG	GAAACACCGGGCGGTTTGGGCTAGAAGTAGCAAGGTGCCCTAAGGCTCGA	1	bc
GAGAAAATCC	GAAACACCGGTAATCTATAGATCCCCGTGGGGTTAGAGCTAGAAATAGCA	1	bc
AGTAAAATTT	GAAACACCGGTCGTCGTTCGTAGGGGTGGGGTTAGAGCTAGAAATAGCAA	1	bc
AGGCGAGATT	GAAACACCGGTTGTCGTTCGTAGGTCGTGGGGTTAGAGCTAGAAATAGCA	1	bc
ATCCTACACC	GAAACACCGGTTGTGAACGATGGGGGTTGGGGCTAGAAATAGCAAGTTAA	1	bc
AAACGAGCCA	GAAACACCGGTTGTAGGGAACGCGTTGTGGGATTAATGCTAGATAAACCT	1	bc
TAACGCCATT	GAAACACCGGTTTACTTAGTTAACTAGTGGGGTTAGAGCTAGAAATAGCA	1	bc
GGCACTGCCA	GAAACACCGGTTCCCGTAAGCTCGTGGGGATCGAGCTAGCAAAAGCAAGT	1	bc
TCCTATTTCC	GAAACACCGGTCGCGAAAATGCGCCGGTTGGGTTAGAGCTAGAAATAGCA	1	bc
ATGTCCAGCG	GAAACACCGGTTAGGGTAGAGCTTGTTATAGGAAGATAGCCTAAGGTAAC	1	bc
TATCCACATA	GAAACACCGGTGTTCATTCGATCTGAGTGGGGTTAAGCCAGGAAATAGCA	1	bc
ATGCAATTCC	GAAACACCTGTTCCCGTTAGCTCGGGGGGTTAGAGCTAGAAATAGCAAGT	1	bc
GACCATTTCC	GAAACACCGGTACTAGTTACTTACGGGTGGGGTTAGAGCTAGAAATAGCA	1	bc
AATACATAAA	GAAACACCGGTGACAAACGTATGTCAGTGGGGTTAGAGCTATAAATAGCA	1	bc
AACTCTGTCA	GAAACACCGGGGGTTTATAGCTAGAGATAGCATGTTAACCTAAAGTTAGC	1	bc
ATAAACGTAG	GAAACACCGGGGGGTTAGAGCTAGAAATAGGAAGTTAACTTAAGACTAGT	1	bc
AACTACCAGA	GAAACACCGGTATGCGGAGATTATGCGTGAGAAATGAGCTAGAAACAGAA	1	bc
TTACTATATT	GAAACACCGGTCGTCGTTCGGAAGAGCTGGGAATGAGCTAGAAATCTCAA	1	bc
AATACCACCG	GAAACACCGGTTGGATAGACGTATTTGTGGGGATATAACTTAAAATAACA	1	bc
GTCAACGTCG	GAAACACCGGTACTAGATACTTACGGGTGGGGTTAGAGCAAGAAATAGCA	1	bc
TAAAAATGAC	GAAACACCGGTGCCCTTTATGAGACCGTGGGGTTAGAGCTAGAAATAGCA	1	bc
AAAGCCACAA	GAAACACCGGTTGTGTGGGACTCGGAGTGGGAAAAATAACAAGATAATCG	1	bc
GAGTCTGGCA	GAAACACCGGTTATCGTTACGGATTTTGGGGGGTTAGAGCTAGAAATAGC	1	bc
ATCTGCGCCC	GAAACACCGGTCGCGAAAATGTCGGGGTGGGGGTAGAGGCAGAAAAAGCA	1	bc
ATTTTATCAC	GAAACACCGGTCGCGAACGTATGCCAGTGGGGTTAGAGCTAGAAATAGCA	1	bc
TCCCCCCCAT	GAAACACCGGTTTACTTAGAGTGGGGTTAGAGCTAGAAATAGCAAGTTAA	1	bc
ACAACAACAA	GAAACACCGGTGGGGTTAGAGCTAGAGATAGCAGGGTGACCTAAAGCTAG	1	bc
AATGACAGTC	GAAACACCGTGGGGGTAGAGCTAGTAAAAGCAAATAAACCAAGTGCAAGT	1	bc
CCCTCGCCAA	GAAACACCGGTACAACAGGCATCTTTGTGGGGTTAGAGCTAGAAATAGCA	1	bc
GGGTCAACCC	GAAACACCGGTTATCGTTACTCATTTTGTGGTGTTAGATCTAGAAATAGC	1	bc
ATGACTTTCT	GAAACACCGGGGTGTTAGAGCTAGAAGTAGCAAGTTAACCTATTGCTAGA	1	bc
ATACCAGAAA	GAAACACCGGTTGTAAGCGACGGTTTGTGGGATTAGAGGTAAGTAAACCA	1	bc
ACGTTCACCC	GAAACACCGGTTGGCTTTACTCCTTTGTGGGGTTAGAGCTATAAATAGCA	1	bc
CCCCAACACC	GAAACACCGGTAGAATGGATCCACGGGTGGGGTTAGAACTAGAAATAGCA	1	bc
GAGTGGGCAG	GAAACACCGGTTGTGGGGAAGTCGGTGTGGGAGAACTAGCAAGTTAACCT	1	bc
CCGTTCCTAC	GAAACACCGGTTCTGTGTGCTCGTTTGTGGTGATAGAGATATAATTAGCT	1	bc
ATGACCGATT	GAAACACCGGTGTGCTAGAGCTCGAAATAGCAATTTAACCCAAACGTAGG	1	bc
ATCACCCCCT	GAAACACAGGTGCCGCGAGGTTATGAGCTAGAAATAGCAAGTAACCCTAG	1	bc
CCGACCATAC	GAAACACCGGTAGTCTAAAGTCCTCCGTGGGGATAGAGCTATAAATATCA	1	bc
GAGACAGTCG	GAAACACCGTTGTGTTAGAACTAGAAATGGCAATATAACCTAAAGCTAGT	1	bc
TAGACAGTCG	GAAACACCGGGGGGGTAGATCTAGAAGTGGGGAGTTAACCTAAGGCGAGT	1	bc
TCCGCACACT	GAAACACCGGTTTAACTGGCGTATTAGTGGGGTTAGTAACATAATACTCA	1	bc
AAAATCTTTA	GAAACACCGGTTTGGTTAGAGCTGGCAGTAGTAGAAATAGCTAGTGCTCC	1	bc
AATACAGTCG	GAAACACCGGGGGTTTAGAGCTAGCAGTGGGAAGAGAACCTGAAGCTAGA	1	bc
TGCTAACCCA	GAAACACCGGTGTGCGGAGATTATTCGTGAGAAATAGCCAATAACCTAAG	1	bc
AGCCTCAGCC	GAAACACCGGTTTTAGTAAATGGTGAGTGGGTTTAGAGCTAGAAATATCA	1	bc
GGTCCATATA	GAAACACCGGTGGTCCCAGAACTTTTGGGGGTTAGAGCTAGAATTAGCAG	1	bc
GTCTATGCCA	GAAACACCGGTACTGGTTATTTACGGGTGGGGTTAGAGCTAGAAATAGCA	1	bc
GTGGGCGAGA	GAAACACCGGTGGGGTTAGAGCTAGAAATAGCGAGTTAACCTAAGGCTAG	1	bc
TGATTAGATT	GAAACACGTGGGGAAGAGCTAGAAATAGCGGGTTAACCTAAGGCTAGTCA	1	bc
CGACAGGCCC	GAAACACCGGTGTTCTTTGCTCTAGGGCGGGTTTAGAGCTAGAAATAGCA	1	bc
AGGAGGGTTG	GAAACACCGGTGGGTGAGAGCTGGGAGTGGGAAGAGAGCCAGAGACAGGA	1	bc
CAGACCGTAG	GAAACACCGTGGGGCTAGAGTTATTTATAGCAAGATAACTTAAAGTAAGT	1	bc
TTATTGGCCA	GAAACACCGGTTGTGGGGAACTCGGTGTGGGAGAAATAGCAAGTTAACCT	1	bc
GGAATATCCA	GAAACACCGGTTGTCGTTCGCAGGTAGGGGGGTAGAGCTAGAAATAGCAA	1	bc
ACGACGGCAG	GAAACACCGGGGGGGTAGAGCTAGAAATAGCAGGTTAAGCTAGAGCTAGT	1	bc
GGCTAATACG	GAAACCCCGGTGGCTAGTCGTTGTGAGTTGTGCTAGGGCTTGTACGTTCT	1	bc
CAATCCCACT	GAAACACCGGTTTAATTAGTTAACTAGTGGGGCTAGAGCTAGAAAGATCA	1	bc
AAGTGGGCTG	GAAACACCGGTTGTCGTTGGTGGGGTTAGGGCTAGAAATAGCAAGTTAAA	1	bc
CAAAGAGATT	GAAACGCCGGTCCTCGCGGGTTCGGCGGGGGGTTAGAGCTAGAAATAGCA	1	bc
ATCTTATCTA	GAAACACCGGTCGCGAAAATGTGTCGGTGGGGTTAGAGATCGAAATAGCA	1	bc
GGATCACCAA	GAAACACCGGTGATAATAGAACGTTTGTGGGGATAGCGCTAAAAAGCGCG	1	bc
GTGGCCGTGA	GAAACACCGGTCCGGGTAGCTGTAGAAATAGTAAGCTAACCCAAGTCCTG	1	bc
CTGCGCGTCG	GAAACACCGGGAGGTTAGAGCTAGGAGTAGGATGTTAACCTGAGGCTGGT	1	bc
GAATCCATAA	GAAACACCGGTGCTGATAGTTAGGTCGTGGGGTTAGAGCTAGAAATAGCA	1	bc
ACATCTCACC	GAAACACCGGTTCACCCGGCGTCTTTGTGGGGTTAGAGCTCGAAATAGCA	1	bc
CCCGCACCCC	GAAACACCGGTTCAACCGGCGTCTTTGGGGGGTTTGAGCTTGAAATTGCC	1	bc
TTAATATAAT	GAAACACCGGTTTACTTAACGTGGTGGTAGGGATAGAAATAGAAAGTTAA	1	bc
GAGTTTACAC	GAAACACCGGTTGGCTTTACTACTTTGTGGGGTTAGAGCTATAAATAGCA	1	bc
ATGACAGCCA	GAAACACCGGTGTGCGGATATTAGGCTTGGGAAATAAAAATTAACCTAAA	1	bc
AATTTTGCAC	GACACACCGGTTGTGTTTCCCTCGGTGTGGGATCAATAGCACTTTCACCT	1	bc
CATTCCCGCA	CTAAACACCGGTGGCAATTCGATCTGAGTGGGGTGAGAGCTAGGAATAGC	1	bc
CAATCACACC	GAAACACCGGTTGAAATAATCAATGAGTGGGGTTTGGCTCTAAAAAGCCA	1	bc
GTCTAATATA	GAAACACCGGTCGTCGTTGGTTAGGGGGGGGTTAAAGCTAGAAAAAGCAA	1	bc
AACCTGCTAG	GAAACACCGGTTTTCGATCATAGGGGGTGGGGTTAGAGCTAGAAATATCA	1	bc
ATTACATAAA	GAAACACCGGTCGTCGTTCGTAGGTGTGGGGTTAGAGCTAGAAATAGCAA	1	bc
GAGTTCAACA	GAAACACCGGTGCTAATAGTTAGCTCGTGGGGTTAGAGCTAGAAATAGCA	1	bc
CTCATATATC	GAAACACCGGTGAACATGATAACGTCGTGGGGTTAGAGCTAGAAATAGCA	1	bc
AGGTCAAGAA	GAAACACCGGTTATCGTTACGGGTTTGTGGGGTTAGAGATAGAAATAGCA	1	bc
TAGCCGAACT	GAAACACCGGTTTTCGTTCGTAATTAGTGGGGTTAGAGCTAGAAATAGCA	1	bc
TAAAACCACC	GAAACACCGGTTTACTTAAGGTGGCGGTAGGGCTAGAAATAGAAAGATAA	1	bc
TGTACTGCTT	GAAACACGTGGGGCAGTGCTAGAAATAGGGGGTTAACCTAAGGCTAGTCC	1	bc
TTCGTCTAAC	GAAACACCGGTCGGGATAGTGCGCCGGATGGGATATAGACATAAAGATCA	1	bc
TAAACCGTCG	GAAACACCGGGGTGCTTGAGCTAGAAATAGCATTATAACCAAAGGCTAGT	1	bc
TCCTCAAACC	GAAACACCGGTTCAACTGGCGTCTTTGTGGGGTTAGAGCCAGAAATAGCA	1	bc
TCCCCCAACT	GAAACACCGGTTTACTTAGAGTGGGGTTAGTGCTATAATTAGCTAGTTAT	1	bc
AATAATTCTT	GAAACACCGGTGCCCTTTATGGGACCGTGGGGTTAGAGCTAGAAATAGCA	1	bc
CTCTCATACA	GAAACACCGGTTCAACCGGCGTCTTTGTGGGGTTAGAGCTAGAAATAGCA	1	bc
CGACGAGATT	GAAACACCGGGGGTAGCGGTATAGATGGCGGGTTAGAGTTAGAAATATCA	1	bc
CGCCAGCACC	GAAACACCGGTGTTCTTTGCTCGAGGGTGGGGTTAGAGCTAGAAATAGCA	1	bc
GACTTTGCAC	GAAACACCGGTCCTAGTTACATATGGGTGGGGTTTGAGGTAAGAATAACA	1	bc
CGAACATCAT	GAAACACCGGTTAACGTTAGCTAGTGGGGTTAGAGCTAGAAATAGAAAGT	1	bc
AAGATAGTCG	GAAACACCGTGGGGATAGAGCTATAAATAGCAAGTTAACCTAAGGCTAGT	1	bc
ACTTCGCCAC	GAAACACCGGTTGTGGGGAACTCGGTGTGGGAGAAATAGTAAGTTAACCT	1	bc
TCAACAATCA	GAAACACCGGTGACGCAGAGGTAAGAGTAGGAAGTAGCAAGAAAACCAAA	1	bc
ATTCAATAAA	GAAACACCGGTGAGCAGAGAATGTGGGGTTGAAACTGCAAATAGCCTAAT	1	bc
GGACCATATT	GAAACACCGGTGAGCGTGCTAGCAATAGCGATTTAACCTAAGGATTATCC	1	bc
ATGAAGGTAG	GAAACACCGTGGGTTTATAGCTAGAAATGGGAATATAACCTGAAACTAGA	1	bc
TAGTCTACAG	GAAACACCGGTTATCGTTACGGATTTTTTGGGGTTAGAGCTAAAAATAGC	1	bc
TTAACCCCAA	GAAACACCGGTTTACTTAGAGTGGGGTTAGAGCTAGAAATAGCAAGTTAA	1	bc
CGTTCTGCTT	GAAACACCGGTTGTAGGGACCTCGGTGTGGGAGAAATAGCAAGTTAACCT	1	bc
GCGACAGACG	GAAACACCGGTCCTAGTAGATGAGTTGTGGCGTTAGAGCTAGAAATAGCA	1	bc
CACTTACTAA	GAAACACCGGTTGTAAGTCATCCTGAGTGGGGTTAGAGCTAGAAATAGCA	1	bc
CGGTCAACAT	GAAACACCGGTTTTCCTTACTTCTTTGTGGGGTTAGAGCTAGAAATAGCA	1	bc
ATCTTCCACC	GAAACACCGGTCGTGAATCTGTGCCGGTGGGGTTAGAGCTAGAAATATCA	1	bc
AACTCCCCAA	GAAACACCGGTTGAGGAGAGCTCGGTGTGGCAAGAAAAACAAAGTAAACT	1	bc
TACTCGCACT	GAAACACCGGTTCAACCGGCGTCTTTGTGGGGTTAGAGCTAGAAATAGCA	1	bc
ATATAAAAGA	GAAACACCGGTGAGCGGGGATTATGCGTGGGGAATAACAAGGAAACTGAG	1	bc
AGCAAGCGAC	GAAACACCGGTGTTCTTTGCTCGAGGGTGGGGTTAGAGATAGAAATAGCA	1	bc
ATGTTCGTCC	GAAACACCGGGGGGTTAAATCTAGAAATGGTATATTAATCTAAATAGCGT	1	bc
AAACCCCACA	GAAACACCGGTTGCGAAAGTGTGCAGGGGGGGATAAAGCTCGAAATAGCC	1	bc
TAACGCCATT	GAAACACCGGTTTACTTAGAGTGGGGTTAGAGCTAGAAATAGCAAGATAA	1	bc
TCACACCAAT	GAAACACCGGTGACGCGAGGGTTAGAGCTAGAAATAGCAAGGTAACCTAA	1	bc
ATTACCGTAC	GAAACACCGGTGGCTAAGAGCTAGAAGTGGGGTGATAGCCAGAAGCTGCA	1	bc
GGATCAACAA	GAAACACCGGTGAGAACAGAACTTTTGGGGCTAGAGCTAGAAATATAAAG	1	bc
TCAAATCAAC	GAAACACCGGTGACATGAGGGTTAGTTCTAGAAATATCAAGGTAATCTAA	1	bc
ACTCTAACAC	GAAACACCGGTGACCAACGCATGTCAGTGGGGTTAGAGCTATAAATAGCA	1	bc
CACCCGGATT	GAAACACCGGTCCAACCGGCGTCTTTGGGGGGTTAGAGCTAGAAATAGCA	1	bc
AACATGCTAG	GAAACACCGGTTTTCGATCATAGGTGGGGGTAGAGCTAGCAATAGCAAGT	1	bc
TCAACTTCAT	GAAACACCGGTGGTCTTTGAGCTAGAGTTGGCAAGTTAACCTGAGGATAG	1	bc
AGCAACTAAC	GAAACACCGGTGTTAGTTGCTCGAGGGTGGGGTTAGAGCTAGAAATAGCA	1	bc
AAATGCGACA	GAAACACCGGTTGTGCGCGACTCGGTGTGGGAGAAATAGCAAGATAACCA	1	bc
AAGTGACAGA	GAAACACCGGTGGCAATTCGATCTGAGTGGAGTTCGAGCTAGAACTAGCA	1	bc
AAACCCGTCG	GAAACACAGTGGGGTTAAGGCTATAAATGGCAAGTTAGCCTAAGACTAGT	1	bc
TTAAACAAAA	GAAACACCGGTGGGGTTATAGCTAGAAATAGCAAGTTAACCTAAGGCTAG	1	bc
AAGAGAGACG	GAAACACCGTGGGGTTAGAGCTAGAAATAGGAAGTTAAACTAAGGCTAGT	1	bc
ACTTTAGCAA	GAAACACCGGTTGTGGTGGACTCGGTGTGGGAGAAATAACCTGTTAACCT	1	bc
CATCAACCAA	GAAACACCGGTGGCAATTCGATCTGAGTGGGGTTGGAGCTAGAAATAGCA	1	bc
CAGTTTGCAA	GAAACACCGGTACTCTTTACTCACTTGTGGGGTTAGAGCTAGAAATAGCA	1	bc
CCACCGCACA	GAAACACCGGTTCAACCGGTGTCTTTGTGGGGTTAGAGCTAGAAATAGCA	1	bc
ATGACGCACC	GAAACACCGGTTGGATAGAGCTCTAGAAAGCTTAGTAACAGAAATGGCAA	1	bc
ATGTCGGTAG	ATACCGAAACACCGTGTGGTTAGAACTCGAAGTAGCACGTTAAGCTAGGT	1	bc
CGGCGGGCTG	GAAACACCGGTCGTCGTTCGTAGGGTTAGAGCTAGAAATAGCAAGTTAAC	1	bc
ACAGCACAAG	GAAACACCGGTTTTCGTTCATCTATCGAGATCTTAGTACTCTAAAGCGCA	1	bc
GTGATAGTCG	GAAACACCGTTGGGCTAGAGCTAGAAATCGCAAGTTAACCTCAGGCTAGT	1	bc
AAATATATCA	GTAGCACTGGTAAGAGGTGCTTAGGGGAGGGGGTAAAGATAGAGATAAAA	1	bc
TAATGTGTTC	GAAACACCGGTACTAGTTACTTACAAGTGGGGTTAGAGCTCTAAATCGAA	1	bc
ATGATCTCTG	GAAACACTGTTGGGTTAGAGCTAGAAATAGCAAGTTAACCTAAGGCTAGT	1	bc
TCATCACCCT	GAAACACCGGTGACGCGAGGACGTTGGTGGGGTTCAAGCTAGACCTAGCA	1	bc
AATTGAACCC	GAAACACCGGTTGTATGAAACTAGTTGGGGGGGAAATATATAGATATACT	1	bc
CATCCGTACC	GAAACACCGGTGAAACACGTGTGTTTGGGGTGGTAAAGCTAAGAATAACC	1	bc
TCCAAGCACG	GAAACACCGGTTGAAGCGAGGGCTTTGTGGGGTTAGAGCTAGAAATAGCA	1	bc
GTGTAAACCG	GAAACACCGGTGATCGGTCCTGATTGTTGGGGGTTAGAGGTAGAACTAGC	1	bc
ACTACTCCCT	GAAACACCGGTGACCTTTCTGGTACCGTGGGGATAGAGCTAGAAATAGCA	1	bc
GGACCAGATA	GAAACACCGGTCGTCGTTCGTTGGGGGGGGGTTACAACTAGAAATAGCAT	1	bc
CCTTCAGCAT	GAAACACCGGTATTCGTGGCTCCTATGTGGGGGTAGGGCTATAAAAAGAA	1	bc
TCTTCAGAAG	GAAACACCGGTTTTACTAGATGGTGCGTGGGGTAAAATCAGAAAAAGCAA	1	bc
GCCTTTGAAA	GAAACACCGGTACTAGTTACATCCGGGTGGGGTTAGAGATAGAAATAGCA	1	bc
AGAGAGTCCT	GAGACACCGGTGCTCTTTGGCTGAGAGTGGGGTTAGAGCTAGAAATAGCA	1	bc
AACTTACTAA	GAAACACCGGTGGTAATTCGTAGTGGGTGGGGTTCGAGATGGAAATACCA	1	bc
TTAACCGACT	GAAACACCGGTTGGCTTGGGTTAGAAATAGGAAGAGAAACTAAGACAAGA	1	bc
ATGACAGAAA	GAAACACCGGGGGGTAAGAGCTAGAAGTAGGGAGTGAACTTGAAACAGGT	1	bc
ACAACGGACG	GAAACACCGGTGTTCTTTTTGGGGGCGGGGGGTTAGAGCTAGAAATAGCA	1	bc
ACAAACCAAC	GAAACACCGGTGATGCTAGCTCGAGGGAGGGAGTAAAGGTAGAAAAATCA	1	bc
AATGACAGTC	GAAACACCGTGGGGATAGAGCTAGAAATAGCAAGTTAACCTAAGGATAGT	1	bc
AATTCAAACA	GAAACACCGGTGGCAATTCGATCTGAGTGGGGTTAGAGCTAGAAATAGCA	1	bc
GTAACCGCCG	GAAACACCGTGGGGTTAGAGCTAGAAATAGCAAGTTAACCTAAGGCTAGT	1	bc
CCTCGCCGTA	GAAACACCGGTCGACTGGGTCCACGGGGGGGGTTCTAGCTAGAACTAGCT	1	bc
ATGATCAAAG	GAAACACCGGGGGGCTATAGTTAGAAATAGCAAGATAACCTAAAGTTAGA	1	bc
GTGTTCGACA	GAAACACCGTTGCTAAAATAGCAAGTTAACCTAAGACTAGTCAGTTATCA	1	bc
AGGTGGGCCG	GAAACACCGGTTGTGGGGGCCTCGGAGTGGGAGTAATACCAAGGTAACCT	1	bc
AACAATCCCC	GAAACACCGGTACCCTTTATCGAACGGTGGGGTTAGAGCTAGAAATAGCA	1	bc
GATAACGTAC	GAAACACCGGTAATCTGAAGATCCCCGTGGGGGTAGAGCTAGAAATAGCA	1	bc
ATGACACACG	GAAACACCGGCGGCCATTAGCTCTGAGTGGGGTTAGAGCTAGAAATAGCA	1	bc
AATTCCGTAA	GAAACACCGGTTTTGGGTGACTGGTTGTGGGAGAAATAGCAAGTTAACCT	1	bc
AAAAGGGAAA	GAAACACCGGTTGGGGGGAACTCGGTGTGGGAGAAATAGCAAGTTAACCT	1	bc
TAAACAAACT	GAAACACCGGTTTACTTTGCGTGGGGTTTGGGCTAGAAATAGCAAGTTAA	1	bc
CGGTGGGTTA	GAAACACCGGTACTAGTTACTTGCGGGTGGGGTTAGAGCTAGAAATAGCA	1	bc
TCATTCCTCC	GAAACACCGGTGGCAATTCGATCTGAGTGGGGTTAGAGCTAGAAATAGCA	1	bc
TTCAATGCGA	GAAACACCGGTTTCCGGTAGCTCGTAGTGGGGTTAAGGATGGAAATTGCG	1	bc
CGCACATATA	GAAACACCGGTCGTCGTTCGTAGGAGCGGGGTTACAGCTAGAAATAGCAA	1	bc
AAACCTCTAA	GAAACACCGGTATAGTTTGGTTGGGGGTGGGGTTAGAGATAGAAATAGCA	1	bc
ATGCCCTCCG	GAAACACTGGGGGGTTAGAGCTAGAAATAGCAAGTTAACCTAAGGCTAGT	1	bc
AGGCAGGAAA	GAAACACCGGTGCTATTTGCTCGAGGGTGGGGTTAGAGCTAGAAATAGCA	1	bc
CACTTCCCCC	GAAACACCGGGCTCGAAATAACCTGATAACCTATAGCTAGACCGATATCA	1	bc
GAAACATACA	GAAACACCGGTCCTCGTGATATCGGCCGGGGGTTGAAAGAGAGAATTAAC	1	bc
ACACGCCACC	GAAACACCGGTAGAATGGATCCACGGGTTGGGTTAGAGCTAGAAACAGCA	1	bc
GACCCTGTCA	GAAACACCGGTACTAGTTACTTACGGGTGGGGTTAGAGCTAGAAATAGCA	1	bc
ATCTTCCTCG	GAAACACCGGTCTTGAAACTTAGGCGGTGGGGTTAGAGCTAGAAATAGCA	1	bc
TGAATCAACC	GAAACACCGGTTTTGGTAGATGGTGAGTGGGGGTAGAGCTAGAAATAGCA	1	bc
GCGACCGACG	GAAACACCGTGTGGATAGAGCTAGAATGAGGAAGTTGAGCTAGGGATAGT	1	bc
ATCTACGAAA	GAAACACCGGGGGGATATACCTACAAGTGGGGATATAACCAGAAACAGCA	1	bc
TCCGCAAACC	GAAACACCGGTGGGGATAGAGTTATAAATGGGATTGTAACATAAAGCAGC	1	bc
AATACCCTCC	GAAACACAGGTAATCTACATATACCCGTGGGGATAGAGCTAGAACTATCA	1	bc
TGCTCCTCAA	GAAACACCGGTGAGAACAGTACTTTTGGGGGTATAGCTAGAAATAGCAAG	1	bc
GATAACTCCC	GAAACACCGGTAATCTAAAGATCTCCGTGGGGATAGAGCTAGAAATAGCA	1	bc
GACTCTATCC	GAAACACCGGTACTCTTAACTTACAAGTGGGGTTGGAGCTAGAAATAGCA	1	bc
GAGTCAAATA	GAAACACCGGTTATCGTTACGGATTTTGTGGGGTTAGAGCTAGAAATAGC	1	bc
ATGAATGCGA	GAAACACCTGTGCCCTTTATGGGACAGAGGGGTTGGAGATAGAAATAGCA	1	bc
GGCAACTACG	GAAACACCGGTGGCAGCCAGCCACTTGTGGGGTTAGAGCTAGAAATAGCA	1	bc
GTCTAACAAA	GAAACACCGGTGTTCGGAGATTATGCGTGGGAAATGAGAAGTAACCTAAA	1	bc
TAGACAAAAT	GAAACACCGGTTGGCTTTACTCATTTGTGGGGTTAGAGCTATAAATAGCA	1	bc
ACTTTTTTAA	GAAACACCGGTGAGAATAGATTACTAATTGGTAATTAAACCTAGGGTTCT	1	bc
ATCAACGTAA	GAAACACCGGGACTAGAGAGCTAGGAATGGCAAGATAACCTAAAACTAGA	1	bc
CATTTACACC	GAAACACCGGTCGCAATACGATCTGAGTGGGGTTGAACCTAGAAAAGCAA	1	bc
AGGACAGAAG	GAAACACCGTTGGGGTAGAGCCAAGAATAGGAAGTTAACCTAAGGATAGT	1	bc
AAGTAACGCG	GAAACACCGGGGGGCTAGAGCTAGAAATAGTAAGTAAACCCAAGTCTAGT	1	bc
GATAACCACA	GAAACACCGGTGATCTAGAGATCGCAGGTGGGATAAAGGTAGGAATAGCA	1	bc
ATAAAACAAC	GAAACACCGGTGGTCTGCGCTGGATTGTGGGGTTAGAGCTAGAAATAGCA	1	bc
ACCCTCGCCA	GAATCACCGGTACAACTTGCGTATTTGTGGGGTTAGAGCTAGAAATAGCA	1	bc
AATAGCGAAA	GAAACACCGGTTTACTTAGATTCGTTGTGGGGGTAAAAGCAGAATTAGCT	1	bc
TGCTCATCAT	GAAACACCGGTGAGCACAGAACGGGGGTAGAGCTAGAAATAGCAAGATAA	1	bc
CGTTACTCAC	GAAACACCGGTGAGAACAGAACTTTTGGGGGTAGAGCTAGAGATAGAAAG	1	bc
ATCAGACAGA	GAAACACCGGTGCGCGGAGATTAGAAGTGAGCAATCAAAAGTAAGAAAAG	1	bc
AACACGGAAT	GAAACACCGGTTTAGTTGAAGTGGGGGTGGGGGTAGAAATAAGAAAATAA	1	bc
GAGATATATG	GAAACACCTGTTATTTTTTCGGTATTTTTGGCTTTATAGCTAGAGATTGC	1	bc
CGTACCCTCA	GAAACACCGGTGATCACATAACTTTTGGGGTTAGAGCTAGAAATAGCAAG	1	bc
TCCACGTACC	GAAACACCGGTTCCCGTTAGCTCGTGGGGTTAGAGCTAGAGATAGCAAGT	1	bc
TGTAACGCTG	GAAACACGTGGGGTCTATATAGACATGGGGGGTTAAAGTAAGTCACAGCC	1	bc
TCCTTCACAC	GAAACACCGGTGGCATTTCGATCTGAGTGGGGTTAGAGCTAGAAATAGCA	1	bc
CATAAACCCA	GAAACACCGGTTTACTTAGAGTGGGGTTAGAGCTAGAAATAGCAAGTTAA	1	bc
CGATTAAATT	GAAACACCGGTGCTAATAGTTAGCTCGTGGGGATAGAGCTAGAAATAGCA	1	bc
CCCCTACGAC	GAAACACCGGTACTATTAGTTCACGGGTGGGGTTAGAGCTAGAAATAGCA	1	bc
GAGTACACCC	GAAACACCGGTAATCTAAAGATCCCCGAGGGCATAGAGGTAGTAATATTA	1	bc
CAACAAGTAA	GAAACACCGGTACTAGTTGCTTCCGGGTGGGGTTAGAGCTAGAAATAGCA	1	bc
AATCCACCTA	GAAACACCGGTGTTGATTGGATCTGAGTGGGGTGAAAGATCAAATTACCA	1	bc
GCATCTGTAA	GAAACACCGGTAGTGGTTGATCAAGGATTGGTATAGAGCTATAAATCGAG	1	bc
TCAAGCGTCA	GAAACACCGGTGACACGAGGGTTAGAGCTAGAAATAGCAAGTTAACATAA	1	bc
GACTATCACC	GAAACACCGGTACAACCTGCTTCTGTGTGGGGTTAGAGCTAGAAATAGCA	1	bc
GCATATCTCA	GAAACACCGGTGATGCTAGCTTGCGGGGGGGGTAAGGGCAGAAATAGGCA	1	bc
GTCTTTGTCA	GAAACACCGGTAGCGGTAACGTTCGGGTGGGGTTAGAGCTGGAAATAGCA	1	bc
CACCGCCGAA	GAAACACCGGTAGAATGGATCCACGGGTGGGGTTAAAGCTAGATATAGCA	1	bc
CAACCAGCTT	GAAACACCGGTTTTAGCAAAAGTGGGGTTAGAGCTAGAAATAGCAAGTTA	1	bc
CCCTCGAAAA	GAAACACCGGTTGAATCGGAGTCTTTGTGGGCATAGAGCCAGAAATCGAA	1	bc
AAATGCGTAA	GAAACACCGGTTGTGGGGGACTCGGAGTGGGATTAATAGTAGAAATACCT	1	bc
AAGAGGGTCA	GAAACACCGTGGGGGTAGAGCTAGAAATAGGAAGAAAATCTAAGTATAGT	1	bc
ACTAACGACG	GAAACACCGGTGGCCTTTATGGGACCGTGGGGTTAGAGCTAGAAATAGAA	1	bc
TACACCTACT	GAAACACCGGTTTTCTTAGCGTGGGGTTAGAGCTAGAATAAGCAAGTTAA	1	bc
GAAGCAACCA	GAAACACCGGTTTTAGTAAATGGAGAGTGGGGTTAGAGCTAGAAATCTCA	1	bc
GTGGGCGAGA	GAAACACCGGTGAGATGCCTCAAGTGCTAGAAATAGCAAGTTAACCTAAG	1	bc
