GTAACAGTCG	GAAACACCGGTCCTAGAAGATGAGGTGTGGGGTTAGAGCTAGAAATAGCA	1	bc
CCGTTTGCAA	GAAACACCGGTTCTATTTACTTACGTGTGGGGTTAGAGCTAGAAATAGCA	1	bc
GAAAAATTCC	GAAACACCGGTAATCTAAAGATCCCCGAGGGGTTAGAGCTTGAACTAGCA	1	bc
TTACCTCTCT	GAAACACCGGTTGTAAGCGATGGTTTGTGGGGGTAGAGCAAGATATAGCA	1	bc
TATTATGTAT	GAAACACCGGTACTGGTAGATTACGGGAGAGCAATGCACTCGAATAAGTA	1	bc
GCCATAACCC	GAAACACCGGCGGCGTTTGGTTATAGCTAGAAATAGCAATTTAACCTAAG	1	bc
GAGCGAGGTG	GAAACACCGGTTATCGTGACGTATTTGTGGGGTTAGAGCTAGAAATAGCA	1	bc
TACTATGAGA	GAAACACCGGTACTAGTTGGTTACGGGTAGGAATAGCACTATAACTAACA	1	bc
ACATTATCAA	GAAACACCGGTGCCAATTAGATCTGAGTGGGGTTAGAGCTAGAAATAGCA	1	bc
TATCCACAAT	GAAACACCGGTCTCCATTGGATCTGCGTGGGGTAGAGCTTGGAAATAGCA	1	bc
CCGTCAGCAG	GAAACACCGGTTGTCGTTACTCGTTTGTGGGGTTAGAGCTAGAAATAGCA	1	bc
GTCAACTACG	GAAACACCGGTTGCTAGAAATAGCAAGTTAACCTAAGGCTGGTCCGTTAT	1	bc
TCCCGCCTCT	GAAACACCGGTGACGCGAGGACAGGGGTGGGGTTAGAGCTAGAAATAGCA	1	bc
ATGTCAACAC	GAAACACCGGTTGGAGTTACTGATTTGGGGGGTTAGAGCTTAAAAAAGCC	1	bc
TCGACCGACA	GAAACACCGGTGGGATAAGATGAATTGCTGGGTAGTTGCTCGAAAGCCCG	1	bc
GCATCTTAAA	GAAACACCGGTGAGCGTTACCTAAGAATAGGAATCTAACTCTAAGTTACA	1	bc
GACTCTATAG	GAAACACCGGTACTCGTTACTTACGGGTGGGGTTAGAGCTAGAAATAGCA	1	bc
AGTTAATAAA	GAAACACCTGTGAGAATAGAACGTTTTGGGGTTAGAGCTAGAAATAGCAA	1	bc
AAATTCATTA	GAAACACCGGTTTAGTATGGAGGGCAGTGGGGTTAGAGCTAGAAATAGCA	1	bc
AAGCAGCACC	GAACCACCGGTGATCTTTACGGATGAGAGGTGTTAGAGCAAGAAATAGCA	1	bc
ACTAAACCAC	GAAACACCGGTGCTCTTTACTCGACCGTGGGGTTAGAGCTAGAAATAGCA	1	bc
CATTGGGCCC	GAAACACCGGTTGTAGGGATCTACGGGTGGGGTTAGTGCTAGGTTTAGCT	1	bc
GTAATGCATC	GAAACACCGGTGAGCATGATAACGTCCGTGGGTTTAGAGCTAGAAATGGC	1	bc
CAATCACACC	GAAACACCGGTTGCAATTAGCTCTGAGTGGGGTTAAAGCTAGAAATAGCA	1	bc
AAGTGGACAG	GAAACACCGGTTGTGGGGAACTCTGGGAGTGAGAAGTAAACAGATGGCTT	1	bc
GGAAAAGATG	GAAACACCGGTTGTGGGGAACTCGGTGTGGGAGAAATAGCAAGTTAACCT	1	bc
GCCCAGATCA	GAAACACCGGCGGCGTGGGGATAGAGCTAGGAATAGCAAGATAACCAAAG	1	bc
GGTAACGATT	GAAACACCGGTCGTTCTTAATAGCAAGTTGAGTAGAGCTAGGAATATTAA	1	bc
AAATCATCCA	CTAGACACCGGTTTTTAACCTATGTGTAGTAGGTTATCTATATGAATAAA	1	bc
GAAATCTCAA	GAAACACCGGTAATCGAGAGATCGGCGTGGGGGTAGAGCTAGAAATAGCT	1	bc
ATGACAGAAG	GAAACACCGGTCCTAGAAGCTGAGTTGTGGGGTTAGAGCTAGAGATAGCA	1	bc
CACAGGCCCC	GAAACACCGGTAGATGGGATCTCCGTGTGGGGGTAAAAGCAGAATTAGCT	1	bc
TCCTTCACCC	GAAACACCGGTGGCGATAGTGCGCGAAAGGGCATGTAAACAGAAATATAA	1	bc
CACAGAGTAT	GAAACACCGGTGCTCGCGGATTCGACGTGGGGTTAGAGCTAGAAATAGCA	1	bc
GTGAGCTCGA	GAAACACCGGTGGGGGTAGAGCTAGAAATTTCAAGTTAACCTAAGGCTAG	1	bc
CCTTCACACT	GAAACCCCGGTGGCAATTCTGTCTGAGTGGCGTTAGAGCTCGAATTGGCA	1	bc
AAAAAACGCC	GAAACACCGGTTGAGATAATCAAAAAGTGGGGTAGAGCTAGAAATAGCAA	1	bc
AACTTGATAC	GAAACACCGGTTGTCTTTCATAGGTCGTGGGGTTATAGCTATAAATAGCA	1	bc
TGCTATGAAA	GAAACACCGGTACTAGTGACTTACGGGTGGGGTTAGGGCTAGAAATATCA	1	bc
ATCATCAAAA	ACGTACGAAACACCGGTGGGGTTAGAGCTAGAAATAGCAAGTTAACCTAA	1	bc
GAACTCTAGA	GAAACACCGGTGAGCATGGTAACGTCCGGGGGGTTAGGGCTAGAAATAGC	1	bc
AAATTCACCC	GAAACACCAGTTGAGATAGGGTGGAGGTGGGATTAGAACTATAAACTAAA	1	bc
CATCGGGCTG	GAAACACCGGTCGTCTTTAGTAGGGCGTGGGGTTAGAGCTAGAAATAGCA	1	bc
TTCTTCTCCC	GAAACACCGGTGGCGCTTAGATTTGAGTGGGGGTAGAGCTATAAATAGCA	1	bc
ATACCATATC	GAAACACCGGTGAGCATGGTAACGTCCGTGGGGTTAGAGCTAGAAATAGC	1	bc
ATTCAATACT	GAAACACCTGTTGTAAGCGATGGTTTGTGGGGTTAGAGCTAGAAATATCA	1	bc
AAGAAAATAA	GAAACACCGGTGTTCTTTGCTCGAGGGTGGGGTTATAGCTAGAAATAGCA	1	bc
AGATAGTCAC	GAAACACCGGTGATCTTCGCTCGAGGGTGGGGTTTGAGCTAAAAATATCA	1	bc
TAGATCAAAT	GAAACACCGGTTGGCTTAATTCACTTGTGGGGTTAGAGCTATAAATAGCA	1	bc
GAATAACCAG	GAAACACCGGTTTTAGTTAATGCTGAGTGTGGTTATAGCTAGAAATACCA	1	bc
GAAAAAGCCT	GTAACACCGGTTTTAGTAAATGGTGAGTGGGTTTAGAGCTAGAAATAGCA	1	bc
TCCACATCAT	GAAACACCGGTTCTAGTTAATTCGTAGTGGGTTTAGAGCTAGAAATATCA	1	bc
AATTTAGACA	GAAACACCTGTGCTCTTAGTTGGCCCGTGGGGTTAGAGCTAGAAATAGCA	1	bc
GCACTCGCCA	GAAACACCGGTGCTCTTTGCTCGAGGGTGGGGCTAGAACTAGAAATAGCA	1	bc
ATAAACCCCA	GAAACACCGGTTTACTTAGTTAACTAGTGGGGTTAGAGCTAGAAATAGCA	1	bc
ATGAACGCCC	GAAACACCGGTAATAGAAGGTGAGTTGTGGGGATAGAGCTAGAAATAGCA	1	bc
ACAACGAGAC	GAAACACCGGTGCTAGCGGTTTCGAAGTGGGGTAAGAGCTAAAATAAGAA	1	bc
CCGGTCGCAC	GAAACACCGGTTGGCTTTACTCCTTTGTGGGAATAGAGCTATAAATATCA	1	bc
ATAAAGTATC	GAAACACCGGTGTGCTTTGCTCGAGGGTGGGGTTATAGCTAGAAATAGCA	1	bc
AAAACCCACG	GAAACACCGGTCTACTTAGTTAACTAGTGGGGTTAGAGCTAGAAATAGCA	1	bc
TAAGGAGTCC	GAAACACCGGTTGAGATAATCAAAAAGTAGAAAAGAGCTATAAATAGAAG	1	bc
AACTCGCCAC	GAAACACCGGTACTAGTTACTTACGGGTGGGGTTAGAGCTAGAAATAGCA	1	bc
GTACTATAAC	GAAACACCGGTGAGCATGATACCGTCGTGGGGTTAGAGCTATAAATAGCA	1	bc
ATACAACAGA	GAAACACCGGTGTGCTGAGATCGTGCGTGGGATAAGGCATGGAACTAACG	1	bc
GAGGCAAACC	GAAACACCGGTTATCGTTACGGATTTGTGGGGTTAGAGCTAGAAATAGCA	1	bc
GATGGCGACA	GAAACACCGGTGAGATGCGTGTTACAGTGGGGTTAGTGCTAGAAAGAGTA	1	bc
CCGTCAGCCC	GAAACACCGGTCGTAGAAGCTGGTGTTTGGCCTAGGAGTTGCAAGTTGCC	1	bc
AAATACACAA	GAAACACCGGTTGAGGATGGAGGGAAGGGGGGTTAGAGCTAGAAATAGCA	1	bc
ATACAGTATC	GAAACACCGGTGTGCTTTGCTCGAGGTTGGGATTAGAGCTTGAAATAGCA	1	bc
CACTCCCAAC	GAAACACCGGTAGCATGTCGATCCGAGTGGGGGTAGAGCTAGAAGTAGCA	1	bc
TATAAAGCTT	GAAACACCGGTCTTCCTGGTGTATACGTGGGGTAGAGCTAGAAATAGCAA	1	bc
CAGTCGCGCC	GAAACACCGGTTAGACCTGGAACTTGCGAGGTAACATAGGGATAGTCAGT	1	bc
CTGACAGTAG	GAAAAACCGGTCCTAGAAGCTGAGTTGTGGGGTTAGAGCTAGAAATAGCA	1	bc
AAACACGTAA	GAAACACCGGTTTTGGATGGTTAGGGGTGGGGTTAGAGCTAGAAATAGCA	1	bc
TATACCAAGC	GAAACACCGGTTTACTGAGTTAACTAGTGGGGTTAGAGCTAGAAATAGCA	1	bc
AGGCCTATCT	GAAACACCGGTTCCGGTTGGCGCGTAGGGGGAGAGCTAGAAATAGCAAGT	1	bc
CCAGTAAGAA	GAAACACCGGTGGGGTTAGCTCTATAGATAGGTTATAAATATAAGTATAG	1	bc
TTCTTCTCCC	GAAACACCGGTCGCGAAAATGGGGGGGTAGAGCTAGAAATAGCAAGTTAA	1	bc
ACGAATGCCC	GAAACACCGGTACGCTTTATTCGTTCGTGGGGTTAGAGCTAGAAATAGCA	1	bc
AATATTACCA	GAAACACCGGTTGAGTTAATCAAAAAGTGGGGTAGAGCTAGAAATAGCCA	1	bc
ATACACCACC	GAAACACCGGTGTTCTTTGCTCGAGGGTGGGGTTAGAGCTAGAAATAGCA	1	bc
GACTAATAAA	GAAACACCGGTGATAATTATATGGGCGTGGGGTTAGAGCTAGAAATAGCA	1	bc
CACCGTGAAA	GAAACACCGGTGCTAGCGGCTTCGAAGTGGGGTTAGAGCTAGAAATAGCG	1	bc
GTATAATCTA	GAAACACCGGTGAGCGGAACTTCTGCGTGGGAATTAGCACGTAACCTAAG	1	bc
GGATTTCAGC	GAAACACCGGTCTTCCTGGAATCTACGTGGGGTAGAGCTAGAAATAGCAA	1	bc
AGAATCAGCA	GAAACACCGGTCCTAGAAGCTGAGTTGTGGGGTTAGAGCTAGAAATAGCA	1	bc
CCGTTCCCCC	GAAACACCGGTTGGCTTTACTCCTTTGTGTGGTTAGAGCTATAAATAGCA	1	bc
GTGTGAGCTA	GAAACACCGGTGAGGTTCATGTTAACCTAGGGCTGGTCCGTTATCAGCTT	1	bc
GGCTAAGAAA	GAAACACCGGTCCTCCTGGAATCCGGGGGGGGAGAGAGAGAAATGGCACG	1	bc
AAGTCAACCC	GAAACACCGGTGATCGACGCGTGTTTGTGGGGTTAGAGCTAGAAATAGCA	1	bc
GCATAAAGCA	GAAACACCGGTGGCGATAGGTTATAGCTAGAAATAGAAAGATAACCTACG	1	bc
ACGTTACCAA	GAAACACCGGTTGGCTTTAATTCTTTGTGGGGATAGAGATATAAATTGAA	1	bc
ATGTTCAGCT	GAAACACCGGTCCTAGAAGATGAGTTGTGGGGTTAGAGCTAGAAATAGCA	1	bc
TGTGACCATC	GAAACACCGGTCTTCCTGGAATCTACGTGGGGTAGAGCTAGAAATAGCAA	1	bc
GTATCTGTAA	GAAACACCGGTACTAGTTACTTACGGGTGGGGTTAGAGCTAGAAATAGCA	1	bc
GATTCATGAA	GAAACACCGGTGAGAACAGAGCGTTTGGGGGTTAGAGCTAGAAATAGTCA	1	bc
AGACCACAAA	GAAACACCGGTGTTCTTTGGTTGATGGTGGGGTTAGAGCTAGAAATAGCA	1	bc
TAGTCAACCC	GAAACACCGGTTACCCTTGCTCCTTTGTGGGGCTAGAAATATCAATATAA	1	bc
GACACACTAC	GAAACACAGGTAATCTAAAGATCCCCGTGGGGATAGAGCTAGAAATAGCA	1	bc
AAAAAATAAA	GAAACACCGGTGAGCATGGTGACGAGCGCGGGGTTAAAGCTAGTAATATC	1	bc
ATACAACAGA	GAAACACCGGTTGGAAGAGATGGTTTGTGGGGTTATAGCTAGGAATAGCA	1	bc
CAACGGATGA	ATTGTCGATACACCGTTCGTCGTTCGTAGGGCGTGGGGTTAGAGTTAGAA	1	bc
