AAACCACACT	GAAACACCGGTTCAATATGGTGCGTAGTGGGGTTAGAGCTAGAAATAGCA	1
AAATCAGCAA	GAAACACCGGTGAGGACAGAACTAGATAGGGCAAGATCTAGAAATAGCAA	1
AAATGACCCA	GAAACACCGGTTATGGTAGGCCCTTAGAGCTAGAAATAGCAAGTTAACCT	1
AACTTACCGA	GAAACACCGGTGTTCGTAGTTTGTGCGTGGGATATAGCAAACAAACTAAG	1
AACTTGCTAA	GAAACACCGGTTTCCATTCGTACGTCGTGGGGTTAGAGCTAGAAATAGCA	1
AATAAGGAAG	GAAACACCGGTGCCCTTTGTGGGACCGGGGGGTTAGAGCTAGAAATAGCA	1
AATACATCCC	GAAACACCGGTGCCCGTCGGCTGTCAGGGGTAGTAGAGCTAGAAATAACA	1
AATCCAGCAC	GAAACACCGGTGACAAACGTATGTCAGTGGGGTTAGAGCTAGAAATAGCA	1
AATCCATCAC	GAAACACCGGTTTTAGTAAATGGTGAGTGGGGTTAGAGCTAGAAATAGCG	1
AATTGGCCAA	GAAACACCGGTTGTCGGTAAGGCGGTGTGGGATTAATAGCAGGATTAGCA	1
AATTGGGCAA	GAAACACCGGTTGTGGGGAACTCGGTGTGGGAGAAATAGCAAGTTAACCT	1
ACATCAACAA	GAAACACCGGTGGGGTTAGATCTAGAAAGAGCAAGTTAACCTAAGTATAG	1
AGCCAAAAGC	GAAACACCGGTTCAACCGGCGTCTTTTGTGGGGTTAGAGCGAGAAATAGC	1
AGTCCGCAAC	GACACACCGGTGATCTTTGCTCGAGGGTGGGGTTAGAGCTAGAAATAGCA	1
ATACCAAGCG	GAAACACCGGTTATCATCGACGATTTGTGGGGTTAGAGCTAGAAATAGCA	1
ATCTAAGCAA	GAAACACCGGTACTAGTTACTTACGGGTGGGGTTAGAGCTAGAAATAGCA	1
ATGACCGTCG	GAAACACCGGTCCTAGAAGCTGCTTTAGAGCTTGAAATCGCGACAAGTTA	1
ATGATAGTCG	GAAACACCGGTCCTCGAAGCTGAGTTAGAGGTAGAAATAGAAACATGTTA	1
ATGTAAGCGA	GAAACACCGGTGCGCGGAGATAAGGCGGGGGTAGTAACAGGAAACCTAAC	1
CAACGAGATT	GAAACACCGGTGCTAGCGGTTTCGAAGTGGGGTTAGAGCTAGAAATAGCA	1
CATTGGGAAA	GAAACACCGGTGGCGGGGAAATCGGAGTGGGGGTAGTGCTAAGATAAGCT	1
CCCCGCCGCC	GAAACACCGTTAGAATGGATCCACGGGTGGGGTTAGAGCTAGAAATAGCA	1
CCCTCGCACC	GAAACACCGGTTCAACCGGCGTCTTTTGTGGGGTTAGAGCTAGAAATAGC	1
CCCTCGCCCC	GAAACACCGGTTCAACCTGCTCCTTTTGTGGGGTTAGAGCTAGAAATACC	1
CGGCGGGCCG	GAAACACCGGTCGTCGTTCGTGGGGTTAGAGCTAGAAATAGCAAGTTAAC	1
CGGTTAACTC	GAAACACCGGTTGGCTTTACTCCTTTGTGGGATTAGAGCTATAAATAGCA	1
CGTTCAGAAA	GAAACACCGGTCTCACTTGGATCTGCGTGGGGTAGAGCTAGAAAAAGGAA	1
CTGACCGTCG	GAAACACCGGTCCTAGAAGCTGGGTTAGAGCTAGAAATAGCAAGTTAACC	1
CTTGAATCAA	GAAACACCGGTGAGCACAGGACGTTTTGGGGTTAGAGCTAGAAATAGCAA	1
GAATATGTAA	GAAACACCGGTACTAGTTACTTACGGGTGGGGTTAGAGCTAGAAATAGCA	1
GAATCAGCCG	GAAACACCGGTCTTAGTAAATGGTGAGTGGGGTTAGAACTAGAAATAGCA	1
GAATCAGCGG	GAAAAACCGGTTTTAGGAAATGGTGAGTGGGGTTAGAGTTAGAAATAGCA	1
GACTATGTAA	GAAACACCGGTACTAGGCGCTTACTGGTGGGGTTAGAGCTAGAAATAGCA	1
GACTATGTAA	GAAACACCGGTACTAGTTACTTACGGGTGGGGTTAGAGCTAGAAATAGCA	1
GACTATGTAA	GAAACACCGGTACTCGTTACTTACGGGTGGGGTTAGAGCTAGAAATAGCA	1
GACTATTTAA	GAAACACCGGTACTCGTTACTTACGGGTGGGGTTAGAGCTAGAAATAGCA	1
GACTCTGTAA	GAAACACCGGTTCTCGTTACTTACGGGTGGGGTTAGAGCTAGAAATAGCA	1
GTAATATATA	GAAACACAGGTGGCAATTCGATCTGAGTGAGGTTAGAGCTAGAAATAGCA	1
GTGGGCGAGA	GAAACACCGGTGAGATGCCTCAAGTGGGTGGGGTTAGAGCTAGAAATAGC	1
GTGGGCGAGA	GAAACACCGGTGGGGTTAGAGCTAGAAATAGCAAGTTAACCTAAGGCGAG	1
GTGGGCGAGA	GAAACACCGGTGGGGTTAGAGCTAGAAATAGCAAGTTAACCTAAGGCTAG	1
TAAACACAAT	GAAACACCGGTTTACTTAGTTAACTAGTGGGGTTAGAGCTAGAAATAGCA	1
TAATTAATCC	GAAACACCGGTTGAGATAATCAAAAAGTGGGGTAGAGCTAGAAATGGCAA	1
TCGTCAACAT	GAAACACCGGTTGCCTTTAGCTCTTTGTGGGGTTAGAGCTAGAAATAGCA	1
TGAACAGATT	GAAACACCGGTCTTCTTTGAATCAACGTGTGGTAAGGCTAGAAATAGCAA	1
TGAACCCTCT	GAAACACCGGTGACGCGAGGGTTAGGGCTAGAAATAGAAAGTTAACCTGA	1
TGATTATACC	GAAACACCGGTGGAAGGGGTTAGAGCTAGAAATAGCAAGTTAAACTAAGG	1
TGCCCAGATT	GAAACACCGGTCTTCCTGGAATCTAGGTGGGGTAGAGCTAGAAATAGCAA	1
