ATGCCCAGAT	GAAACACCGGTCTTCCTGGAATCAGCAAGTTAACCTAAGGCTAGTCCATT	2	bc
GTGGGCGAGA	GAAACACCGGTGAGATGCCTCAAGTGCTAGAAATAGCAAGTTAACCTAAG	2	bc
TTATTCTTCA	GAAACACCTGTCACGAAAGGGTGGCAGAGGGGGGTGAGAGCTAAATAGAA	1	bc
CCCTCATACA	GAAACACCGGTTCGAACAGCACGTTTTGGGGGGTTAGAGCTAGAAATAGA	1	bc
GGCAATACCT	GAAACACCGGTGGGGTTAGAGCTAGAAATAGCAAGTTAACCTAAGGCTAG	1	bc
AATTCTGCAG	GAAACACCGGTGCCCTTTATGGGACCGCGGGGTTAGAGCTAGAAATAGCA	1	bc
TGAACAGCCT	GAAACACCGGTTTCAGTTAGTTGGGGGGGGGAGAGCTAGAAAAAGTAAGA	1	bc
ACAACTAACA	CTAAACACCGGTGGGCTTAGAGCTACCAATGGCAAGTTAACCTAAATCTC	1	bc
ATCTCACCCT	GAAACACCGGTTGCAAGCGATTGTTTGTGGGGTTAGAGATAGAAATAGCA	1	bc
TAAGCAATAC	GACACACCGGTGGGGTTAGAGCTAGAAATAGCAAGTTAACCTAAGGCTAG	1	bc
AAATTGTCTA	GAAACACCGGTTGTGTTGGACTCGGACTTGGAGAAATAGCATGTTACCCT	1	bc
TAATCCCCCC	GAAACACCGGTTTACTTAGTTAGCGAGTGGGGTTAGAGCTAGAAATAGCA	1	bc
GATACATCCA	GAAACACCGGTAAGATCAAGATCCCCGTGGGATAGAGCTGGAAATAGCAA	1	bc
CTGATAACAA	GAAACACCGGTTAGCTTGACTACAGTGTGGGGTTAGAGCTATAAATAGCA	1	bc
AACCCACAAC	GAAACACCGGTGACAAACGTATGACAGTGGGGTTAGAGCTATAAATAGCA	1	bc
TCATTAACAA	GAAACACCGGTGGCAATTCGATCTGAGTGGGGTTAGAGCTAGAAATAGCA	1	bc
GCGGTAGCAC	GAAACACCGGTTGGCTTTGCTCCTTTGTGGGGTTAGAGCTATAAATAGCA	1	bc
ATCTACCCCC	CTAAACACCGGTGTGCTGAGATTATGCGTGAGAAATAGCAAGTAACCTAA	1	bc
GACCGAGCCC	GAAACACCGGTTTTAAGGAATGGCGAGTGGGGTTAGAGCTAGAAATAGGA	1	bc
TACACCTACT	GAAACACCGGTTTCCTTAGTTAACTAGTGGGGTTAGAGCTAGAAATAGCA	1	bc
TCAAAGAAAA	GAAACACCGGTGGGCTTAGAGCTAGAGTGGGGATAGAGCTCGAAATATCG	1	bc
GCAACAAACA	GAAACACCGGTGAGCTTAGTGCTAGAAATGGGAATTTAACATAAGGCTAA	1	bc
ATCAAAGTCG	GACACACCGGTGTGAGGAGATTATGCGTGAGAAATAGCAAGTAACCTAAG	1	bc
GTGGGCGAGA	GAAACACCGGTGATAGGCCTCAAGTGCTGGGAGTAGCAAGTTAACCTAAG	1	bc
TCATTAAACT	GAAACACCGGTGATACGAGTAAGTTAGTGGTGGTAAAAGCAAAAAAAGCT	1	bc
AAAACACTCT	GAAACACCGGTGGCGAAACTGTGTCGGTGGGGTTAGAGCTAAAAATAGCA	1	bc
CAGCCAAGCC	GAAACACCGGTTATCGTTACGTATTAGTGTTAGTAACAGCATGTTCTCCT	1	bc
TAAAGAGTCT	GAAACACCGGTGACGCGAGAACGTTAGATCTAGAAATAGCAAGTTAACCT	1	bc
TCCAAACTCT	GAAACACCGGTGACGCGAGGACGTTAGAGCTAGAAATAGCGAGTTAACAT	1	bc
AAAACACCCC	GAAACACCGGTTTTCGATCATAAGGCTAGTCCGTTATCAACTTGAAGCAG	1	bc
TCAGGCCGCC	GAAACACCGGTGGAGTTAGAGCTAGAAATGGCAAGTTAACCTAAATATAG	1	bc
ACCCAACGGA	GAAATACCGGTGGGCGGAGTCCACGCGTGGGAAATAGGATGGAAATAAAA	1	bc
GTATCACCCT	GAAACACCGGTTTTAGTAAATGGTGAGTGGGGTTAGAGCTAGAAATAGCA	1	bc
AAAATCCTCG	GAAACACCGGTTTTCGGTCATCGTGCTAGTCCGTTGTCCACTTGAAGACG	1	bc
TCTTCAGCAT	GAAACACCGGTCTTCCTGACATCTTTGAGTTAATATAGCTCTAGACCGCT	1	bc
TACAACTCCC	GAAACACCGGTATCTAAAGATCTCCGTGGGGATAGAGCTAGAAATAGCAA	1	bc
AGCTAGCACC	GAAACACCGGTGCAACCGGCGTCTGTTGGGGGGTTGGGGCTGGAAATGTC	1	bc
GGCCAGGAAA	GAAACACCTGTAATAGTTACTTAAGGGAGGGGTTAGCGCTAGAAATAGCA	1	bc
GAAAAATCCC	GAAACACCGGTAATCAAAAGATCGTCGGGGGTTTAGAGCTGGAAATACGA	1	bc
TCACAGAGAT	GAAACACCGGTGCTAGCGGTTTCGAAGTGGGGTTGGAGCTAGAAATAGCA	1	bc
GAATTCGTCG	GAAACACCGGTTTTCGTAAATGCCGAGTGTGGTTAGAGCTAGAAATAGCA	1	bc
TTCTCCCTGT	GAAACACCGGTCTTCCTAGAATCAGCACGATAACCTAAGGGTAATCCGTT	1	bc
CGGTGGGTCC	GAAACACCGGTCGTAGTTGGGGGGGTTAGAGCTAGAGATAGCAAACTAAC	1	bc
AAACACCTGC	GAAACACCGGTATTCTAAGGAGCGCAAGGGGGATTAAGGCAAAAAAAGGC	1	bc
GCCACAAACG	GAAACACCGGTTGCGATAAATCTCAAGATAACCTAATACCCGTCCGTTAT	1	bc
CCCTCTGACA	GAAACACCGGTCCAAGCGGCGTATTTTGTGGGGTTAGAGATAAAAATAGC	1	bc
GACAAAGTCG	GAAACACCGGTAATCTAAAGATCCGCGTGGGGATAGAGCTAGAAATAGCA	1	bc
CCATCCCTCC	GAAACACCGGTTACGCCAGGACGTTAGATCTAGATATAGCAAGTTAACCT	1	bc
ATGATCTTAG	GAAACACCGGTCCTAGAATCTGAGTTAGTGCTAGAAATAGCAAGTTCAAC	1	bc
CCCCCCTCCC	GAAACACAACGTGGTTAGAGCTAGAAATAGCAAGTTAACCTAAGGCTAGT	1	bc
CTACCCCACC	GAAACACCGGTTGTAAGCGATGGTTTGTGGGGTTAGAGCTAGAAATAGCA	1	bc
ACCTCCATCA	GAAACACCGGTGCCACCCGCGTGTCATTGGGGTTATGGCTAGAAATAGCC	1	bc
ATGATAGCCG	GAAACACCGGTTGTCTTAGCTGCGTTGGGGGTTGAGATCGATAGATAACA	1	bc
CACTTACTAG	GAAACACCGGTGATCAATCATCGTTTGGGGGTTTAGCTCTAAATATCAAG	1	bc
AAACGCATTT	GAAACACCGGTTTAGTATGGAGAGAAGGGGGGTTAGAGCTAGGCATAGCA	1	bc
AGAGCAACCC	GAAACACCGGTGTTCTTTGCTCGAGGGTGGGGTTAGAGCTAGAAATAGCA	1	bc
AGCAACGTCG	GAAACACCGGTGGGTTGAAATAGCAAGTTAACCTGAGGATGGTCCGTTAT	1	bc
ATCATCACTC	GAAACACCGGTTGCGATAGTAAGATAGAGGGGGAGAGATAGAGATAGCCT	1	bc
TCAGCCCTAC	GAAACACCGGTGGGGTTAGAGCTAGAAATGGCAAGTTAACCTAAGGCTAG	1	bc
ACACCAATCA	GAAACACCGGTTTAGGCCGTAGGGAAGTGGGGTTTGAGCTAGAAATAGCA	1	bc
AATATAACAC	GAAACACCGGTGCGCTTTACGCGTTTGTGGGGTTAGAGCTATAAATAGCA	1	bc
TACACAGCCC	GAAACACCGGTTTTCTTAAAATGCCAGTGGGGTTAGAGCTAGAAATAGCA	1	bc
GCATCAACCC	GAAACACCGGTTTTCGTTAATGGTGAGTGGGGTTAGAGCTAGAAGTAGCA	1	bc
ACAAGACGCC	GACACACCGGTAAACTAAAGATACACGTGGAGATAGAACGAGAAACAAAA	1	bc
AGAACGGAAG	GAAACACCGGTGTTATTTGCTCGGGGGGGGGGAGAGAGCGAGAGTTAACA	1	bc
TCCATGTAAC	GAAACACCGGTACTAGTTACTTACGGGTGGGGTTAGAGCTAGAAATAGCA	1	bc
TCCTCCACAC	GAAACACCGGTCGCGATAATGCGCCGGAGAGGATGGTAATCTAAGTCGCA	1	bc
AAAACCCCTG	GAAACACCGGTTTAGTGTGGAGGGAAGTGGGGTTAGAGCTAGAAATAGCA	1	bc
AACCACATTT	GAAACACCGGTGCTAGCGGTTTCGAAGTGGGGTTAGAGCTAGAAATAGCA	1	bc
TAACCATCAA	GCAACACCGGTGGGGATCGAGCGAGAAAGGGCAAGTTAACCTAAGGCGAG	1	bc
GAGGACGTCC	GAAACACCGGTGATATGACTCACCGGGTGGGGCTAGAAATAGAAAGTTAA	1	bc
TACCTACTCC	GAAACACCGGTTGAGATAATCAAAACGTGGGGTAGAGCTAGAAATAGCAA	1	bc
CACCTGCTCG	GAAACACCGGTTTTCGATCATAAGGCTAATCCGTTATCAACTTGAAGACG	1	bc
GCCTGACGCG	GAAACACCGGTTTTATGGAATGGCGGGTGGGGTTAGAGCTAGAAATAGCA	1	bc
ATCTTCATGC	GAAACACCGGTTTAGTATGGAGGGAAGTGGGGTTAGAGCTAGAAATAGCA	1	bc
GAATCCACCA	GAAACACCGGTTTTGGATGATGGTGTGTGGGGTTAGAGCTAGAATTAGCA	1	bc
AACCGCCTCC	GAAACACAAGGGGTTTAGAGCTCGCAATGGCAAGTTAACCTAAGTCTCGT	1	bc
CAATTCCACA	GAAACACCACGGCTTTTGGGTAAGTAGTGGGGATATAACTTAAGGCTAGT	1	bc
AAGATACCAC	GAAACACCGGTTGGCTTTACTCCTTTGTGGGGTTAGAGCTATAAATAGCA	1	bc
AACTTGCACC	GAAACACCGGTTTTAGCTCCTAAGGCTAGGCAATTATCAACTTGCCGAAG	1	bc
GACATAAAAC	GAAACACCGGTGATCTTAGGTTGTGCGGGTGGAGATAGAAATAGCAAGCT	1	bc
ACGTACATCA	GAAACACCGGTGATCACAGAACGTTTTGGGGTTAGAGCTAGAAATATCAA	1	bc
CACAAACCCG	GAAACACCGGTTTTCGATCATAAGGCTAGTCCGTTATCAACTTGAAGAAG	1	bc
GACAAAATAC	GAAACACCGGTAATCTTTACATCCCCGTGGGGATAGAGCTAGAAATAGCA	1	bc
GAATCTCAAA	GAAACACCGGTTCTCTTAGCTAACTAGTGGGGTTAGAGCTAGAAATAGCA	1	bc
CTATTACACA	GAAACACCGGTTGCGAAAGTGTGCCGGTGGGGTTAGAGCTAGAAATAGCA	1	bc
AAACGATCAT	GAAACACCGGTGATAGCGGTATCGCAGTGGGGTTAGAGCTAGAAATAGCA	1	bc
CAACCACTGA	GAAACACCGGTTTAGTATGGAGGGAAGTGGGGTTAGAGCTAGAAATAGCA	1	bc
ACAACACTAG	GAAACACCGGTGGTGTTACAGCAAGAAATTGCTTGTTCAACTTGGACTAG	1	bc
AATCCCTTGC	GAAACACCGGTGACGTATGTATGTCAGTAGGGTTAGAGCTAGAAATAGCA	1	bc
AAGTTAATAC	GAAACACCGGTTGTCTTTCATCCTTTGTGGGGTTAGAGCTAGAAATAGCA	1	bc
CGCCGGGGCC	GAAACACAGGTGGGTGTGCGCTAGAAATGGGGTGTTAACTTGAAACAGGA	1	bc
GTCATATCTA	GAAACACCGTTGAGCGTGGAATATTCGCGAGTTATCGTAAGGAACCTACG	1	bc
AACCTCATAA	GAAACACCGGTTTTCGAGGGTAAAGATCTTGAAATATCAACTTAACCTAA	1	bc
ATGTCCTCCA	GAAACACCGGTGCGAACAGAACGTTTTGTGGTTAGAGCTAGAAATAGCAA	1	bc
AGGCGGGATC	GAAACACCGGTCGTCGTTCGTGGAGTTAGAGCTAGAAATAGCAAGTTAAC	1	bc
CCAGAACACC	GAAACACAGGTTAAACCGGCAACTTTTAGGGGGAGAGAGCTAGAAATAGG	1	bc
ACCCCATCCC	GAAACACCGGTGTCGAGCGTGTGACAGTGTGGTTAGAGCTAGCAATAGCA	1	bc
CAATTCCGCC	GAAACACAACTGGGTTAGAGCTAGAAATAGCAAGTTAACCTAAGGCTAGT	1	bc
CCGATATCCA	GAAACACCGGTTAGCTTTACTCCTTTGTGGGGATAAAAATATAAATAGCA	1	bc
CAGATAATAC	GAAACACCGGTAGTCTTTACATCTCTGTGGGGATAGAGCTAGAAATAGCA	1	bc
ATAAACCTAG	GAAACACCGGTGTTCTTAGCTCGGGTGTGGGGTTAGAGCTAGAAATAGCA	1	bc
AAGTTCACAC	GAAACACCGGTTGACTTTACTCCTTTGTGGGGTTAGAGATATAAATAACC	1	bc
TCAACAATCA	GAAACACCGGTGACGAGAGGACGTTAGAGCTAGTAGTAGCAGATTAACCT	1	bc
TACATCCCCT	GAAACACCGGTTGCGTTAATGAGCTGGTGGGGTTAGAGCTAGAAATAGCA	1	bc
AAAAATCCAG	CTAAACACCGGTTTTCGATCATAAGGCTAGTCCGTTATCAACTTGAAGAA	1	bc
ACGGCGGGGT	GAAACACCGGTCGTCGTTCGTGGGGTTAGAGCTAGAAATAGCAAGTTAAC	1	bc
AACCCCCTCA	GAAACACCGGTTTGGTATAGATGGAAGTGGGAAGATAACTAAAAGTAACT	1	bc
TACATCCACT	GAAACACCGGTCTACTTAGTTAACTAGTGGGGTTAGAGCTAGAAATAGCA	1	bc
GAATTATCCA	GAAACACAGGTGCTCATAGTTAGGGAGGGTAGAGCGAGAAATAACAAGCT	1	bc
AGTCCATAAT	GAAACACCGATCACCATGGAATCTCAATGGTAATCGAACTCTAGACCGTA	1	bc
ATGTTCGCAC	GAAACACCGGTTCGCGAAGCTGATTTGGGGGGTTAAATATCTAGTTAGCA	1	bc
GCCTCACACA	GAAACACCGGTTCAAGCAGCGTCTTTTGGGGGTTTAGAGCTAAAAATAGA	1	bc
AGGCGGGCGG	GAAACGCCGGTCGTCGGTCGTGAGGTGAGAGATAGAAATAGCAAGCTAAC	1	bc
CAAGGAGAAA	GAAACACCGGTGGGGTTAGAGCTAGAAATAGCAAGTTAACCTAAGGCTGG	1	bc
AAGGACGCGG	GAAACACCGGTGAGCTTCTAGAAATCGCGGGTTAAGAGATAGCTAGACCG	1	bc
TGTAAAGACT	GAAACACCGGTCTTCCTGGAATCAGCGAGTGAACTGACGGATAGTCCGTT	1	bc
ATGGCGGGAT	GAAACACCGGTCGTCCTGCAATCAGCAAGATAAACTAAGAGTAGACCAAT	1	bc
GACAGAGACT	GAAACACCGGTGCCAGCGGTCTAGAAGTGGGGTTAGAGCTAGAAATAGCA	1	bc
CGACGGTATG	GAAACACCGGTGAGCATTAGAACGGCCTCGGGGGGATAGCGATAGATATC	1	bc
AAGTCAACAC	GAAACACCGGTTACCGTTACGGGTTTGTGGGGTTAGAGCTAGAAATAGCA	1	bc
AGCAAATCGG	GAAACACCGGTGGCTGGAGATAGCAAGTGAGAATAAGCAAGGAACCTTAT	1	bc
CATAATGCAA	GAAACACCGGTGCCCTTTATGGGACCGTGGGGTTAGAGCTAGAAATAGCA	1	bc
TGCTTCTACG	GAGACACCGGTCGCGGCCATCTGCTTGTGGGGTTAGAGCTAGAAATAGCA	1	bc
GAGATAATAC	GAAACACCGGTAATCTTAAAATCCCCGTGGGGGTAAAGCTAGAAAAAGCA	1	bc
TTATAAATCA	GAAACACCGGTGTGCGGAGATTATGCGTGAGAAATAGCAAGTAACCTAAG	1	bc
GCATCGCATA	GAAACACCGGTTCACTCGGCATCTTTTTGGGTTTAAAGCCTCAAATTGGA	1	bc
GGCGACGAGG	GAAACACCGGTGGCTAGAAAGATCAAGTTAACCTAATGATCGTCCGCTAG	1	bc
CATTGGGACA	GAAACACGGGTTGTGGGGCACTCGGTGTGGGAGTAATCTCAAGTTAACCT	1	bc
AAAACCCTGC	GAAACACCGGTTTAGTATGTAGACAAGTGGGGTTAGAGCTAGAAATAGCA	1	bc
AAATCCGTAA	GAAACACCGGTTTTGGGGGACTCGAAGTGGGGTTAATACCAGGTTAACCT	1	bc
GACACCCTGA	GAAACACCGGTGTAGAAAAGACGTTTTAGGGCTAGAACTAGAAAGTGAAC	1	bc
ATAACAGTCC	GAAACACCGGTGACAAACGTATGTCAGTGGGGTTAGAGCTAGAAATAGCA	1	bc
AACTTACTAA	GAAACACCGGTTTTCACTCATAAGGCTAGTCCGTTATCAACTTGAGCAAG	1	bc
TAACAGCTCC	GGAACACCGGTTGTCTTTGTTAGATAGTTGGGTTGAGCTAGGAAATAGAA	1	bc
TAAACAGCCT	GAAACACCGGTTTTAGGAAATGGAGAGTGGGGTTAGAGCTAGAAATCTCA	1	bc
ATCTTGTCAC	GAAACACCGGTCGCGGATCTGAGGCGGTGGGGTTAGAGCTAGAAATAGCA	1	bc
GAATGAGCAA	GAAACACCGGTGGTGGGGAACTCGGTGTGGGAGAAATAACAAGTTAACAT	1	bc
AAATCAAAAC	GAAACACCGGTTGAGATAAGCAAAAAGGGGGGTTGAGCTAGAAAGTGAAA	1	bc
AACATGGCCG	GAAACACCGGTTTTCGATCATAAGGCTAGTCCGTTATCAACTTGAAACCG	1	bc
ACGCGCGGCG	GAAACACAACGGGGTTAGAGCTAGAAATAGCAAGTTAACCTAAGGCTAGT	1	bc
AACACCCTGG	GAAACACCGGTTGGGGTAGAGCTAGAAAGACCACGTTAAACTAGGGCTAG	1	bc
GGACACGAAC	GAAACACCGGTGAGCGTTGCCCGAGAGTGGGGTTAGAGCTAGAAATAGCA	1	bc
AAGACCCATC	GAAACACCGGTTTAGTATGGAGGGAAGTGGGGTTAGAGCTAGAAATAGCA	1	bc
TGCCCAGCGT	GAAACACCGGTCTTCCTGGAATCAGCAAGTTAACCTAAGGCTAGCCCGTT	1	bc
AATACTCCCA	GAAACACCGGTGCCCTTTATGGGACCGTGGGGTTAGAGCTAGAAATAGCA	1	bc
TTAATCTCCA	GAAACACCGGTCGCGAAAATGTTCCGGTGGGGTTAGAGCTAGAAATAGAA	1	bc
GTACAAGCAG	GAAACACCGGTTTTAGTAAATGGTGAGTGGGGTTAGAGCTAGAAATAGCA	1	bc
AAGCGGGTGG	GAAACACCGGTCTACGTTCGTGGGGTTAGAGCTAGAAATAGCAAGTTAAC	1	bc
ATGTGCGCCG	GAAACACCGGTCGCGGAAATGTGCCGGTGGGGTTAAAGGTAAAAATAACA	1	bc
AAGCGCGTGT	GAAACACCGGTGCTAGCGGTTGCGATGTGGGGTTAGAGCTAGAAATAGCA	1	bc
GCGAGAGAGT	GAAACACCGGTGAGCTGCGTCAAGTGGGGTTATGGCAAGGCAAGGCAAGT	1	bc
TCTTAACGGC	GAAACACCGGTCCTAGAAGCTGAGTTAGAGCTAGAAATAGCAAGTTAACC	1	bc
ATTCTTTGCC	GAAACACCTGTCTCGAAAATGTGCCGGTGGGGTTAGAGCTAGAAATAGCA	1	bc
CCGTTACAAA	GAAACACCGGTTGCCTTTACTCCTTTGTGGGGTTAGAGCTATAAATAGCA	1	bc
TCCAACGAGA	CTAAACACCGGTGCTAGCGGTTTCGAAGTGGGGTTAGAGCTAGAAATAGC	1	bc
ATAATATATA	GAAACACCGGTGACAAACGTATGTCAGTGGGGTTAGAGCTAGAAATAGCA	1	bc
CAACAGCAAT	GAAACACCGGTGTTATTTGCTCGAGGGTGGGGTTAGAGCTAGAAATAGCA	1	bc
AATCCAGCTT	GAAACACCGGTGACCATCGTATGTCCGAGGTAATAGAGCTAGAGTTCGCA	1	bc
CCTTAAACCC	GAAACACCGGTTGGCTTTACTCCTTTGTGGGGTTAGAGCTAGAAATAGCA	1	bc
CGGCCGGCAG	GAAACACCGGTGGCCGACCGAGGGGATTGAGCTTGAAACAGCAAGTAGAC	1	bc
TTCCCCTCTT	GCAACACCGGTCGCGAAAATGTGTCGGTGGGGTTAGAGCTAGAAATAGCA	1	bc
CAGATGCCAG	GAAACACCGGTTTTCGATCATAAGGCTAGTCCGTTATCAACTTGAAGAAG	1	bc
TCAGCCCACA	GAAACACCGGGGGGGTTAGAGCTAGAAATAGCAAGTTAACCTAAGGCTAG	1	bc
GAGAAATACG	GAAACACCGGTGATCGGTAAGGATTTGTGGAGTTAGAGCTAGAACGAGCA	1	bc
TGGCGGGCCG	GAAACACCGGTCGCCGTTCTTGGGCTGTGGGGTTGAAACAGCAAGTTAAA	1	bc
AAACGAGTGA	GAAACACCGGTGCTAGCGGTGTGGAAGTGGGGTTAGAGCTAGAAATAGCA	1	bc
ATACACACGA	GAAACCGCGGTGTGCGGTGATTATGCGTGAGAAATAGCAAGTAACCTAAG	1	bc
TCAGAAACGA	GAAACACCGGTGGGGGTAGAGCTAGAAATAGCAAGTTAACCTAAGGCTAG	1	bc
AACCACATCG	GAAACACCGGTTTAGTATGGAGGGTAGTGGGGTTAGAGCTAGAAATAGCA	1	bc
CCCTTAACGA	GAAACACCGGTGTGCGGAGATTATGCGTGAGAAATAGCAAGTAACCAAAG	1	bc
CAACAGCAAA	GAAACACCGGTGGTCTTTGCTCCAGGGTGGGGTTAGAGCTAGAAATAGCA	1	bc
CCGAAAAACC	GAAACACCGGTTATCTTTACACCTTTGTGGGGTTAGAGCTATAAATAGCA	1	bc
CACCCCCCCC	GAAACACCGGTTCAACCGGCGTCTTTTGTGGGGTTAGAGCTAGAAACAGC	1	bc
TGCAATCTCC	GAAACACCGGTACTCGATAGCTCGCGGGGTGAGTGCTGGTAGTAATAGGA	1	bc
TGCCACTAAG	GAAACACCGGTTTTAGTAAATGGTGAGTGGGGTTAGCGCTAGAAATAGCA	1	bc
GATTCATCCA	GAAACACCGGTGATAACAGATCGCTCTGGGGTTAGAACTAGAAAAAGCAA	1	bc
ACATAACAAC	GAAACACCGGTTGGCTTTGCTCCTTTGTGGGGTTAGAGCTATAAATAGCA	1	bc
AGTACTGTCT	GAAACACAGGTTCCCGTTAGCTGGTGGGGTTAGAGCTAGAAATAGCAAGT	1	bc
AGTTCACGGA	GAAACACCGGTGAGCGCAGATAGTGCTGGGGATAGAGCGAGAAACTAAAG	1	bc
ACACGCCGTT	GAAACACCGGCGATAACTGGCTCGATGAGCGATGAGTAGTACGTTTTCAA	1	bc
CTGACGCACC	GAAACACCGGTCCTACCGGCTTCGTTTGTGGGGTTAGAGCTAGAAATAGC	1	bc
CGCACGCCCT	GAAACACCGGTTCCCGCGAGGTCGTTGGGTTAGAGCTAGATAGAGCTAGT	1	bc
TTATTCTATA	GAAACACCGGTCACGAAAATGTACCTGTGGGGTTAGAGCTAGAGATAGCA	1	bc
GAAATGTCTA	GAAACACCGGTTGTGGTGAACTCGGTGGGGGAGATATAGATAGTTATACT	1	bc
TAATAGCACC	GAAACACAGGTTCAAGGGGATTATTCTGTGGGGATAGCAATAGAACTAAG	1	bc
CACCCCAGAA	GAAACACCGGTAGAATGGGTCCTCGGGAGGGGTTAGAGCTAGAAATCGCA	1	bc
CAACGAAGCC	GGAAAAAAACGGGGAGAGAGCTAGAAATAGCAAGTTAACCTAAGGCTAGT	1	bc
TATTTTGCCG	GAAACACCGGTCCCCTTTATGGGACCGTGGGGCTAGAGCTAGCAATAGCA	1	bc
CTCTTAACAA	GAAACACCGGTCGGGTAAATGTGCCGGTGGGGTTAGAGCCAGAAATAGCA	1	bc
GCAGCACAAC	GAAACACCGGTGGGGTTAGAGCTAGAAATAGCATGTTAACCTAAGGCTAG	1	bc
ACATACACAA	GAAACACCGGTGGCAATTCGATCTGAGTGGGGTTAGAGCTAGAAATAGCA	1	bc
AATCCTACGA	GAAACACCGGTGTCCTTTGTGGGGCCGTGGGGTTAGAGCTAGAAATAGCA	1	bc
AACCTACTCG	GAAACACCGGTTTTCGGTCATAGTGCTAGTCAGTTATCAACTTAAAGAAA	1	bc
TAATCAGATT	GAAACACCGGTTGAGCTAGTCTAAACGTGGGGTAGAGCTAGAAATAGCAA	1	bc
ACTTGGGGAC	GAAACACCGGTTGAGTGGAACTCCGGGTGTGAGTAATAGCAAGTTAACCT	1	bc
TCATCCCAAA	GAAACACCGGTGGGGTTAGAGCTAGAAATAGCAAGTTTACCTAAGGCTAG	1	bc
AGCTATGGGG	GAAACACCGGTGGGGTTAGAGTTTGAATTAGCAAGGTCACCTAAGGTGAG	1	bc
AAAAGGGATT	GAAACACCGGTGTTAGCGGTTTCGAAGTGGGGTTAGAGCTAGAAATAGCA	1	bc
AACCTGCTTT	GAAACACAGGTGTTCGAGCATTAGGCTAGTCCTTTATCAACTTGATGAGG	1	bc
CCCTGCCGGA	GAAACACAGGGGTGTGGGGGCTAGGCGTGGGAAGTTGCACGAAGCCTAAT	1	bc
GATTATGATA	GAAACACCGGTACTAGTTACTTACGGGTGGGGTTAGAGCTAGAAATAGCA	1	bc
CCGTGGGCAA	GAAACACCGGTTGGGGGGAATTCGGTGTGGGAGTAGAAGCATGATAAGCT	1	bc
ATAAACAAGA	GAAACACCGGTTATCTTTATTAATTTGTGGGGTTAGAGCTAGAAATAGCA	1	bc
ACGCTACCAT	GAAACACCGGTTGTCATTACTCCTTTGTGGGGTTAGAGCTATAAATAGCA	1	bc
CATAAACTCA	GAAACACCGGTAATATATAGATCCGAGTGGGGATAGAGCTAGAAATAGCA	1	bc
AACTGCCCAC	GAAACACCGGTAGTGTAAAACTCCGTGTGGGGGTAGTGCTAGAAATAGCA	1	bc
AATAGCCCAA	GAAACACCGGTTGACGTCGTTTCGTAGTGGGGGTAGAGCTAGGAATAGAA	1	bc
TGTTCAGAAA	GAAACGCCGGTTGTGGGGAAATCGGTGTGGGAGAAATAGCAAGTTAACAT	1	bc
ATGAAAGCGT	GAAACACCGGTGTTCGGAGATTAGGCGTGAGAAATAGCAAGTATCCTAAG	1	bc
GAATAACCGA	GAAACACCGGTGTTCGGAGATTGTGAGTGAGAATAAAGATGTAACCTAAA	1	bc
CGTCCCTCGA	GAAACACCGGTGAGAACAGAACGTTTTGGGGTTAGAGCTAGAAATAGCAA	1	bc
ACCTACCGGC	GAAACACCGGTGTAAGGGGACTATGCGTGAGGTTTAGCAAGGAACTTAAG	1	bc
CTGCCCCGCC	GAAACACAACGCCGTTAGAGCTAGAAATAGCACGTTTACCTCTGGCCAGT	1	bc
CCCACACACA	GAAACACCGGTTGAAGCGGCGTCTTTTGGGGGGTTAGAGCTAAAAATAGA	1	bc
AGCAAGCACC	GAAACACCGTTGCTCTTTGCTTGGGGGTGTGGTTAGAGCTAGAAATAGCA	1	bc
AAGTCACGCA	GAAACACCGGTGTGCGTAGAGTATGCGTGAGAAATAGCAAGTAACCTAAG	1	bc
GCAACATTCA	GAAACACCGGTGACGCCAGGACGTTAGAGGTAAAAATAGCAATAGTACCT	1	bc
TCATCAACAC	GAAACACCGGTGGGGTTAGGGCTAGAAATAGCAAGTTAACCTAAGGCTAG	1	bc
GCAGCAAACG	GAATCACCGGTTATCGTTACGGTTTTGTGGGGTTAGAGCTAGAAATAGCA	1	bc
TGTCGGGACA	GAAACACCTGTCTTGCTGAAATCAGCAAGGTAACCTAAGGCTGTTACGCT	1	bc
AACACTCTAA	GAAACACCGGTTTTCGATCATAAGTCTAGTCCGTTATCAACTTGAAGAAA	1	bc
AGTTGAGAAA	GAAACACCGGTTGTGGGGGACTCGGTGTGGGGGAAATAGCAAATTAACCT	1	bc
GACAACGACT	GAAACACCGGTGCCTAGAGATACCAAGTTGACCTAGGGCTAGTCCGATAT	1	bc
ACCTATCAAG	GAAACACCGGTACTCTTGATGTGACGGCGGGGTTAGAGCGAGAAATAGCA	1	bc
TCAGCAGATT	GAAACACCGGTGTTGTTAGAGCTAGAAGTAGGAAGTTGACCTAGGGATAG	1	bc
CTGTTAGCAG	GAAACACCGGTTGCAGTAATTCTTTGGGGGGGTGAAAGTAATAATAAGAA	1	bc
GAAATATATA	GAAACACCTGTTTTCGTAATAGGTGAGGGGGGTTTGAGTCTAAAAATACA	1	bc
GTATTACCTA	GAAACACCGGTGTGCGGAGATTATGCGTGAGATATGAGATGTAACCTAAG	1	bc
TGCTCAGCTT	GAAACACCGGTCTCCATGGAATCAGCGTGGTAACATAAGGATAGACCGTT	1	bc
ACGCTAAAAC	GAAACACCGGTTGGCTTTACTCCTTTGTGGGGTTAGAGCTATAAATAGCA	1	bc
GTATAATCGA	GAAACACCGGTGTGCATGATAAAGTCGTGGGGGTTAGCGCTAGACCTAGC	1	bc
AAATCGGCCC	GAAACACCGGTTTTCGTGAATGGGGAGTGGGGTTAGAGCTATAAATAGCA	1	bc
CGCACTGCTT	GAAACACCGGTTCCCGTTAGCTCGTGGGGTTAGAGCTAGAAATATCAAGT	1	bc
TGAACTTAAT	GAAACACCGGTTTACGTAGGTAACTAGGGGGGTTAGAGCTAGAAATAGGA	1	bc
AACATGCCCC	GAAACACCTGTTGGCTATCATAATTCTAGGCCGTTATCAACTTAATGAAG	1	bc
AAGCTAACAC	GAAACACCGGTTGGCTTTACTCCTTTGTGGGGTTAGAGCTATAAATAGCA	1	bc
ATTTCCGACG	GAAACACCGGTGGCAGTTGCGGCTGTTGGGGGGTTAGACTAGGAATATCC	1	bc
GACAAAATCA	GAAACACCTGTAATCTAAAGATCCCAGTGGGGATAGAGCTAGAAATAGCA	1	bc
TCACGACGCC	GAAACACCGGTGGGTTAGATCTAGAAATGGGGTAGTGACATAAATCTCAA	1	bc
TCCTTTAACA	GAAACACCGGTGGGGTTAGAGCTAGAAATAGCAAGTTAACCTAAGGATCG	1	bc
CAACGCCTCC	GAAACACCGGTGGGTTAGAGCTAGAAGTGGCGAGTTAACCTAAAACTAGA	1	bc
TTCTGCCTGA	GAAACACCGGTGAGCGGAGAATATGCGTGAGAAATAGCAAGAAACCTAAG	1	bc
CTGTCCGTAA	GAAACACCGGTCCTAGAGGATGAGTTAGCGCTAGAAATAGCAAGTTAAAC	1	bc
ATATCATCAA	GAAACACCGGTGAGAACAGAACGTTTTGGGGTTAGAGCTAGAAATAGCAA	1	bc
AACTTACTAA	GAAACACCGGTTTTCGCTCATAAGGATAGTCCGTTTTCCCCTTGACGAAG	1	bc
AAACACCTGC	GAAACACCGGTTTTCTATGGAGCGCCGTGGGGTTAGAGCTAGAAATAGCA	1	bc
TCACGCATCC	GAAACACCGGTGAAACGAGAACGTTAGAGGTGGTTATAGCAAGAAAAAGT	1	bc
CCGAACACCC	GAAACACCGGTTGGCTTCAGTCCTTTGTGGGGTTAGAGCTATAAATAGCA	1	bc
ACGAAAGTCG	GAAACACCGGTCATAGAAGCTGAGTTAGGGGAAGAAAGAGAAAATTAAAA	1	bc
TAAAAAAACG	GAAACACCGGTGGCGAGAAAGAGAAAGTTAACCAGAGGATGGACCGCTAG	1	bc
GACAAACTAA	GAAACACCTGTAATCTAAAGATCCCCGGGGGGATAGAGCTAAAAAAAGCA	1	bc
CGCCTGGGTG	GAAACACCGGGCGTTGTTCGTTGGGCTAGAGCTAGAAATAGCAAGTTATC	1	bc
AAGACCCACG	GAAACGCCGGTTTACGTTAGAGGGAAGTTGGGTTAGAGCTAGAAATAGCA	1	bc
ATCTCACTTC	GAAACACCGGTGTGCGGAGATTATGCGTGAGCAATAGCAAGTAACCTAAG	1	bc
AACTCGGCCG	GAAACACCGGTTTTAGTTCATAGTGCTTGGGGTTAGTGATAGTGATCGCA	1	bc
AGCAACGAAA	GAAACACCGGTGGCGAGAAATAGGAAGTGGGAGTAAGACTGAGACAATAT	1	bc
GAAAAATATA	GAAACACCGGTGAGCACGTGGGGATATAGCTAGAAATAGCAAGTTAACCT	1	bc
ATCTCCCCGG	GAAACACCGGTGTGCGGAGATTATGCGTGAGCAATAGCAAGTAACCTAAG	1	bc
AATTCCGTCA	GAAACACCGGTGGTAGTAGCATAGGTGTGGGTTTAGAGATAAAGTTACCA	1	bc
CCCTATCACA	GAAACACCGGTACTACTTGCTTACGGGTGGGGCTAGAGCTAGCAATAGCA	1	bc
ACACCCCTCC	GAAACACCGGTGACGCGAGGACGTTAGAGCTAGAAATAGCAAGTTAACCA	1	bc
AACTCGCCCC	GAAACACCGGTTAAACAGGCGTCTTTTGGGGGGTTAGAGCTCGAATTACA	1	bc
GAAAAACCCC	GAAACACCGGTAATCTAAAGATCCCCGTGGGGATAGAGCTAGAAATAGCA	1	bc
GTAAACTACA	GAAACACCGGTGGCTATAAATATCAAATTAACCTAAGACTGGTCCGTTAT	1	bc
TTTTTCTCAA	GAAACACCGGTCGCGGAAATGTGGCTGTGGGGTTAGTGCCAGGATAAGCA	1	bc
GAAATCAAGA	GAAACACCGGTTAAGGATGGAGGGTAGTGGGGGTAGAAGCAGAAATTAGA	1	bc
AATACCCCCC	GAAACACCGGTAATCAACGTATCTAAGTGGGGATAGAGCTAGAAATAGCA	1	bc
GATAAAGTCC	GAAACACCGGTAATCTAAGGATCCCCGTGGGGATAGAGCTAGAAATAGCA	1	bc
AGCCCGCCCT	GAAACACCGGTGTTCTTTGCCCGAGGGTGGGGTTAGAGCTAGAGATAGCA	1	bc
ATTTCACCAA	GAAACACCGGTGTGCGGAGATTGTGCGGGGGATATAGCAAGTAACCTAAG	1	bc
AGATAGCCAA	GAAACACCGGTTTTAACTGATCGAGGGTGGGGTTAGAGCTAGAAATAGCA	1	bc
ATGTAAACAC	GAAACACCGGTGGGCGTAGATTATGTGTGGGAAAAAAGAAATAAACAAAA	1	bc
TGCTTCGACC	GAAACACCGGTCGCGATAATGCGCCGGTGGGGTTAGAGCTAGAAATAGCA	1	bc
GTAATAGATG	GAAACACCGGTGCGAGTGATTAAGTAGCAAGTTACAATAAGGCTAGTCGG	1	bc
AAACGATATC	GAAACACCGGTGCTCGCCGTTTCAGAGTGGGGTTAGGGCTAGAAATAGCA	1	bc
TACTAAAGCC	GAAACACAGGTTGACATAGTCAAGATGGGGGTTAGAGTTGCAAATAGCCA	1	bc
GTAACAGACG	GAAACACCGGTGAGCATGATAGCGTAGCAAGTTAGACTTAGGCTGGTCCG	1	bc
TAAACAAACC	GAAACACCGGTGGTCTTAGAGCTAGAGAGGGCAAGTTAACCTAAGGATCA	1	bc
ATACAAGAAA	GAAACACCGGTTGTAAGCACTGGCGTGTGGGGTTAGAGCTAGAAATAGCA	1	bc
GACTAAGCAC	GAAACACCGGTGTTCGGAGATTATGAGTGGGAATAAGCAAGGAACCTACA	1	bc
CATCGAGTTG	GAAACACCGGTGACAAACGGGTGTCAGAGAGTTAAGAGCTGGCAATTGCA	1	bc
AGAAACTACA	GAAACACCGGTGGCTAGAAATAGCAAGTTGACCTAAGGCTGGGCCGTTCT	1	bc
ATCTCCCTGA	GAAACACCGGTGTACTGTGGTTATGCGTGGGATTTGGCCAGTAACCTGAG	1	bc
AGATTAACAC	GAAACACCGGTGGTCTTTGCTCGAGGGTGGGGTTAGAGCTAGAAATAGCA	1	bc
GAGTGACGCC	GAAACACCGGTGGGCGATAGCTATATGTGGGGATTTAACTTAAGATTAGT	1	bc
AGGTAACCAC	GAAACACCGGTGTTCTTTGCTCGATGGTGGGGATAGAGCTAGAAATAGAA	1	bc
ATCAACCTGC	GAAACACCGGTAAGCTAAAGATCTCCGTGGGGATAGAGCTAGAAATAGCA	1	bc
TACTCAAAAA	GAAACACCGGTGGGGTTATAGTTAGAAATAGCAAGTTAACCTAAGGCTAG	1	bc
GCCCCCAGCT	GAAACACCGGTGGTCGCCGTGGAGTTAGAGCTAGAAATAGCAAGTGGGGT	1	bc
TCCCGAAGCA	GAAACACAACGGGGTTTAGAGTAGGAATTGGAAGTTAACCTTAAGGCTGT	1	bc
GACACACAAA	GAAACACCGGTAATCTAAGGATCACAGTGGGGATAGAGCTAGAAATAGCA	1	bc
AAACCACTAC	GAAACACCGGTGACAAACGTATGTCAGAGGGGGTAGAGCTAGAAATATCA	1	bc
CTCTTACCAC	GAAACACCGGTTTGCTTTACTCCTTTGTGGGGTTAGAGCTATAAATAGCA	1	bc
CGCCACCACG	GAAACACCGGCTGCTAGAAACAACAAATTATCCTACGGCTGGTCCGTTAT	1	bc
GAACCAGACT	GAAACACCGGTTTTAGTAGATGCTACGTGGGGTTGTGGCTAAAATTGCCA	1	bc
TGACGAGTTT	GAAACACCGGTCGTCGTTCGTGAGATTAGGGCTAGAGATAGCAAGATCAC	1	bc
GTAACATACA	GAAACACCGGTGGGGATAGAGCTATAAATAGCAAGTTAACCTAAGGCTAG	1	bc
TTCGCCTCAC	GAAACACCGGTCGCGAAAATGCGCCGGAGAGGTTAGAGATAGAAAGATAG	1	bc
TGCTTGCACC	GAAACACCGGTTGAACGAGTGTCTTTTGTGGGGTTAGATCTAGAAATAGC	1	bc
AACCAGCAAA	GAAACACCGGTGTTCTTTGCTCGAGGGTGGGGTTAGAGCTAGAAATAGCA	1	bc
GTCTTATAGA	GAAACACCGGTGTGCGGAGATTATGAGTGAGCAATAGAACCTAACCCTAG	1	bc
TCACCCCATC	GAAACACCTGTTTACTTAGTTAACTAGGGGGGTTAGAGCTAGAAATCTCA	1	bc
GACAACTATC	GAAACACCGGTAATCTAAATATCCCCGTGGTGGTAGAGCTAGGTATAGCT	1	bc
AAATCAGCAC	GAAACACCGGTTTTAGAAGATGGTGGGTGGGGTTAGAGCTAGAAATAGCA	1	bc
TGTCAAGTAT	GAAACACCGGTATTACTGGAATAAGCGAGTTAACCTAATGCTAGATAGCT	1	bc
TACGTGCTAA	GAAACACCGGTGTTCAATCTTAAGGCTAGGGGGTTATCAATTTAAAGAAG	1	bc
AAACAAGAAA	GAAACACCGGTGTTATTAGTTCGAGGGTGGGGTTAGAGCTAGAAATAGCA	1	bc
TGAACCTAAA	GAAACACCGGTGTACTCAGCTAACTTTTGGGGTTAGAGCTAGAAATAGCA	1	bc
GACAGTGCCC	GAAACACCGGCAATCTAAAGCTCCCTGTGGGGGTAGTGGTAGAATTAGCT	1	bc
CAACGATAAC	GAAACACCGGTGCCAGCGGTTTCGCAGTGGGGTTAGAGCTAGAAATAGCA	1	bc
CATTCACCCG	GAAACACAGGTGGCAATTCGATCTGAGTGGGGTTAGAGCTAGAAATAGCA	1	bc
AATCCCTTAA	GAAACACCGGTGACAAACGGATGTCAGTGGGGTTAGAGCTAGAAATAGCA	1	bc
TCATTCAACC	GAAACACCGGTCGCGAAAATGTGACGGTGGGGTTAGAGATAGAAATCGAA	1	bc
TGGTTAGACA	GAAACACCGGTGGGGATAGTCCTATAGAGAGGGAGAGATAGCAATAGCAT	1	bc
ATATAGCCGC	GAAACACCGGTGTTCTGTGCTCGTGGGTGGGGATTGAGCTAGAAATAGCA	1	bc
GACAAGGTTC	GAAACACCGGTAATCTTACGAAGCCCGTGGGGATAGAGCTAGAAATAGCA	1	bc
AGTCCGCGAC	GAAACACCGGTGTTCTTTGCTCGAGGGTGGGGTTAGAGCTAGAAATAGCA	1	bc
TTCCTCTTGC	GAAACACCGGTCTCGTATATGGGCCGGTGGGGTTAGAGCTAGAAAGTTCA	1	bc
CACCTTCTCG	GAAACACCGGTCGTCGATCATAAGGCTAGTGCTTTAACTACTAACAGAAC	1	bc
TAATCACTCT	GAAACACCGGTGACGAGAGGAAGTTAGAGGGGGAGATCTAAAGTTAACCC	1	bc
CGGTGAGGTG	GAAACACCGGTTATCGTTCCGGATTATCGATATGTAGAGATAGAGCTAGC	1	bc
AGACAGTAGA	GAAACACCGGTGTTCTTTGCTCGAGGGTGGGGTTAGAGCTAGAAATAGCA	1	bc
TGTTCCTTAG	GAAACACCGGTGAGCACTGGACGTTTGGGGGATAAAGGTTAAAATAGCCA	1	bc
CTGACATTCG	GAAACACCGGTCCGAGCAGCTGGGTTTGGGGTAGGAGTAGCAAATAGACA	1	bc
TCCTCATACA	GACACACCGGTGGGGTAAGGGCTAGAAATTGCAAGTTAACCTAAGGCTAG	1	bc
AATAACTTCC	GAAACACCGGTAATATAAGGATGACAGTGGGGATAGAGCTAGAAATAGCA	1	bc
CACTCCCTCC	GAAACACCGGTAATCTCAGGATCCCCGTGGGGTTAGACCTAAAAATAGCA	1	bc
TTGTCCGCCC	GAAACACCGGTCTCGAAAATGTGCCGGTGGGGTTAGAGCTAGAAATAGCA	1	bc
CCCTTGAACA	GAAACACCGGTTCAACCGGCGTCTTTTGGGGGGTTAGCGATAGAAATAAC	1	bc
CCATCAAAAC	GAAACACCGGTTGGGTTTACGCCTTTGTTGGGATAATACTCTAAATATAG	1	bc
GTCAACGGCG	GAAACACCGGTGGCAAGAAATAGCAATTTAACCTGAGATTGGTCCGTTAT	1	bc
ATCGGATATA	GAAACACCGGTGGGAATGGGTTAGAGCGAGGAGTTGGAAGTAAAAATAAG	1	bc
AATTAATCAA	GAAACACCGGTTGTGGTAGACTCGGTGTGGGAGAAATAGCAAGTTAACCT	1	bc
CCCTGTCGAC	GAAACACAAGGGGGATAGAGTTAGAAATAGCAAGTTAACCTAAGGTTAGT	1	bc
AAGAACGTCC	GAAACACCGGTCCTAGAGGCTGATTTAGAGCTATAAATATCAAAATAACC	1	bc
CCCTTGCAAA	GAAACACCGGTTCAACCGGAGTCTTTTGTGGGGTTAGAGCTAGAAATAGC	1	bc
GACGGCCTTC	GAAACACCGGTAATCTAAGTATCCACGTGGGGATAGAGCTAGAAATAGCA	1	bc
AAGCCCGTCA	GAAACACCGGGTCGGGTTAGTGACGGGAGTGGTTAGTGCAACAAATACTA	1	bc
TTCATCATCC	GAAACACCGGTGGTGGTTAGAGCGAGAGATGGCAAGTTTAGCGATGGCTA	1	bc
ACCCCCCTGC	GAAACACCGGTTTAGTATGGCGGGAGGTGGGGTTAGAGCTAGAAATAGCA	1	bc
CATGTCCAGA	GAAACACCGGTCTTCCTGGAATCAGCAAGTTAACCTAAGGCTAGTCCGTT	1	bc
AAATGGCCAC	CTCCACCCCGGTTTTCTTTGCTCTATGGTTTTTTTAGAGCTATCACTCTC	1	bc
CTGTCCGTAA	GAAACACCGGTCCTAACAGCTGAGTTAGGGCTGGAAATAGAAAGTTAACC	1	bc
GGAATTTATT	GAAACACCGGTGCCCGTGAGAACGTGGGGGGGGTAGAGGAAGAAGCAAGA	1	bc
AAAACGCAAG	GAAACACCGGTTTACTTAGTTAACTAGTGGGGTTAGAGCTAGAAATAGCA	1	bc
TGAACACTCC	GAAACACCGGTGTCGCGAGGTCGTTAGAGGTAGAAATAGCAAGATAACCT	1	bc
CCCTGTCTCC	GAAACACAAGTACTATATACTTACAAATGGGGATAGAACTAAAAATAACA	1	bc
AGCAAGTAAG	GAAACACCGGTGGCTGGAAATAGGAAGTTGGCCTAAGGCTTGGCCGATCT	1	bc
ATCTTCCTCC	GAAACACCGGTTGTGAAAATGTGCCGGTGGGGTTAGAGCTAGAAATAGCA	1	bc
ATAATTCATA	GAAACACCGGTCTACTTAGATCACTAGAGGGGTTAGAGCGAGAGATAGCA	1	bc
TAAAGGGAAT	GAAACACCGGTTGAGTTAGTTAACTAGTGGGGGTAGAACTAGAAAAAGCA	1	bc
GAGAAAATAC	GAAACACCGGTAATCTAAAGATCACCGTGGGGATAGAGCTAGAAATAGCA	1	bc
AATAGGCCCC	GAAACACCGGTTATGTAGAAATCGGTGTGGGAGAAATGGCAGGAAAACCT	1	bc
AGACCGCGAA	GAAACACCTGTGTTATATGTTCGAGTGTGGGCTTAGATCTAGACATAACA	1	bc
CCCCCCCCCG	GAAACACAACGGGGATAGAGCTAGAAATAGCAAGTTAACCTAAGGCTAGT	1	bc
ATCTAAATGC	GAAACACCGGTGTGCGGAGATTATGCGTGAGAAATAGCAAGTAACCTCAG	1	bc
GCATCAGCAA	GAAACACCGGTTTTAGTAAATGTAGAGTGTGGTTAGAGCTAGAAATAGCA	1	bc
GTCCACTAGA	GAAACACCGGTGTCTAGAGATTACAAGTGAGACTTAGGCTGGTACGTTAT	1	bc
GACAACTAAA	GAAACACCGGTAGCTAGAAATAGCAAGTTGGCCTAAGCCTTAAACAGTAA	1	bc
AAACTCATAC	GAAACACCAGTTTAGTTTGGAGGGAAGTGGGGTTAGAGCTATAAATAGCA	1	bc
CCACGCCACT	GAAACACCGGGGGGATGCGGCGGGTAGTGGCGGTATAGCTTGAAATAGCA	1	bc
AGTAATTCGG	GAAACACCGGTGAGAACAGAACGATTTGGGGGTAGAGCTAGGAATAACAA	1	bc
AGACCCCCCC	GAAACACCGGTGTTCTTTGCTCGAGGGTGGGGTTAGAGCTAGAAATAGCA	1	bc
CATCGCGTTG	GAAACACCGGTTTACGTTCGTGGGGATAGAGCTTGAAACTGCAAATAAAC	1	bc
GGTTGAGCCG	GAAACACCGGTTTTAGGGAACGGGGAGTGGGGTTAGAGCTAGAAATAGCA	1	bc
AGTAATTCCT	GAAACACCGGTTCCCGTTATGGGGCGGGGGTAGTGGTGGAGATAATATGA	1	bc
AAACGAGCAT	GAAACACCGGTGCTAGCGGTTTCGAAGGGGGGTTAGAGCTAGAAATAGCA	1	bc
CATTGCCCAC	GAAACACCGGTTGAAGGGGGCTAGATCTAGAAATAACAACATAATCTAAT	1	bc
GAACCAGTGA	GAAACACCGGTTTTAGAAGATGGGGAGTGGGGTTAGAGCTAGAAATAGCA	1	bc
TCTTCACACC	GAAACACCGGTTCAACCGGCGTCATTTGGGTGGTTTGAGCTAGGTATATT	1	bc
GGGTGGGTAG	GAAACACCGGTCGTCGTTAGTGAGGGTAGGGGTTGAAGCAGCAAGTAGAA	1	bc
GAGAAAATCC	GAAACACCGGTAATCTAAAGATACTTGTGGCGATAGAGCTATAAATAGCA	1	bc
CGATCAGCGA	GAAACACCGGTGAGAACAGAACGTTTTGGGGTTAGAGCTAGAAATAGCAA	1	bc
TGAAACCACG	GAAACACCGGTGGCTAGAAATAGCAAGTTAACCTAAGGCTGGTCCGATCT	1	bc
TGAACATAAA	GAAACACCGGTGAGCACAGGACGTTTTGGGGGTTGAGCTAGGAATTGCCA	1	bc
ATCACCCAGA	GAAACACCGGTGTGCGGAGATAATTAGTGGGAAATAGCAAGGAACCTAAG	1	bc
CGTTCCTTGA	GAAACACCGGTGAGAACAGAACGTTTTGGGCTTAGAGTTAGAAATAGCAA	1	bc
GAACCCCTCC	GAAACACCGGTAATCTAAGGTTCGCCGTGGGGATAGAGCTAGAAATAGCA	1	bc
AAAGGGATAG	GAAACACCGGTTGTGGAAGATAAGGCTAGGGCGTCATCAACTAGGAGTAG	1	bc
TGCCAAGATC	GAAACACCGGTCTTCCTGAAATCAGCAAGTTAACCTAAGGCTAGTCCGTT	1	bc
CGGTTATCAT	GAAACACCGGTTGGCTTTACTTCTTTGTGGGGTTAGAGCTATAAATAGCA	1	bc
CGGCTAACTT	GAAACACCGGTTGTCTTTACTTCTTTGTGGGGTTAGAGCTATAATTAGCA	1	bc
ATACAACAGA	GAAACACCGGGGGTGTTTGCTCGAGGGGGGGGTTAGAGCTAGAAATAGCA	1	bc
AATAAACTAA	GAAACACCGGTGGCAATTCGATCTGAGTGGGGTTAGAGCTAGAAATAGCA	1	bc
GATTTAGATT	GAAACACCGGTCTTCCTAGAATCAGCGTGTTAATCTAAGGCGAATCCGTT	1	bc
CTGCGTGTTT	GAAACACCGGTTGTAAGCGATGGTTTTTGGGGTTATAGCTAGAAATAGCA	1	bc
AATCACTCCC	GAAACACCGGTGACAAACGTATGGCAGTGGGGTTAGAGCTATAAATAGCA	1	bc
CTGCCACTCT	CTAAACACCGGTCGTCATCCGTGGTTTTAGGGCTTGGAATTGCAAATAGA	1	bc
TCCTAACACT	GAAACACCTGTGGTCGCCGCGGAGTTAGAGCTAGAAATAACAAGTGTGAT	1	bc
CGGTGGTCAA	GAAACACCGGTGAGAATAGATCGGTTTGGGGCTAGAAATAGCAAGATCAC	1	bc
CAACCCCGCC	GAAACACAGGTGTGTTAGAGCTAGTAATAGCAAGTTAACCTAAAGCTAGT	1	bc
ACATCAACAA	GAAACACCGGTGGGGTTGGAGCTGGAGTGATAAAGTTAACATAAGGATAG	1	bc
TCGCGAGATA	GAAACACCGGTCGGCGTACGTCTGGCTATAGCTAGTAATCCTAAGGCAAC	1	bc
AAGAACGTCC	GAAACACCGGTACTCGAAGGATCCCCGTGGGGATAGAGCTAGAAATAGCA	1	bc
TACACCCACC	GAAACACCGGTGGGGTTAGAGCTAGAAATAGCAAGTTAACCTAAGGCTAG	1	bc
AATAAATTAC	GAAACACCGGTGACAAAAGGATGTCTGTGGGGATAGAGCTGGAAATAGCA	1	bc
TGAAGGGTTT	GAAACACCGGTGATGGTTGGACGTGATAGTGATAGATAGCGAAGGATACT	1	bc
ACATCGCACA	GACACACCGGTTCAACCGGCGTCTTTTGTGGGGTTAGAGCTAGAAATAGC	1	bc
ATCTCAGCCG	GAAACACCGGTTTGCTTAAATTGTGAATGAGAATTAGGATATAACTAACG	1	bc
TGACCCGACT	GAGACGCCGGTCTTGCTGGAATCAGCGAGTTAACCTAAGTCGAAACCGCT	1	bc
AGAATTAATC	GACACACCGGTTGAGATAATCAAAAAGGGGGGGAGAGCTAGAAATAGCAA	1	bc
AACTAAACGC	GAAACACCGGTGAGAAGAGAATATGAGTGGGAAATAGCATGAAAACAGAT	1	bc
CATTCCCGTA	GAAACACCGGTCGCCATTCGTTCTGTTTGGGGTTGGAGCTAGAACTAACC	1	bc
TCAGCCCAGA	GAAGCACCGGTTGTGTGAAAGCGAGAGATGGAGAAATAACAAGTTAACCG	1	bc
GCAGCAACCA	GAAACACCGGTGTGGGTAGAGCTAGAGATAGCATGGTACCAGAAGGCTCA	1	bc
CGCCACGACT	GAAACACCGGTGGCAGCGAATAGCAAGTGGGGTTAAGGCTGGAAAGAGAA	1	bc
AGTCCGGACT	GAAACACCGGTCTTCCTGGAATCAGCGAGTTAACCTAAGTCGAGACCGCT	1	bc
AACATGAGCT	GAAACACCGGTGTTCGACGAGGGGAGGTGGGGTTAGAGCTAGAAATAGCA	1	bc
TTCTCAGGCT	GCCTAAACACCGGTGGCAAGAGGAGCTGTGTGGGGTTGACCTTAGAAATA	1	bc
TATAATCCCA	GAAACACCGGTTTACTTAGTTAACTAGTGGGGTTAGAGCTAGAAATAGCA	1	bc
TTCCCAGAGT	GAAACACCGGTGTTCCGGGAATCAGCAAGTTAACCTGCGGGTAGCCTGTG	1	bc
AACAGCGGCG	GAAACACAGGGGGGTTAGAGGTAGAAGTAGCAATAGAGCCAGAAGCAGGA	1	bc
CTGAGGTACG	GAAACACCGGTCGTCGTTCGTGGGGTTAGAGCTAAGAGTAACAAGTTACA	1	bc
AGATAACCAC	GAAACACCGGTGTGCTTAGCTCGAGGGTGGGGTTAAGGCAGGAACTAAAA	1	bc
CAATCACACG	GAAACACCGGTTTAAGCGGAGGGTTTTGGGGGGTTGTAGCTGGAAATAGC	1	bc
ACGACCAACG	GAAACACCGGTCCTAGTAGCTGAGTTAGTGGTAGAATTAGCTAGTTAACC	1	bc
GGATAAGCAG	GAAACACCGGTGTTCGTAAATGGTGAGTGGGGTTAGAGCTAGAAATAGCA	1	bc
AGACCGCCCC	GAAACACCGGTGTTCTTTGCTCGAGTGTGGGGTTAGAACTAGAAATAGCA	1	bc
CCCCACCCGA	GAAACACCGGCGAGCGGTGATTATGCGTGCGAAATAGCAAGCATCCTCAG	1	bc
AACGTGGAAA	GAAACACCGGTTGTCGAACATAAGGCTAGTCCGATATCAACTTAAAGAAG	1	bc
GTGTCCGCCG	GAAACACCGGTTTTAGTAGATGGGGTGTTTGATTAGAGCTAGGAATAGCA	1	bc
ATCCCCGAAT	GAAACACCGGTTCAATCGGCTACCTTTTTGGTGTTAAAGCAAGAAATAGA	1	bc
CGTTTATTAC	GAAACACCGGTGAGAACAGAACGTTTTGGGGTTAGAGCTAGAAATAGCAA	1	bc
TTTTCCGATT	GAAACACCGGTCTTCCTGGAATCAGCAAGTTAACCTAAGGCTAGTCCGTT	1	bc
CAATGACAGT	GAAACACCGGTGCTAGCGGATTCCAAGTGGGGATAGAGCTAGAAACAGCA	1	bc
TTGTCCAGCT	GAAACACCGGTCTTCCTGGAATCTACGTGGGGTAGAGCTAGGAAAAGCAA	1	bc
AATTAACCAA	GAAACACCGGTGGCAATACGTTCTGCGTGGGGTTAGAGCTCGAAATAGCG	1	bc
TGCAACGATT	GAAACACCGGTCTCTAGAAATAGTAAGTTAATCTAAGGCTGGTCCGCCAT	1	bc
AAGTAGAGAG	GAAACACCGGTTATCGTTACGGATTAGAGCTAGTAATAGCAAGTTAACCT	1	bc
ACTTTTTAAA	GAAACACCGGTTGTGTGGAACTCGGTGTGGGAGTAATCGCCAGTTAACCT	1	bc
TTAACACTGT	GAAACACCGGTGACGCGAGGACGTTAGAGCTAGAAATAGCAAGTTAACCT	1	bc
ACAACGAGAA	GAAACACCGGTGCTAGCGGTTTCGAAGTGGGGTTAGAGCTAGAAATAGAA	1	bc
AAGCTAACAC	GAAACACCGGTGACAATCGTATGTTTGTGGGGTTATAGCTAGAAATAGCA	1	bc
AAACCGCAAA	GAAACACCGGTGATGGTGGATTGGGTGTGGGGGAAGAGGTAGGATAAGCA	1	bc
ATCTTGCCAG	GAAACACCGGTGTGCGGAGATTATGCGGGAGAGATAGCAAGTAACCTAAG	1	bc
GGATTATCAA	GAAACACCGGTTCTTTAAGACTGGAAGTGGGAGTAGAACCAAATAAAGCT	1	bc
TGCCGTTGCT	GAAACACCTGTTAGCAATGGCAAGTTGAGTTAAGGCTAGACCGAGATCGA	1	bc
CGCTACTAAG	GAAACACCGGTGGGTAGAAATAGCAAGTTAACCTAAGGCTGGACCGTTAT	1	bc
AGAACCCCCC	GAAACACCGGTGTTCTTTGCTCGAGGGTGGGGTTAGAGCTAGAAATAGCA	1	bc
GACTAATCAA	GAAACACCGGTAATAAAAGAACGCTTGGGGGTTAGGGCTAGAAATAGCAA	1	bc
CCGCGGCGTG	GAAACACCGGCCGTCGTTCGCGAGGTTAGAGCTAGAAATACCAAGTTAAC	1	bc
TAAACGGCCA	GAAACACCGGTTGTGGGAGACTCGGTGTGGGATTAATACTAGAATTAGCT	1	bc
ATATAACAAA	GAAACACCGGTGTACGGAGATTATTCGTGGGGATTAGCAAGTAACCTAAG	1	bc
GTATTATCCA	GAAACACCGGTCGCGAAAATGTGCCGGTGGGGTTAGAGATAGAAATAGAA	1	bc
CCCGGCAGAC	GAAACACCGGGGGGGTTGAGCCATTAATAGGAAAGTAACCTAAGGCTAAG	1	bc
TTCATCTTCT	GAAACACCGGTCGCGCAAATGTGACGGCGGGAAAAGAGCTAGAAACAGCA	1	bc
AAACCTGCAA	GAAACACCGGTTTTAGATCATAAGGCTAGGCCGTTATCAACTAAAAGAAG	1	bc
TGGCCAGACG	GAAACACCGGTCTTCCTGGAATCAGCAAGTTAACCTAAGGCTAGTCCGTT	1	bc
AAAAAGCAAT	GACACACCGGTGTACTTAGCTAAATAGTGGGGTTAGAGCTATAAATAGCA	1	bc
TACAACTACC	GAAACACCGGTGGCTAGAAACAGCAAGTTAACCTAAGGCTGGTCCGTTAT	1	bc
AAATTACTAC	GAAACACCGGTGGTGTTTGTCCGAAGGTGGGGTTAGACTTGGAAAAGCCA	1	bc
CTCTTCGCCG	GAAACAACGGTCGCGAAAATGTGCCGGTGTGGTTAGAGCTAGGAATAGCA	1	bc
CCCCCCTCCC	GAAACACAACGGGGTTAGAGCTAGAAATAGCAAGTTAACCTAAGGCTAGT	1	bc
TTATCACCGA	GAAACACCGGTGGGTGGAGAGCTAGAAATAGCAAGTTAACATAAGGCTAG	1	bc
CTCTCACCGC	GAAACACCGGTGTGAGGAGCGTATGCTGTGGAGATAGCGAGTAACCTAAC	1	bc
GAGCAACGCC	GAAACACCGGTTTTCGTGGCTCTAGGGCTGGGTTAAGCCTGTAAACCTCA	1	bc
GTCTCACCCG	GAAACACCGGTTTGCGGAAATGGTGCGTGGGGATAGAGCTAGAAATTGCG	1	bc
CGTCGGGCTA	GAAACACCGGTCGTCATTGGTGGTTTGAGGGCTAAAAATCACAATTAACC	1	bc
TGCTCATGCT	GAAACACCGGTTCCCGTTACCTCGTTGGGTGAGTGCTAGAAAAAACAAGA	1	bc
ACACCACAAA	GAAACACCGGTGGGGGTAGGGGCTGAAATAGCCAGGTAAACTAAGGGTAG	1	bc
ATCTCTCCCT	GAAACACCGGTTTTCGGTGACTCTGCGTGGGGTTAGAGCTAGAAATAGCA	1	bc
CCCTGACCAA	GAAACACCGGTGGGAACAGAATGGATTGGGGTTAGAGCTAGAAATAGCAA	1	bc
ATGAAAACGA	GAAACACCGGTCTAAGAAGATGAAGTAGAGTTAGAGATAGCAATAGAAGG	1	bc
AAACATGCAA	GAAACACCGGTTTTCTATCATAAGGCGAGGCCGTTATCAACTAAAAGAAG	1	bc
CAATGAGAAA	GAAACACCGGTGCTAGTGGTTTCGGAGTGGGGTTAGAGCTAGAAATAGCA	1	bc
ATCCCACCGT	GAAACACCGGTTGGCGGCGATGATGCGTGGGAATTAGCAAGTAACCAACG	1	bc
ACCTCCAACA	GAAACACCGGTTTAACATGCGTCTTTAGTGGGGTTATAGATAGAAATAGC	1	bc
AAATCAGCAA	GCAACACCGGTTGTGGTGGAGTCAGAGTTGGCGAAATAACACGTTAACCG	1	bc
