CGGTCGGCCG	GAAACACCGGTCGTCGTTCGTAGTGCTTGGGGTTAGAGCTAGAAATAGCA	1	bc
CGGGGAAAAG	GAAACACCGGTCGGCGTACATAGGGAGTGGGGATAGAGCTATAAGTCGCA	1	bc
GAAATCAATA	GAAACACCGGTGAGCAAGATAACGTCCGAGGTGGTAGAGCTAGAAAAAGC	1	bc
ACCGCCGCCC	GAAACACCGGTAGAATGGATCCACGGGTGGGGTTAGAGCTAGAAATAGCA	1	bc
ATGATCTATG	GAAACACCGGTCCTAAAAGTTACGTTTGTGGGGTTAGAGCTAGAAATATC	1	bc
AAATCCACAA	GAAACACCGGTTTCAGTAAGCCGGTTAGGGGGTAAAAGTGAGAATTACCC	1	bc
TCACCGTTCT	GAAACACCGGTCATGGGACGTCGGGCGTGGGGTTAGAGCTAGAAATAGCA	1	bc
GTTGCCGATT	GAAACACCGGTTTTATGCGTCAATTGGTGGGGTTAAAGCTAGAAATGGCA	1	bc
AAACGGGCAT	GAAACACCGGTTGTAGCGGACTCGGTGTGGGGGTAGAAGTAGAATAAGCT	1	bc
GACAGGCTTG	GAAACACCGGTCTTCGATCGTAGGGCGTGGGGTTAGAGCTAGAAATAGCA	1	bc
GAGTGAATGA	GAAACACCTGTTAAATTCCTCAAGAGGTGGGGTTAGAGCTAGAAATAGCA	1	bc
AAACTGCTTG	GAAACACCGGTCGTCGTTCGTAGGACGTGGGGTTAGAGCTAGAAATAGCA	1	bc
GGCAAATCTG	GAAACACCGGTGGCCGCCAGCGAGGTGTGGGGTAAAAACAAGAAGTTAAA	1	bc
AGACATGAAA	GAAACACCGGTGTTCCTTGCTCGAGGGTGGGGTTAGAGCTAGAAATAGCA	1	bc
AGTCAGTCAC	GAAACACCGGTGATCTTTGCTCGAGCGTGGGGTTAGAGCTAGAAATAGCA	1	bc
ACTAGCCCAT	GAGACACCGGTTGCGCGGGGCTGGTTGTGGGAGAAATAGCAAGTTAACCT	1	bc
CGCCCAGATC	GAAACACCGGTCTTCCTGGAACCTACGTGGGGTAGAGCTAGAAATAGCAA	1	bc
CTCTACCCGC	GAAACACCGGTGTGCGGGGATTATGCGTGGGGAATAGCCAGTAACCTACG	1	bc
ATGAAACCGG	GAAACACCGGTGCGCGGAGATGATTCGGGAGAAATAGCAAGAGACCTAAG	1	bc
GAATCGTAAA	GAAACACCGGTGCCAATAGTTTGCTCGTGGGGTTAGAGCTAGAAATAGCA	1	bc
AATACAGTAG	GAAACACCGGTCCTAGAAGCTGAGTATGTGGGGTTAAAGTTAGAAATAGC	1	bc
AATTGTGCCC	GAAACACCGGTTGTGGGGAACTCGGTGTGGGAGAAATAGCAAGTTAACCT	1	bc
ACACAGCGCC	GAAACACCGGTGGTCTTTGCTCGCGGGTGGGGTTAGAGTTAGAAATAGCA	1	bc
TGAACTTCAA	GAAACACCGGTTCCCGTTAGCTCGGAGTGGGGTTAGTGATAGAAATAGCA	1	bc
ACTCCACCAA	GAAACACCGGTGAGCGACGATTATGCGTGGGAATTGGCAAGGAACCTAAG	1	bc
AAGAGTGATT	GAAACACCGGTACTAGCGGTTTCGAAGTGGGGTTAGAGCTAGAAATAGCA	1	bc
ATAGAAAAAA	GAAACACCGGTTGGGTTAGAGCTTGAATTAGCAAGGTAATCTAAAGCTAG	1	bc
GTAATCTTTG	GAAACACCGGTGAGCATGATAACGTCGTGGGGGTATAGCTAGGAATAGCA	1	bc
GAAATCTAAA	GAAACACCGGTGAGCCTAGTAATAGCCGGGGAGTTAGAGCTATAACTAGC	1	bc
TAAAAACACA	GAAACACCGGTTTACTTAGTTAACTAGTGGGGTTAGAGCTAGAAATAGCA	1	bc
AAACCCGTTT	GAAACACCGGTTTACCTTGGAGGTAGGAGGGGTTAGAGCTACAAATAACA	1	bc
TAAGGACAAA	GAAACACCGGTGGGGTGGGACCCAGAGATGGCGAGATAACATGTGGACAG	1	bc
GACAAGGGAC	GAAACACCGGTACTAGTTACTTACGGGTTGGGTGAGAGCTAGAAATTGCA	1	bc
GTGGGAGATT	GAAACACCGGTGAGATGCCTCAAGAGGTGGGGTTAGAGCTAGAAATAGCA	1	bc
TCCTCAAACA	GAAACACCGGTGGTCTTTGAGCTTTAGATAGCTTAGTGCTATAAATCTCA	1	bc
CCCATGATCA	GAAACACCGGTTCAATCGGGGTCTTGGTGGGGGTTGGGCTCAAAATAAGC	1	bc
AATATTTCCA	GAAACACCGGTGCCCTTTATGGGACCGTGGGGGGAAAGCTATAGATAGCA	1	bc
CATTAACACC	GAAACACCGGTTGTCGTTACTCCTTTGTGGGGTTAGAGCTATAAAAAGCA	1	bc
TTGTTCGAGA	GAAACACCGGTTACGTGACTCAAGTGGTGGGGTTAGAGCTAGAAATAGCA	1	bc
GGATCATAAA	GAAACACCGGTGAGAACGGTAACGTTCGGGGGTTGAGATATAAATATAAC	1	bc
GTAATACTCA	GAAACACCGGTGGGGATAGTGATAGAAATAGCAAGAGAACCTAAAAGTAA	1	bc
CCATCGAACA	GAAACACCGGTTCAAACGGCGTCTTTTGTGGGGTTAGAGCTAGAAATAGC	1	bc
AAAAATATAA	GAAACACCGGTGAGCATGAAAACTGAGGGGGGGTTAGAGTTAGAAATTGA	1	bc
CAGCGAAGCC	GAAACACCGGTTGAGTTGATCCACGGGTGGGGTTAGAGCAATAAAAACCA	1	bc
ATGAAGCTAC	GAAACACCGGTGCTCTTTGCTCGGGGGAGGGGTTAGAGCTAGAAGTAGCA	1	bc
GATTCAGTAA	GAAACACCGGTACTAGTTACTTACGGGTGGGGTTAGAGCTAGAAATAGCA	1	bc
TGGCCAGGCG	GAAACACCGGTTATCGTTACGGCTTTGTGGGGTTGGACTTGGAAATGGCA	1	bc
TGCTGGTCCA	GAAACACCGGTTCCGGGTAGCTCGTAGTGGGGATAGAGCTAGGATAAGCA	1	bc
CGACCGCCAA	GAAACACCGGTGTTCTTTGCTCGATGTGGGGGTTAGAGCTAGAAATAGCA	1	bc
ACCTCATCAC	GAAACACCGGTGACACAAGCGTCTTTGTGGGGATTAGAGCTGAAACTAGC	1	bc
AGCCCTTCAT	GAAACACCGGTTCTCGTTAGCTCGTGGTGGGGTTAGAGCTAGAAATAGCA	1	bc
GCCTTGTATA	GAAACACCTGTGAACATGATGACTTGCGGGGTGAGAGAGCTAGGAATAAC	1	bc
GCGTTCGAAA	GAAACACCGGTGATATTTCTTAAGGGGTGGGGTTAGAGCTAGAAATAGCA	1	bc
TTCATACGTC	GAAACACCGGTAAGCATGATAACGTCGTGGGGATAGAGCTAGAAATAGCA	1	bc
CATTGGGACC	GAAACACCGGTTGAAGGGACGTCGTTGTGGGAGTTAGAGCCAGTTAACCT	1	bc
TATCCATAAA	GAAACACCGGTGGCGGTCGAATCTGAGTGGGGTAAAGAAAAAAAAAACAA	1	bc
CGCTCGTCCT	GAAACACCGGTTCCCGCTGCGTCTTATTGGGGGTTAGAGCTAAAAATGGC	1	bc
AACTAACAAA	GAAACACCGGTGGCAATTGGATATGAGTGGGAATAGAGCTAGAAACAGAA	1	bc
AGTAATATAC	GAAACACCGGTGAGCATGATAGCGTCGTGTGGTTAGAGCTAGAAATAGCA	1	bc
AACAGGCCCC	GAAACACCGGTTCAACCGGAGTCTTTGGGGGGGTTAGAGCAAGAAAAACC	1	bc
AGAACATACG	GAAACACCGGTGGCAACCGGCCACTTGTGGGGTTAGAGCTAGAAATAGCA	1	bc
GAATTTGTTA	GAAACACCGGTACTAGTTCCTTACGGGGGGGTTTAGGCCTAAAAAAGCCA	1	bc
GATTCGGAAA	GAAACACCGGTGGCACTTGGATCTGAGTGGGGTTAGAGCTAGAAATAGCA	1	bc
ACCAACGACG	GAAACACCGGTGGCCGCCCGCAACTTGTGGGGTTAGAGATAGAAATAAAA	1	bc
TGCTCATCCC	GAAACACCGGTTATCGCTACGGCTTTGTGGGGTTAGAGCTAGAAATAGCA	1	bc
AAAATCTCTC	GAAACACCGGTGAGCAAGATAAGGTCCGGGGGGTAAAAGCTAGAAATACA	1	bc
ACGTCCAGAT	GAAACACCGGTCTTCCTGGAATCTACGTGGGGTAGAGCTAGAAATAGCAA	1	bc
GAGACCCGCG	GAAACACCGGTTATCGATAGGGATTTGTGGGGTTAGAGCTAGAAATAGCA	1	bc
TACTTGCTCG	GAAACACCGGTTTAGGTACTCAGGACGTGGGGTAGAGCTTGGAATTGCCA	1	bc
GGCTCCTACC	GAAACACCGGTGGCACCCACCCACTTGTGGGGGTAGAGGTAGGAATTGCA	1	bc
CAACTATATA	GAAACACTGGTGAGCATGATAACGTCCGTGGGGTTAGAGCTAGAAATAGC	1	bc
TGCTAGCAAC	GAAACACCGGTGTTCTTTGCTCGAGGGTGGGGTTAGAGCTAGAAATAGCA	1	bc
TGACCAGGAT	GAAACACCGGTTTACTTAGTTAACTAGTGGGGTTGGAGCTGGAAATGGCA	1	bc
GCCTCTAAAA	GAAACACCTGTACTGTTTGCTTTCGAAATAGCTTATTAATCTAAGTCTAA	1	bc
ATGACAGACT	GAAACACCGGTCCTAGAAGCTGATATTGGGGGGTTAGAGCTAGAAAGAGC	1	bc
AGGCACCACC	GAAACACCGGTGTTAGTTGCTCGAGGGTGGGGTTAGAACTAGAAATAACA	1	bc
AACTTGAAAG	GAAACACCGGTTTTAGTTGATAGGTCGTGGGGTTAGAGCTAGAAATAGCA	1	bc
CAGCGGGTAA	GAAACACCTGTCGTCGTTAGTAGGGCGTGGGGTTAGAGCTAGAAATAGCA	1	bc
TGTCCCTCTT	GAAACACCGGTCTTCCTGGCATCTACGAGGGGTAGAGCTAGCAATAGCAA	1	bc
GTAATACCCA	GAAACACCGGTGAGGATGATAACGTGGGGGGGGTAAGAGTTAAAATTGCA	1	bc
CAGTCAACCC	GAAACACCGGTTGTCTTTACTCCTTTGTGGGGTTAGAGCTATAAATAGCA	1	bc
GTGATATGTG	GAAACACCGGTGAGCATGATAACTTCCGTGGGGTCAGAGCTAGAAATAGC	1	bc
CCGTGAAACC	GAAACACCTGTTGGATTTACTCCTTTGTGGGGTTAGCGCTATAAATAGCA	1	bc
GGATCAGATG	GAAACACCGGTTTTAGTAAATGCTACGTGGGGTTGAGGTTGGAAAAAGAA	1	bc
ACCTCACCGC	GAAACACCGGTTCGAACGGCGTCTTTCGGGGAGTTAGAGCTTAACCTAGC	1	bc
AATAATGACG	GAAACACCGGTGCTCTTTATGCGAGGGTGGGGTTAGAGCTAGAAATAGCA	1	bc
GACTAGGACA	GAAACACCGGTATTAGTTAATTACGGGTTGGGTTAGAGCTAGAAATAGCA	1	bc
CAATGGGCAC	GAAACACCGGTTGAGGGGAACTCTGTGTGGGAGTAGTGGCAAGTTAACCT	1	bc
ATACTACACT	GAAACACCGGTTCTAATAGTTGGCTCGTGGGGTTAGAGCTAGAAATAGCA	1	bc
GTGGACGACG	GAAACACCGGTGGGTTGCCTCAAGTGGTGGGGTTAGGGCTGGTAAGAGCA	1	bc
GCATCTATAG	GAAACACGGGTGTGGTTAGAGCTAGAAATAGCAAGTTAACGTAATGCTAG	1	bc
GCGGGGGAGC	GAAACACCGGTTCAACCAGCGCCTGTTGTGGGAATAGAGCTAGAAATAGC	1	bc
CAAACGGCCT	GAAACACCGGTTGAGTTAGATCTAGAATGGGGATATTACCCTAAATAGCA	1	bc
CCTTGCGCAA	GAAACACCGATTGGGTTTAATCCTTTGTGGGAGTAGTAGCATAATTAGCT	1	bc
GAAAATGCCG	GAAACACCGGTTCTCTTTAATGGTGAGGGGGGTTAGAGCTAGAAATAGCA	1	bc
TGCAGTGCAA	GAAACACCGGTTGTGGTTAACTCGTAGTGGGAGAAATAGCAAGATAACCT	1	bc
TACCATTCAA	GAAACACCGGTACTAGTTACTTAGGGGTTGGGTTAGAGCTAGAATTAGCA	1	bc
ACGGCTGGTT	GAAACACCGGTCGTCGTTCGTAGGGAGTGGGGTTAGAGCTAGAAATAGCA	1	bc
ACTCCAAAAA	GAAACACCTGTGGCAATCGTGCTACAAATATCTTGTTAACCTAAGGCTCG	1	bc
ATGAACTTCC	GAAACACCGGTTCCCGTTAGCTCGTAGTGGGGTTAGAGTTAGAAATAGCA	1	bc
TAAATACAAA	GAAACACCGGTGCTCATAGTTAGCTCGTGGGGTTAGAGCTAGAAATAGCA	1	bc
GACTTACGAC	GAAACACCGGTGATAATAGTTAGCTCGTGGGGTTAGAGCTAGAAATAGCA	1	bc
TAAATACAAA	GAAACACCGGTGAGCATGATAACCTCCGTGGGGTTAGACCTAGAAAAACC	1	bc
GTACTAGATC	GAAACACCGGTGCTCCTTGTACCCTCGTGGGGTTGAGCCAGAAATAGCGA	1	bc
AAATTACTGA	GAAACACCGGTTGGGGGAGTCAAAAAGTGGGGAAGAGCTAGTAACCTAAA	1	bc
ACCATCCTAT	GAAACACCGGTTTTCGATCATAGGTCGCGGGGTTAGAGCTAGAAATAGCA	1	bc
GACCGACGCA	GAAACACCGGTATAATGGATCCACGGGGGGGGTTAGAGCTATAAATAGCA	1	bc
CGCTCGCAAA	GAAACACCGGTTCAACCGGCGTCTTTTGTGGGGTTAGAGCTAGAAATAGC	1	bc
GGCCACGACT	GAAACACCGGTGGCAGCCAGCCCCTTGTGGGGTTGGAGCTAGAAATACCA	1	bc
GCACCGCAAA	GAAACACCGGTGTTCTTTGCTCGGGGGTGGGGTTAGAGCTAGAAATAGCA	1	bc
GTGTAACGCG	GAAACACCGGTGAGCGGTACGGATTTGTGGGGTTAAACATGGAAATTGCA	1	bc
GAAAGAGATA	GAAACACCGGTGAGCATGGTATCGACGTGGGGTTAGAGCTAGAAATAGCA	1	bc
GAGAAACGCG	GAAACACCGGTAATCTAAAGATCCCCGTGGGGATAGAGCTAGAAATAGCA	1	bc
GAATTATCTA	GAAACACCGGTGGTCATGATCTCGTCGTGGGGGTGAAACTAGATATAGCA	1	bc
GGACAGGAAA	GAAACACAGGTGTGCTTAGCTCGAGAGAGGGCATGGAGCTCGAAATCTAA	1	bc
GACTAACCCA	GAAACACCGGTGCGAATAGTTTGTTCGTGGGGTTAGAGATAGAAATAGCA	1	bc
TAAGCGAACA	GAAACACCGGTGGAGTTAGTGATATAGAGGGGAAGTTAACAAAAGGCTAA	1	bc
GAATGGGCCA	GACACACCGGTTGTGGGGAACTCGGTGTGGGAGAAATAGCAAGTTAACCT	1	bc
GTGTGCTATA	GAAACACCGGTCGGATGCCTCAGGTGGTGGGGTTAGAGCTAGAAATAGCA	1	bc
TACGCCATCA	GAAACACCGGTGGGGTTAAAGCTAGCGAGGGGATATTGACCTAAAGATCA	1	bc
ACCCCCCACG	GAAACACCGGTCCTAGGAGTCCAGGGTGTGGGGTTAGAGTAAGAAATACA	1	bc
TTTTTCGCTT	GAAACACCGGTCTTCCTGGAATCTACGTGGGGTAGAGCTAGAAATAGCAA	1	bc
TCATCCCACC	GAAACACCGGTGGGGTTAGAGCTAGAAATGGCATGTTAACCTAAGGCTAG	1	bc
CGTTAATCCC	GAAACACCGGTGATCACAGGACGTTTGGGGGTTTGAGCTAGAAATAGCAA	1	bc
GATAGATATA	GAAACACCGGTGAGCATGATAACGTCCGTGGGGTTAGAGCTAGAAATAGC	1	bc
CGGAGGGCCG	GAAACACCGGTGCTCTTTAGGAGGCCTTGGGCTTGGAGTTAGAAATAGCA	1	bc
GACACGCACC	GAAACACCGGTTCAACAAGCGTCTTTGGGGGGGTTGAAGCTAAAAAAAGC	1	bc
CAATGAGCTA	GAAACACCGGTTGAGGGGAACTCGGTGTGGGAGAAATAACAAGTTACCCT	1	bc
CTGCCCGTTG	GAAACACCGGTCCTAGAAGCTGTGTTTGTGGGGTTAGAGCTTGAAATAGC	1	bc
AAATTACTAG	GAAACACCGGTTTAGGTACTTAGGACGTGGGGTTAGGCTAGGAATAACAA	1	bc
GCCTCTCAAA	GAAACACCGGTTCTATTTACTTACGGGTGGGGTTAAAGCCAGAAATATCA	1	bc
GTGGCTTCCT	GAAACACCGGTGCCCGTTAGCTCGTAGTGGGTAGAGATCGAGATATCGCA	1	bc
GACAGCTAAG	GAAACACCGGTGGCAGCCAGCCACTTGTGGGGTTAGAGCTAGAAATAGCA	1	bc
ATGACAGACT	GAAACACCGGTCCTAGAAGCTGAGTTTGTGGGGTTAGAGCTAGAAATAAC	1	bc
TCAACTACAA	GAAACACCGGTGGGGGTAGAGCTAGTAGTAGTAGGTTAACCTAGGGCAAG	1	bc
GTAAAATACG	GAAACACCGGTGGCACCGATCCACTTGTGGGGTTAGAGCTAGAAATAGCA	1	bc
CCGGCAATAG	GAAACACCGGTCATGGTAGAGCTGGAGATGGGGTGGTACCCTAAATCTCG	1	bc
ACCGCCGCCC	GAAACACCGGTAGACTGGATCCACGGGTGGGGTTAGAGCTAGAAATAGCA	1	bc
GAGCGAAGTG	GAAACACCGGTTATCGCTACGGATTTGTGGGGTTAGAGCTAGAAATAGCA	1	bc
AATAATGCCG	GAAACACCGGTGCCCTTTATGGGACCGTGGGTTTAGAGCTAGAAATAGCA	1	bc
CCCCAGCATC	GAAACACCGGTGTTCTTTGCTCGAGGGTGGGGTTAGAGCTAGAAATAGCA	1	bc
CACTACACAC	GCAACACCGGTAATCTAAAGATCCCAGTGGGGATAGAGCTAGAAATAGCA	1	bc
GTATCATCTA	GAAACACCGGTGAGCATGATAACGTCCGTGGGGTTAGAGCTAGAAATAGC	1	bc
CAGTTAATCA	GAAACACCGGTGGGCGGAGCTTATGCGTGGGGAAAAGCAAGTAACCAGAG	1	bc
ATAACATAAA	GAAACACCGGTGAGCATGGTAACAGCGTGGGGTTAGAGCTAGAAATAGCA	1	bc
CTCTACCCGC	GAAACACCGGTAGAATGGATCCACGGGTGGGGTTAGAGCTAGAAATAGCA	1	bc
GATACATAAA	GAAACACCGGTGAGCATGATAACGTAAGCGGAGTTAGAGCTATAAACAGC	1	bc
ACCTAGCAAC	GAAACACCGGTTCAACCTGCGTCTTTTGTGGGGCTAGAGCTAGAAATAGC	1	bc
ACTCCCATAA	GAAACACCGGTTTCGTATGGAGGGAAGTGGGGTTAGAGCTAGAAATAGCA	1	bc
AATACAGTCG	GAAACACCGGTCCTAGAAGCTGAGTTTGTGGGGTTAGAGCTAGAAAAAGC	1	bc
CCGCGCGGCG	GAAACACCGGCCAGCGATCGTAAGGTGATCGAATGCTAGTAGGATAACAA	1	bc
GAACGGGAAT	GAAACACCGGTGCTCGTGGCTTGAGGGTGGGGTTAGAGCTAGAAATAGCA	1	bc
TCGCGGGGAT	GAAACACCGGTCGTCTTTCGTAGGGCGTGGGGTTAGAGCTAGGAATAGCA	1	bc
ATGCGCGAAA	GAAACACCGGTGAGATGCGTCAGGGGGTGTGGTTAGAGCTAGAAATAGCA	1	bc
GAATTGCAAC	GAAACACCGGTGCTCTTTGCTCGCTCGTGGGGTTAGAGCTAGAAATAGCA	1	bc
ATGACAGAAA	CTAAACACCGGTCCTGGAAGCTGAATTTGTGGGGATAGAGCTAGAAATAG	1	bc
TAATTACCGC	GAAACACCTGTGTGCGGTGGTTATGCGTGAGTAATAGCAAGCAACCTAAT	1	bc
CACCACCCCC	GAAACACCGGTGGCATTTATCCACGAGTGGGGTTAGAGCTAGAAATAGCA	1	bc
