GTACTATCTC	GACACACCGGTGAGCATGATAACGTCCGTGGGGTTAGAGCTATAAATAGC	1	bc
AAAAGGGTAG	GAAACACCGGTTTTCGCGGATTGGACGTGGGGTTATAGCTAGAAATATCA	1	bc
AGCAGTGCAA	GAAACACCGGTTCTGGTGAGCTCGGGGGGGTAGAGCTAGAAAGAGCAAGT	1	bc
AAATCCACAA	GAAACACCGGTTGTGGGGAACTCGGTGTGGGAGGAATAGCAAGTTAACCT	1	bc
GCAGCAGTAA	GAAACACCGGTACTAGTAGCTTACGGGTGGGGATAGAGATAGAATTCGCA	1	bc
GAATCACACT	GAAACACCGGTTATCGGTACGGATTTGTGGGGTTAGAGCTAGAAATAGCA	1	bc
TAATTCCCCC	GAAACACCTGTCGCGAAAGTGAGGGGGTGGAGCTAGAAATAGCAAGATAA	1	bc
AAATACCCGC	GAAACACCGGTGTGCGGAGATTATGCGTGAGAAATAGCAAGTAAACTAAG	1	bc
GCAACAATCG	GAAACACCGGTGATCGGTACGGTTTTGCGGGGTTTGGCATAGAAATATAA	1	bc
TCAGCCCACC	GAAACACCGGTGGGGTTAGAGCTAGAAATAGCAAGTTAACCTAAGGCTGG	1	bc
ATGCCAGACG	GAAACACCGGTCCTAGAAGCTGGTTGTTAGAGGCTAAGGCGGGTTAGAGC	1	bc
GTGAAAGAGA	GAAACACCGGGGGGTTAGAGCTAGAAATGGCAAGTTAACCTAAAGCTAGG	1	bc
GTATTATACC	GAAACACCGGTGAGGATGATAACGTCGGGGGGTTAGAGCTAGAAATAGAA	1	bc
GGTTCATCCG	GAAACACCGGTTATCGTTGCGGTTTTGTGGTGTTATAGCGATAGTCAGTT	1	bc
TAGACAGCCC	GAAACACCGGTTTTCGTTAGTTGGGAGTGGGGTTAGAGCTAGAAATAGCA	1	bc
ATGATATAGA	GAAACACCGATGAGCATGATAACTTGCGTGGTAATAGAGCGAGAAATAGC	1	bc
GAAATGGCTA	GAAACAACGGTTATCGGGAAAACGTCGTGGGGGTTATAGCTAGTAATCGC	1	bc
GAATGGGTAA	GAAACACCGGTGGTGGTTAATTACGGGTGGGGGTAATAGCAGAATTACCA	1	bc
CCGATAGCCC	GAAACACCGGTCCTAGAAGCTGAGGGTTAGGCGCTGAGTAGGGATTGAGC	1	bc
TAATCCATAA	GAAACACCGGTGATCAACGGAAGGCAGGGGGGTTAGAGCTAGAAATGCCA	1	bc
CCACCGATGC	GAAACACCGGTTTAGTAGGTAGGGTAGGGGGGTTAGAGGCAGGAAAAAGA	1	bc
GAAATGATAG	GAAACACCGGTTTTCGTTCATAGGTCGTGGGGTTAGAGCTAGAAATAGCA	1	bc
TAGTTCGTCC	GAAACACCGGTTGAGATAATAAAAAGGTGGGGTAGAGCTAGAAATAGCGA	1	bc
ACGTCAACCA	GAAACACCGGTTGTCTTTACTCCTTTGTGGGGTTAGAGCTATAAATAGCA	1	bc
AATATCACAC	GAAACACCGGTTGTAAGCGATGGTTTGTGGGGTTAGAGCTAGAAATAGCA	1	bc
CTGGGGCAGC	GAAACGCCGTGGGGTTAGAGCTAGATATAGCAAGTTAACCTAAGGCTAGT	1	bc
GATCTATCTC	GGAACACCGGTGAGCATGGTAACGCCGGTGTGGTTAGAGCTAGAGTTAGC	1	bc
CCGTGGGCCC	GAAACACCGGTTGTCTCGACTTCGTTGTGGGGGTAGAGCTACAAATACCA	1	bc
GAGTCACGAA	GAAACACCGGTGACAATTACGGATTTGTGGGGTTAGAGCTAGAAATAGCA	1	bc
TAAACCAATG	GAAACACCGGTTTAGTATGGAGGGAATTGGGGTTAGAGCTAGAAATAGCA	1	bc
GACAACCTCC	GAAACACCGGTAATCTAAAGATCCCCGTGGGGATAGAGCTAGAAATAGCA	1	bc
AACCCCTCCC	AGGGGACGGAACACCGGTGACAAACGTATGTCAGTGGGGTTAGAGCTAGA	1	bc
GATTCTCTAA	GAAACACCGGTACTAGTTATTTACGGGTGGGGTTAGAGCTAGAAATAGCA	1	bc
ATCACTCCCT	GAAACACCAGAAATAGCAAGTTAACCGAAGGCTAGTCCGTTATCAACTTG	1	bc
ATGACAATAG	GAAACACCGGTCCTAGAAGATGAGTGTTTGAAGATGTGTGCGATTAGAGC	1	bc
GTCTATGGCA	GAAACACCGGTACTAGATACTTAGGGGAGGGAATAGAGGTAGAAAAAGAA	1	bc
GAACGTGAAT	GAAACACCGGTGCTAGTGGCTTAGGGGTGGGGTTAGAGTTAGAAATGGAA	1	bc
CCCATACCAC	GAAACACCGGTTCCCGTTAGCTCGTGGGGGTAGTGCTAGTAATAGCAAGT	1	bc
CGGTTCTCAC	GAAACACCGGTTGGCTTTACTCCTTTGTGGGGTTAGAGCTATAAATAGCA	1	bc
TTCCCATCTT	GAAACACCGGTCTTCCTGGAATCTACGTGGGGTAGAACTAGAAATATCAA	1	bc
GGATCAGAAT	GAAACACCGGTGCTAATAGTTAGCTCGTGGGGTTAGAGCTAGAAATAGCA	1	bc
GTCTATCCAA	GAAACACCGGTACGCGTTACTTACGCGTGGGGAATGACCAAGAAACTGAA	1	bc
AAATCAACAA	GAAACACCGGTTTAGTAAGGAGGGAAGAGGGGTTGGAGATAGAAATAGCA	1	bc
TGATCATCCC	GAAACACCGGTGAGAAAAGGACGTTTTAGGGATAGAGCTAGAAATAGCAA	1	bc
TAATCCAAAC	GAAACACCGGTTGAGTTAGTCAAATAGTGGGGTAGAGCTAGAAATAACAA	1	bc
AAACCGATCC	GAAACACCGGTGTTGTTTGTGCGAGGGTGGCGTTAAAGCTAGAATTAGCA	1	bc
CAATCAGAAT	GAAACACCGGTGCCCGTTGGTTCGAAGTGGGGTTAGAGCTAGAATTGGCA	1	bc
GCATCATATA	GAAACACCGGTGCGCATGATAACGTCCGGGGGGTTAGAGCTAGAAATAGC	1	bc
AGTATTATAT	GAAACACCGGTGCGCATGATAACGTCCGTGGGGTTAGAGCTAGAAATATC	1	bc
GGCAACTACG	GAAACACCGGTGGCTAGAATTAGCAGGTTAAGCTAAAGCTAGTCCGATAT	1	bc
GATACCTCCC	GAAACACCGGTAAGCTAAGAACGTTCTGGGGGTTAGGGTAGGAATTGCCA	1	bc
AAACCAAGAC	GAAACACCGGTTTAGTAAGGGGTGAAGAGGGGTTAGAGCTATAAAGAGCA	1	bc
GACACAGCCT	GAAACACCGGTTTTAGTTAGTGGTGAGTGGGGTTAGAGCTAGAAATAGCA	1	bc
GAACTATCAC	GAAACACCGGTGATAAACGTTAGTCAGTGGGGTTAGAGCTAGAAATAGCA	1	bc
AAATTACCGC	GAAACACCGGTGTTCGGAGATTGTGCGTGGGGCTTAGCAAGTAACCTAAG	1	bc
GTGTAAACCG	GAAACACCGGTTATCGTTCAGGATTTGTGGGTATAGAGATAGAACCAGCA	1	bc
AACCTCCTCG	GAAACACCGGTTTTATATCTTAAGTGGTGGGGTTAGAGCTAGAAATAGAA	1	bc
TTATATTTAC	GAAACACCGGTGAGCATGATAACGTCCGTGGGGTTAGAGCTAGAAATAGC	1	bc
AAATCGGCAG	GAAACCCCGGTTTTAGTAAATGGGGGGTGGGATTAAAGACAGAACAAGCT	1	bc
ATCTAGCAAC	GAAACACCGGTGTTCTTTGCTTATGTTTGGGGGTTAGAGCTAAAATTAAC	1	bc
ACTAGGGCCA	GAAACACCGGTTGTTGGGGACTGGGAGTGGGAGAAATAGCAAGTTAACCT	1	bc
GAATTACCCC	GAAACATCGGTGGGGGAAAATTGTGAGTGGCAAGTTAGCCTAAAGCTAGA	1	bc
AATTTCTCAA	GAAACACCGGTTGTGGGGAACTCGGTGTGGGAGAGATAGCAAGTTAACCT	1	bc
CTTTTAACCG	GAAACACCGGTCGCGAAAGTATGTTTTGGGGGTAAGTCTCAGAATAGCCA	1	bc
AGCTCTTACT	GAAACACCGGTTCCCGTCAGCTCGTGGGGTTAGAGCTAGAAATAGCAAGT	1	bc
TATCCAGCAT	GAAACACCAGTCTTCCTGGCATCTCCGTGGGGTTAAGCTAGAAATAGCAA	1	bc
ATGACAACAC	GAAACACCGGGCCTAGAAACTGATTGTTGGGCGCTGAGAGGTATTAGAGA	1	bc
AAACCAAGAG	GAAACACCGGTTATCGTTACGGATTTGTGGGGTTAGAGCTAGAAATAGCA	1	bc
TCGTCAGCCT	GAAACACCGGTTGTCTTTACTCCTTTGTGGGGTTAGAGCTATAAATAGCA	1	bc
GTCTATTCCC	GAAACACCGGTCGCGAATATGTGGGGGTAGGGCTAGAAATAGCAATATAA	1	bc
ATGTAAAGCG	GAAACACCTGTTATCGGTAAGGATTTGTGGGGTTAGAGCTAGAACTAAAA	1	bc
AGATTACAAC	GAAACACCGGTTTTCTTTGCTCGATGGTGGGGTTAGAGCTAGAAATAGCA	1	bc
GCCTCAGACA	GACACACCGGTTTTAGTAGCTGGTGAGTGGGGATAGCGCTAGAAATAGCA	1	bc
CGTTGGGCTA	GAAACACCGGTTGTGGGGCACTCGGTGTGGGAGAAATGGCAAGTTAACCT	1	bc
TCGGCAACAC	GCAACACCGGTGGGGTTAGCGCTTGTGATGGCAAGTTACCATCAGGCTCG	1	bc
GTCTTATACA	GAACCACCGGTGCCAATAATTCGCCCGTAGGGTTAGAGCTAGAAATAGAA	1	bc
GACTTACTAG	CTAAACACCGGTTTTCGTTCCTAGGTTGTGGGGTTAGAGCTAGAAATAGC	1	bc
CCACCCATGC	GAAACACCGGTAGAGTGGATCTAGGGCTAGAATTAGCAAGAGAAACTGAA	1	bc
GCATTCATCA	GAAACACCGGTGCTGATAGGTATCTCGTTGGGTTAGAGCTAGAAATATCA	1	bc
GCCTCAAGAG	GAAACACCGGTAATCGTTACGGATTTGTGGGGTTAGAGCTAGAAATAGCA	1	bc
CTCACCCACC	GAAACACCGGTTCTACCGGCGTCTTTTTGGGGGTTAGAGTTAGAATTGGC	1	bc
CCTTTATAAC	GAAACACCGGTTGGCTTTACTCCTTTGTGGGGTTAGAGCTAGAAATAGCA	1	bc
ATTTCGCCCC	GAAACACCGGTTGTGTGGAACTCTGTGTGGGGGTAGAGCTAGGAATAGCA	1	bc
CAACGCATGC	GAAACACCGGTAGAGTGGGTCGAAATAGCAAGTTAAACTAAGGATAGGCA	1	bc
AACACGCAAT	GACGGAACAACGGGTTTAGATCGTAGACTGGGGGGTTTGAAGTAGGAAAT	1	bc
CGGCGCTCTC	GAAACACCGGTCGTCGATCGTAGGCCGTGGGGTTAGAGCTAGAAATAGCA	1	bc
CAGATACTAG	GAAACACCGGTTTTCGATCATAGGTCGTGGGGTTAGAGCTAGAAATAGCA	1	bc
GACTCTGCCC	GAAACACCGGTAGAATGTATCCACGGGTGGGGTTAGAGCTAGAAATAGCA	1	bc
GCGTCGCGAC	GAAACACCGGTTATCGCTGCGTATTTGGGGGGTTTGGGGTAGAAATAGGC	1	bc
ATAACCGATG	GAAACACCGGGGGGCGTTATAACGAGCAATGGGATAGTGATCTAAAGCGA	1	bc
GACGCAGACG	GAAACACGGGTTTTAGCAAATGACGAGTGGGGTTAGAGCTAGAAATAGCA	1	bc
TAAACCCAAT	GAAACACCGGTTTACTTAGTTAACTAGTGGGGTTAGAGCTAGAAATAGCA	1	bc
GGAAAAAATA	GAAACACCGGTGAGCATGATAACGTCCGTGGTGTTAGAGCTAGAAATAGC	1	bc
GGAGCACAAA	GAAACACCGGTGGGGGTAGAGCTAGAGATAGAGAGTTAACCTAAGGCTAG	1	bc
AAACCAGTTT	GAAACACCGGTTTAGTTTGGAGGGAAGTGTGGTTGGAGTTAGAAATAGCA	1	bc
AGGCGGCCAG	GAAACACCGGTTGTGGTTCGTACTACGAGGGGCTAGATCTAGTAAGACTA	1	bc
AATTTAGCCG	GAAACACCGGTGCTCATAATGGGATCGTGGGGTTAGAGCTAGAAATAGCA	1	bc
TGGACTGTCG	GAAACACCGGTCCTAGATACTGAGTTTTGGGGTTTAGATCTAGAATTAAA	1	bc
GACTTCCACC	GAAACACCGGTAATCTAAAGTTCCCCGTGGGGATAGAGCTAGAAATAGCA	1	bc
TACACTCACT	GAAACACCGGTTCCCGTTATCTCGTGGGGTTAGTGCTGGAAATAGCAGGA	1	bc
AGCACTCCCC	GAAACACCAGAAATATTAACTCAACCTATGGCAAGTCCGCCACCAACTTG	1	bc
AGCAAGCTAC	GAAACACCGGTGTTCGTTGCTCGAGGGTGGGGTTAGCGCTCTAAATAGAA	1	bc
TGCGTCCCCC	GAAACACCGGTCGCGAAAATGTGGGGTTAGAGCTAGAAATAGCAAGCGAA	1	bc
TTAAAAATAT	GAAACACCGGTGAGCATGATAACGTCCGTGGTGTTAGAGCTAGAAATAGC	1	bc
ATTACCACCC	GAAACACCGGTTGTAAGCGATGGTTTGTGGGGTTAGAGCTAGAAATAGCA	1	bc
TCCGCAACCA	GAAACACCGGTGGGGTTAGAGCTAGAAATAGCAAGTTAACCTAAGGCTAG	1	bc
AAACCCCTAT	GAAACACCGGTTTAGTTTGTAGGGTAGCTTGGTTTGAGCTATAATTATCA	1	bc
AATACCGCCT	GAAACACCGGTTTCCTTTATGGGATCGTGGGGTTAGAGCTAGAAATAGCA	1	bc
TTAATATGCA	GAAACACCGGTGAGCATGATAACGTCCGTGGGGTTAGAGCTAGAAATAGC	1	bc
TCAGTAAACC	GAAGCACCGGTGGGGATAGAGCTCGAGATGGGAAGTTACCCTAAGGCTAG	1	bc
CAAACCGACT	GAAACACCGGTCCTAGAAGCTGGGTGTTAGGAGCTGAGTGGGGATAGAGC	1	bc
GGTTATCAAC	GAAACACCGGTGAGAACAGAACGTTTTGGGGTTAGAGCTAGAAATAGCAA	1	bc
AACAATCTAA	GAAACACAGGTTTTCGTTCCTAGGGAGTGGGGTTAGAGCTAGAAATAGCA	1	bc
ATTTGGGATA	GAAACACCGGTTGTGGGGAGCTCGGTGTGGGGGACATAGCCAGTTAACCT	1	bc
GTATGAGATA	GAAACACCGGTTTGCATGATCTCGTTCGTGGTGTTATAGCTAGATATAGT	1	bc
ATGAGCGTTT	GAAACACCGGTGCTAGAGGCGTCGTTATGGGTTGAGAGCGCAAGATAACA	1	bc
TGCACCTACG	GAAACACCGGTTTTAGTAAATGGTGAGTGGGGTTAGAGCTAGAAATAGCA	1	bc
ACTAGGCCCA	GAAACACCGGTTGCGGGGGACTCGGAGTGGGAGAAATAGCAAGTTAACCT	1	bc
CCTTCACCAC	GAAACACCGGTGGCCTTTCGACCTGTGTGGGGTTAGAGCTATAAATAGCA	1	bc
AAATAAAACC	GAAACACCGGTTCAGCCGGTGTCTTTTGTGGGGTTAGAGCTAGAAATAGC	1	bc
AGTAATCTAT	GACACCCCGGTGAGCATGGTAACGTCCGTTGGGTTAGAGCTAGAACTAGC	1	bc
GAATTCACCT	GAAACACCGGTGCTCATAGTTAGCTCGTGGGGTTAGAGCTAGAAATAGCA	1	bc
GACAACCTCC	GAAACACCGGTAATGTAAAGATTCGCGTGGGGGTAGTACCAGAAAAACCT	1	bc
GAGAAGGCCG	GAAGCACCGGTGCCCTTTATGGGACCGTGGGGTTAGAGCTAGAAATAGCA	1	bc
AGAAACGAAG	GAAACACGGGGGGTTAGTGCTCGAGGTTGGGAGTTGACCTAGAGATAGTC	1	bc
AGAATATGTC	GAAACACCGGTACTAGTTACTTACGGGTGGGGTTAGAGCTAGAAATAGCA	1	bc
CCTTCAAAAC	GAAACACCGGTGGGAATTAGTTCTGAGTGGGGTTAGAGCTAGAAATAGCA	1	bc
GTACTACAAC	GAAACACCGGTGAGCATTATCACGTCCGTGGGGTTAGAGCTGAAATTGGC	1	bc
TAAACCTCCT	GAAACACCGGTTTCCTATGGCGCAAAGTGGGGTTAGAGCTAGAAATAGCA	1	bc
AATCCAGAAT	GAAACACAGGTCTTACTGGAATCTACGTGGGGTTAGGGTAAGAATAACCA	1	bc
AACATTCCAT	GAAGCACCGGTTTTCGATCATAGGTCGTGGGGTTAGAGCTAGAAATAGCA	1	bc
ACCGCAAGAA	GAAACACCGGTGGGGTTAGAGCTAGAAATAGCAAGTTAACCTAAGGCTAG	1	bc
AACATAAAAG	GAAACACCGGTTTTCGATCATAGGTCGTGGGGTTAGAGCTAGAAATAGCA	1	bc
GAGTATGGCG	GAAACACCGGTTATAGTTACGGATTTGTGGGGTTAGAGCTAGAAATAGCA	1	bc
GTGTGAGCGC	GAAACACCGGTGGGTGGGGTTAGAGCTGGGAATAGAAAGTTAACCTAAGG	1	bc
CTGACAGTCA	GAAACACCGGTCCTAAAAGCTGCGTGTTGGGCGCTGAGTGGGATTAGAGC	1	bc
ATGCCAGTAG	GAAACACCGGTCCTAGAAGCTGGGTGTTAGGAGCTGAGTGGGGTTAGGGA	1	bc
ACGTCGGCCC	GAAACACCGGTTCTCGTTCCGTCTGCGTGGGGTTAGAGCCAGAAATAGCC	1	bc
TCATCCTCCC	GAAACACCGGTGGGGTTAGTGCTAGAAATAGCATGTTAACCTAAGTCTCG	1	bc
CCAATAACTC	GAAACACCGGTGAGCCTGACTCCATAGCGTGGGTTTAGATCTAAATATAA	1	bc
GAGTAAGGAA	GAAACACCGGTACTAGTTACTTACGGGTGGGGTTAGAGCTAGAAATAGCA	1	bc
TTGACCAAAG	GAAACACCGGTCCTAGAAGCTGAGTGTTAGAAGCTGAGTGGGGTTAGAGC	1	bc
GAATGGGTTG	GGAACACCGGTCTTAGTACATGGTGTTAGGGCTAAGATTTACAAGTTACA	1	bc
GAGCCAACAG	GAAACACCGGTTATCGATGCGTGTTAGTGGGGTTAGAGCTAGAAATAGCA	1	bc
AACTCGGTAG	GAAACACCGGTTTTAGCTCGTAATTCGTGGTTTTACAGCTAGTAGTAGCA	1	bc
AAACCATTAA	GAGAAACCGGTTGTGAATGGAGGGAAGGGGGGTTAGAGCCAGAAAAAGCA	1	bc
TCCTCGGATT	GAAACACCGGTTCAACCGGCGTCCTTTGTGGGGTTAGAGCTAGAAATAGC	1	bc
AATCCCCCCC	GAAACACCGGTAATATACGTATCCCCGTGGGGATAGAGCTAGAAATAGCA	1	bc
ACGAACGCCG	GAAACACCGGTGGGGTTGATGCAAGGGTGGGGTTAGAGCTAGAAATAGCA	1	bc
AATTCTGTAA	GAAACACAGGTTCTGGGGAACTCGGAGTGGGAGGAATAGCAAGTTAACCT	1	bc
AAATATGAAC	GAAACACCGGTGCTCTTTGCTCGCGGGTGGGGTTAGAGCTGGAAATAGCA	1	bc
GATATATAAA	GAAACACCGGTGAGCATGGTAACGTCGGGGGGGTTAGAGCAAGAATTAGC	1	bc
AATCTAGCAG	GAAACACCGGTGTTAGAAGATGTGAAGTGGGGTTAGAGCTAGAAATAGCA	1	bc
AACCCTTCAT	GAAACACCGGTTACAAATGTATGGCAGTGGGGTTAGAGCTAGAAATAGCA	1	bc
AACACACTCG	GAAACACCGGTTTTAGATGATGGGTTGTGGGTATAGATCGCGAAATAGCA	1	bc
AACTTACCAG	GAAACACCGGTGTTAGAACATAGGTCGTGGGGATAGAGATAGAAATAGAA	1	bc
CCACAGCCAC	GAAACACCGGTTGGCTTTTCTCCTTTGTGGGGTTAGAGCTATAAATAGCA	1	bc
AAGACCGCAT	GAAACACCGGTCCTAGAAGCTGAGTGTTAGAAGCTGAGTGGGGTTAGAGC	1	bc
CAACAAGAAA	GAAACACCGGTGCTAGCGGTTTCGAAGTGGGGTTAGAGCTATAAATAGCA	1	bc
GGACAGCACG	GAAACACCGGTGTTATTTGGTCGCGTGTGGGGTTAGAGCTAGAAATAGCA	1	bc
ACCTACCCCC	GAAACACCGGTAGACTGGGTCGATATATCAGGTTAACCTGATGCTCGTCG	1	bc
CAACGTGTAA	GAAACACCGGTACTAGCTGCTTACAAGTGGGGTTAGAGCTAGAAATAGCA	1	bc
GTGGATGTGA	GAAACACCGTGGGGATAGAGTTAGAAGTGGGAAGTTAACTTAAGGCTAGA	1	bc
ATGACGCACG	GAAACACCGGTCTTCGTTGCTGGGGGGTGGGGTTAGAGCTAGAAATAGCA	1	bc
CCATCACACA	GAAACACCGGTGCAACTAAAGTCTGATGTGGCAAGAGAGCCTAAAATAAC	1	bc
GGGCCCGAGC	GAAACACCGGGGTGGTAGAGCTAGAAATAGCAAGTTAACCTAAGGCTAGT	1	bc
ATGAGCGCCA	GAAACACCGGTCCTAGAAGCTGCGTTTTGGGAGCTGTATCGAGTTAGAGC	1	bc
AGATCGCCCC	GAAACACCTGTGTTCTTTACGCGATAGTGGGGTTAGAGCTAGAAATAGCA	1	bc
GGATAAGGCG	GAAACACCGGTGTTCGTAGATGGTGTGTTGGGTTAGAGCTCGAAATAGCA	1	bc
GAGTCTGTCG	GAAACACCGGTCCTAGTTACTTGCGTGTGGGGTTAGAGCTAGAAATAGCA	1	bc
CACCACATAA	GAAACACCGGTTTAGTATGGCGAGAAGTGGGGTTAGAGCTAGAAATAGCA	1	bc
ATCCGAGGGT	GAAACACCGGTGCGAGCGGTTTCTACGTGGGGTTTGAGCTAGAACTTGCA	1	bc
AACACACAAA	GAAAATGACGAAACACCGGTTTTCGATCATCGGGCGTGGGGTTAGAGCTA	1	bc
CTGACCCTAG	GAAACACCGGTCCTATAAGCTGAGTGTTAGGAGCTGAGCGAGATTAGAGC	1	bc
AAACCCCTCT	GAAACACCGGTTTAGTATGGAGGGAAGTGGGGTTAGAGCTAGAAATAGCA	1	bc
ACCTCAACAC	GAAACACCGGTTGGCTTTATTCCTTTGGGGGGAGATAACTAAAAATAACA	1	bc
AGAACGAGAT	GAAACACCGGTGGGGGTAGAGTTGAAGAGGGCAAGGAACTAGAAATAGAA	1	bc
CCCTGATGCC	GAAACACCGGTGGAATGGATCCGAATTGCGGGTTGACCTAAGGCTAGCCC	1	bc
GAATAGAAAC	GAAACACCGGTGCTCTTTGCTCGATGGTGGGGTTAGAGCTAGAAATAGCA	1	bc
TTCTTTTCAA	GAAACACCGGTCCTGAAAATTTACGGTTGGGGCTAGAACTAGAAAGATCA	1	bc
ATCTTCTTAC	GAAACACCGGTCGCGAAAATGTGTGGTTAGAGCTAGAAATATAAAGATAA	1	bc
TCAACCCTCT	GGAACACCGGTGACGCGAGGACGGTTAGAGCTAGAAATATCAAGTTAACC	1	bc
AACAGCGGCC	GAAACACCGGTAGAATGGGTCGAAATAGCGGGATAAACTAAAGATAAACC	1	bc
AACAACGTCA	GAAACACCGGTACTAGATGCTTACGGGTGGGTTGAGAGCGAGAGATAGCA	1	bc
AATCCCATTT	GAAACACCGGTTTAGTATGGATGGAAGTGGGGTTAGAGCTAGAAATAGCA	1	bc
GTGCGCCACT	GAAACACCGGTTATAAGCGTCGGATTATGGGGTTAACCCAAGGCTTAGCC	1	bc
AAACGCCGCA	GAAACACCGGTAGAATGTTAGAGCTAGAAATAGTAAGTTAACATATGGCT	1	bc
TCGGCAAGCG	GAAACACCGGTTATCGTTACGGTTTAGTGGGGTTAGTGCTATAAATATCA	1	bc
TGGAGAGATT	GCAACACCGGTCTGCCTGGAATCTTCGGGGGGAAGAGATAGAACTAGCAA	1	bc
AACAGTGCCA	GAAACACCGTTAATGGGAAACTCACCGTGGGGTAATCGCTTGTTAACTTA	1	bc
GCCGCAAGCA	GAAACACCGGTGGTGGCAGTGGTGGGGAGGGGTTAGAGATAGGAGGAGCA	1	bc
TGTCTTTTCC	GAAACACCGGTCGCGAAAATGTGGGGTTAGAGCCAGAAATAGCAAGTTAA	1	bc
GTATTATACT	GAAACACCGGTGGTAATAGTTAGCGGGTGGGGTTAGAGCTAGAAATAGCA	1	bc
TCCAAAACCA	GAAACACCGGTGCTGTTAATGTCACCGTGGGGATAGAGCTAGAAATAGCA	1	bc
GTGTGCGCAA	GAAACACCGGTGAGCGGGACTAGAGCTAGAAATAGCAGGTTAAACTAAGG	1	bc
CTGCGGGTGA	GAAACACAGGTCGGCGGTCGTTGTGCGTGAGAATAAGGCAGGAACCTAAA	1	bc
CAGTTCCCAC	GAAACACCGGTTGGCTTTACTAATTTGTGGGGTTATAGCTATAAATAGCA	1	bc
GCCTCAAAAC	GAAACACCGGTTCAACCGGCGTCTTTTGGGGGGTTAGAGCTAGAAGAGGC	1	bc
GACAAAATTC	GAAACACCGGTGAGCATGATAACGTCCGTGGGGTTAGAGCTAGAAATAGC	1	bc
AGAGCACAAA	GAAACACCGGTGGTGTTAGATCTAGAAATAGCAAGTTAACCTAAGGCTAG	1	bc
AAATGAACGA	GAAACACCGGTTTCGTGGGAATGGAAGTGGGAGTAGTGCTAAGAATACCA	1	bc
TGCTCTTCAA	GAAACACCGGTTCCCGTTACTTCGTGGGGGGGGTACTAGAAAAAACAGGT	1	bc
GGTTTAAATT	GAAACACAGGTCCTACTAGATACTTCGTGGGGTTGAACTAGAAAATACAA	1	bc
AAGTCAACAG	GAAACACCGGTTATCATTGCGTGTTTGTGGGGTTAGAGCTAGAAATAGCA	1	bc
GTCATATCCA	GAAACACCGGTGAGCATGTTAACGTCCGTGGGGTTAGAGCTAGAAATAGC	1	bc
CAATCAGTAA	GAAACACCGGTTTAGTATGGAGCGGAGTGGGGTTAGAGCTAGAAATAGCA	1	bc
