CGCCCGCATC	GAAACACCGGTCTTCCTGGCGTCTTTGGGGGGGTTAGAGATAAAAATCGA	1	bc
TAGACCGTAA	GAAACACCGGTTCAATTAGCTAACTAGTGGGGTTAGAGCTAGAAATAGCA	1	bc
AATCCGATAA	GAAACACCGGTTTAGGGTGGAGGGGAGTGGGAGTAGTGCTAGGTTAAGCT	1	bc
CTGATAATAC	GAAACACCGGTCGGCTTTACTCCTTTGTGGGGTTAGAGCTATAAATAGCA	1	bc
AACAAGTACG	GAAACACCGGTGCCCTGTATTAGACCGTGGGGTTAGAACTAGAAATAGCA	1	bc
CGCTCGTCAG	GAAACACCGGTGTTAACAGATCGTTCTTGGGTTAGAGCTAGAAATAGCAA	1	bc
TATTGGGCCC	GAAACACCGGTTGTGGTGGACTCGGTGTGGTAGAAATAGCAAGTTAACCT	1	bc
TCATCCATCC	GAAACACCGGTTGAGATAATCAAAGAGTGGGGTGGGGCTAAGAATAGGCA	1	bc
AAATTGGCAC	GAAACACCGGTTGTGGGGAACTCGGTGTGGGAGAAATAGCAAGTTAACCT	1	bc
TTTCCCGAGT	GAAACACCGGTCGTGATAGAATCCGCGTGGGCAAGATCTACTAAGACCAC	1	bc
GTGTTCTATC	GAAACACCGGTCAGGTGCCTCGAAATAGCGGGTTAACCTAAGACTAGTCC	1	bc
TGCTTCGATT	GAAACACCGGTCTTGATGGAATCTACGTGGGGTAAAGCTAGAAATAGCAA	1	bc
GAAACACACT	GAAACACCGGTTTACGTAATTAGCTAGTGGGGTTAGAGCTAGAAATAGCA	1	bc
ATGTGCGAGC	GAAACACCGGCGAGATGCCTCGAAATAGCAAGTTAACCTAAGGCTAGTCC	1	bc
AATTTATCAA	GAAACACCGGTTGGGTTGAACTTGGAGATGGAAAGTTAACCAATTAATAG	1	bc
ATCCCTCTCC	GAAACACCGGTGACAAACGTATGTCAGTGTGGTTAGAGCTAGAAATAGCA	1	bc
GAGGGCGATT	GAAACACCGGTGAGATGCCTCGAGATAGCAAGTTAACCTAAGGCTAGTCC	1	bc
GTGTCCGACG	GAAACACCGGTTATAGTCCTCGATCGTGCAGGTTAACCTAGGACTAGTCC	1	bc
TGCTTGTACC	GAAACACCGGTTCCGATAATTTGCTGGTGGGGTTAGAGCTAGAAATAGCA	1	bc
TAAGCATCAA	GAAACACCGGTGGGGTTATAGCTAGAAATAGCAAGTTAACCTAAGGCTAG	1	bc
ATCACCTTAG	GAAACACCGGTCCTAGAAGCTGGGGTTAGAGCTAGAAATAGCAAGTTAAC	1	bc
TAAGAAATAA	GAAACACCGGTAGGGATAATGCAAGAGAGGGGAAGATAACATAAGAGTAA	1	bc
AACCAAACGA	GAAACACCGGTTTAGTGTGGTTGTGCGTGGGGTTAAGGAAGGAACTAACA	1	bc
GACACTGTAT	GAAACACCGGTACTCGTTACTTACGGGTGGGGTTAGAGCTAGAAATAGCA	1	bc
AAGCCCGTAG	GAAACACCGGTCCTAGAAGCTGGGGATAGAGCTTGAAATAGCAAGCTAAC	1	bc
GAAGGCGCGA	GAAACACCGGTGAGATGCCTCGGAATAGCAAGTTAACCTAAGGCTAGTCC	1	bc
ACGCGCGAAA	GAAACACCGGTGCGATGCGTCGATATAGCAGGTTAACCTAAGGCAAGGCC	1	bc
AACCACAAAA	GAAACACCGGTTTAGTATGGACGCAAGTGGGGTTAGAGCTAGAAATAGCA	1	bc
AGATCACCAA	GAAACACCGGTGAGCACAGATCGAGGGTTGGGGTAGAGATAGGCAAGTTA	1	bc
TGCTCTCCCC	GAAACACCGGTTCACGTTGGCTCTTAAGTGGGGTTAGAGCTAGAAATAGC	1	bc
CGGATAAAAA	GAAACACCGGTGCTAATAGTTAGCTCGTGGGGTTAGAGCTAGAAATAGCA	1	bc
AACACCCTCG	GAAACACCGGTGTTGCGACGTCGGTCGTGGGGTTAGAGCTAGAAATAGCA	1	bc
ACTGCGCACC	GAAACACCGGTTAAACCGGCGTCTTTTGTGGGGTTAGAGCTAGAAATAGA	1	bc
GATTCATCCA	GAAACACCGGTGATAACAGAACGTTTTGGGGTTAGAGCTAGAAATAGCAA	1	bc
TATCCCGCAT	GAAACACCGGTATTCCTGGTATATACGTGTGGTAAAACTAGAAATAGCCA	1	bc
TTCTAAGCTT	GAAACACCGGTGTGCGGAGATTATACGTGGGGTAGAGCTAGAAACAGAAT	1	bc
ATGCACTTCA	GAAACACCGGTTCCCGTTAGCTCGTAAGTGGGGTTAGAGCTAGAAATAGC	1	bc
CAAAGGCATT	GAAACACCGGTCGACTTAGTTAAGTAGTGGGGTTAGAGCTAGAAATAGCA	1	bc
GAAATATCAA	GAAACACCGGTTATGATGATAACGGTGGGGGTAGAAAAAGCAAGTTACCC	1	bc
GCATGAAGAA	GAAACACCGGTGCAAATAGTTAGCTCGTGGGGTTAGAGCTAGAAATAGCA	1	bc
CCACGCGCCC	GAAACACCGGTAGAATGGATCCACGGGTGGGGTTAGAGCTAGAAATAGCA	1	bc
TCAGAACCGA	GAAACACCGGTGGGCGGAGAGCATGAGTGAGAAAGATAAAGTAAGCCAAG	1	bc
GTGACCTACG	GAAACACCGGTCCTAGCAGCTCACTTTAGGGCTTGTAACAGCAAGTTAAC	1	bc
TAGCCAGATG	GAAACACCGGTCTTCGTTGAGTCTCAAGTTGGCTTAAGCCTAGAATGTTA	1	bc
GACTCAGCAA	GAAACACCGGTACTAGTTACTTATGGGTGGGGTTAGAGCTAGAAATAGCA	1	bc
AAATGAGCCA	GAAACACCGGTTGTGGTGAACTCGGTGTGGGAGAGAGAGCAAGTTAACAA	1	bc
ATGACAATCT	GAAACACCGGTGCTAGAAGCTTAGTTGTTAGAATTAGAAATTAAAATAAC	1	bc
TCTTGGACAA	GAAACACCGGTTGGGTGGGAGCTAGAAAGGGCGAGTTAACCTGTTAATCT	1	bc
GTACGGCAGA	GAAACACCGGTGAGATTTGCCACCGGTGTGAGATCGAGAAATAACAAGCT	1	bc
ATAAACCCGA	GAAACACCGGTTTGCGGAGATTATTCGTGGGAAAAAGCAAATAACTTACG	1	bc
ATCAAAAGGA	GAAACACCGGTGTTAGAAGCTTATCCGTGAGAAATAGCAAGTAACCTTAG	1	bc
GAAGCTATAA	GAAACACCGGTACTAGTTACTTACGGGTGGGGTTAGAGCTAGAAATAGCA	1	bc
GCCTTACCTA	GAAACACCGGTGGGGGGAGATTATGCGAGAGAAATAGCACGTAACCTAAG	1	bc
CGCCGGCCTG	GAAACACCGGTCGTCGTTGGTTGTGCGTGGGGATTGGGCTAGAAATATCA	1	bc
AACACTTTCT	GAAACACCGGTTCTCGTTAGATCGTAGGGGGGTTAGAGAGAGAAATAGCA	1	bc
TATTCACAAA	GAAACACCGGTTGCGATAATAAATGAGTGGGGTTGAGCTTGAAAATGCAA	1	bc
CCGCTACCCC	GAAACACCGGTTGGCTTTACTCCTTTGTGGGGTTAGAGCTATAAATAGCA	1	bc
TAAACCCAAT	GAAACACCGGTTTACTTAGTTAACTAGTGGGGTTAGAGCTAGAAATAGCA	1	bc
GTGACCGACA	GAAACACCGGTGCGCGAACTCGGGTTGTGGGGTTAAACTAAGGTTAAGCC	1	bc
CCGCCGATTG	GGAACACCGGTTTAGTTTGGAGGGAAGTGGGGTTAGAGCTAGAAATAGCA	1	bc
AAAATATAAA	GAAACACCGGTGTTCATGCTTACGTTGTGGGGTTAGAGCGAGAATTAGCA	1	bc
CAATCGAACC	GAAACACCGGTTCAGACGACCTATTAGGGGGGGATAGAGATAAAAATAAA	1	bc
TTAAAAAACC	GAAACACCGGTTGATATAATCAGCAAGTGTGGTAGAGCTAGAAATAGCAA	1	bc
AAACGCCGAC	GAAACACCGGTTGTCTGTTCCCGCGGGTTGGGTTAGAGCTATACATCGCA	1	bc
TAATCAACAA	GAAACACCGGTTGTGGTAGAGCTAGTGTGGGCAAGTTAACATAAGGATCG	1	bc
CCACGCCTCT	GAAACACCGGTGACGCGCGGCCGGGGGTAGAGCTAGAAATAGCAAGTTAA	1	bc
CGACAGAAAA	GAAACACCGGTGGTGTTTGCTCGAGGGTGGGGTTAGAGCTAGAAATAGCA	1	bc
ATGCCCAGAT	GAAACACCGGTCTTCCTGGAATCTACGTGGGGTAGAGCTAGAAATAGCAA	1	bc
AAGACAGGCG	GAAACACCGGTTATAGATGCGGGTTTGTGGGGTTAGAGCTAGAAATAGAA	1	bc
ATAACCCACC	GAAACACCGGTTGTAAGCGATGGTTTGTGGGGTTAGAGCTAGAAATAGCA	1	bc
ATCAACGACG	GAAACACCGGTCCTAGAAGCTGGGGCTAGAGCTAGACATATAAAGTAAAC	1	bc
TAACGTGCTT	GAAACACCGGTGCTCGCGGTTTCGAAGTGTGGTTAGAGCTAGAAATAGAA	1	bc
TCCACCACAT	GAAACACCGGTTACGCGAGCTCGTTAGAGCTAGAAATAGCAAGATAACCT	1	bc
CTACAACCTA	GAAACACCGGTGCGCGGAGATTATGCGTGAGAAATAGCAAGAAAACTAAG	1	bc
GTGTGCGCGC	GAAACACCGGTGAGATGCCCCGCAATAGGGAGTTAACCTAATGCTAAGCC	1	bc
GTACCAAACC	GAAACACCGGTTGAGCTAGATTTTGACTTAGGCTTGAACCTGAAACTGAG	1	bc
CATTCACAAA	GAAACACCGGTGGCAATTGGATCTGAGTGGGGTTAGAGCTAGAAATAGCA	1	bc
CATTCACAAA	GAAACACCGGTGCCGCGTCGACGTTAGTGGGGTTAGAGCTCGAAATAGCA	1	bc
AACTATTCAA	GAAACACCGGTTCCCGATGGCTCGTAGTGGGGTTAGAGCTAGAAATAGCA	1	bc
GTCAACCCTA	GAAACACCGGTGATCATAATATCCTCTTGGGGGGTTAGCTATAAACAGCG	1	bc
CAATCAACCC	GAAACACCGGTTGGCTTTAATGCTTTGTGGGGTTAGAGCTAGAAATAGCA	1	bc
CAGACCCTCG	GAAACACCGGTAATAGAAGCTTGGTTTAGGGGTTTAAATATCAAGTTAAC	1	bc
CGACAACAAA	GAAACACCGGTGTTCTTTGCTCGAGGGTGGGGTTAGAGCTAGAAATAGCA	1	bc
GGCCACTCCT	CTAAACACCGGTGGCCTCCATCCACTTGTTTTTTTAGAGCTATACATCTC	1	bc
TCGTTAAAAT	GAAACACCGGTTGCGTGTACTCGTTTGTGGGGTTAGAGCTAGAAATAGCA	1	bc
TAATCAGCAT	GAAACACCGGTTTCAGGAGATGGTGAGTGGGGTTAGAGCTAGAAATAGCA	1	bc
AGACTCAGCC	GCACCACCGGTTTTAGTACATGGTGAGTGGGTTTAGAGCTAGAAATAGCA	1	bc
TAAGGAGATA	GAAACACCGGTGAGATTCGTCGAAAAAGCAGGTTAACCTCAGAAGTCTCC	1	bc
TAATTAGCCA	GAAACACCGGTCGAGATAATCTCAAAGTGGGGTAGAGCTAGAAATAGCAA	1	bc
TATTGAGATT	GAAACACCGGTCTTCCTGGAATCTACGTGGGGTAGAGCTAGAAATAGCAA	1	bc
GACAAATCCC	GAAACACCGGTAATCTCAGGACGCTTGGGGGGTTAGTGCTAGAAATGCCA	1	bc
TCCGCAAACC	GAAACACCGGTGGGGTTAGAGCTAGAAATAGCAAGATAACCTAAGGCTAG	1	bc
AGCATCAGCC	GAAACACCGGTTTTAGTAAATGGTGAGTGGGGTTAGAGCTAGAAATAGCA	1	bc
ATGCCCGTAC	GAAACACCGGTCCTAGAAGCTGTGGGTAGGGCTTGAAATAGCAAGTTAAC	1	bc
CGTCGAGTTC	GAAACACCGGTGACAAACGTATGTCAGTGGGGTTAGAGCTAGAAACAGCA	1	bc
GCGTCGCGCG	GAAACACCGGTTATCGTTGCGGCTTTGTGGGGTTAGAGCTAGACATCGCC	1	bc
GACTTTTTAC	GAAACACCGGTACTGGTTACTTACGGGTGGGGTTAGAGCTAGAAATAGCA	1	bc
GCCTATAAAA	GAAACACCGGTACTAGATACTTATGGGTGGGGTAGAGCTCGAAATAGCAA	1	bc
ATATCAAACC	GAAACACCGGTTGTAAGTGATGGTTTATGGGGTTAGAGCTAGAAATAGAA	1	bc
CCCCCAAGCC	GAAACACCGGTAGAATGGATCCACGGGTGGGGTTAGAGCTAGAAATAGCA	1	bc
CGATAATAAA	GAAACACCGGTGTGAATAGAACGATTTGGGGTTAGAGCTATAAAAAGCAA	1	bc
TACTCTGAAA	GAAACACCGGTACTGGTTGCTCACGGGAGGGCATGGAGACAGAAATATCA	1	bc
TGCCCTCCCC	GAAACACCGGTTCAAGTTAGCTCGTAAGGGGGATTAGAGATAAAAAAAGA	1	bc
AGACCGTCAC	GAAACACCGGTGATCTTTGCACGGGGGTGGGGTTAGAGCTAGAAATAGCA	1	bc
GCGGCCGACC	GAAACACCGGTTCAACGCCTCGCTATTGCAAGTTAACCTAATGCTAGTCC	1	bc
CAGTGGGATG	GAAACACCGGTCGTCGTTCGTAGGGCGTGGGGTTAGAGCTAGAAATAGCA	1	bc
GAATCTGTCA	GAAACACCGGTATTAGTTACTTGCGAGTGGGGTTAGAGCTAGAAATAGCA	1	bc
TTCTTAAGCC	CTAAACACCGGTCACGAAAATGTGTTGGTGGGGTTAGAGCTAGAAATAGC	1	bc
AGCAAATCAG	GAAACACCGGTGAGAACAGAAAGTTTTGGGGTTTGAGCTAGGAATAGCAA	1	bc
ACTCCATAAA	GAAACACCGGTGACAAACGTATGTCAGAGGGGTTAGAGCTAGAAATAGCA	1	bc
AGAAAGGACC	GAAACACCGGTGTTCTTTACTCGAGGGTGGGGTTAGAGCTAGAAATAGCA	1	bc
TCACCAATGA	GAAACACCGGTTTAGTATGGAGGGAAGTTGGGTTGGAGATAGAAATAGAA	1	bc
CTTCCATATT	GAAACACCGGTCATCACAGAACCTACGGGGGTTAGAGCTAGAAACAGCAA	1	bc
TCAAACTACG	GAAACACCGGTGGCAGCCAGCCACTTGTGGGGTTAGAGCTAGTAATAGCA	1	bc
CCCACGGCCT	GAAACACCGGTTCCCGCGGCTTCGAAGTGGGGTTATAGCTAGAAATAGCA	1	bc
AGGACCGCAA	GAAACACAGGTGCTAACAGAACGGTTTGAGGTTGGAGCTAGAAGTAGCAC	1	bc
TCGATCAATA	GAAACACCGGTTAGGACAGAACGTTTTGGGGTTAGAGCTAGAAATAGCAA	1	bc
GAATCCCACG	GAAACACCGGTTTACGTAGATGACTAGTGGGGTTAGAGCTAGAAATAGCA	1	bc
TAATCCCTCC	GAAACACCGGTTGAGTTAGTCAACAAGTGGGGTTAAGCTAGAAATAGCAA	1	bc
CCTAAAACCG	GAAACACCGGTGCCCTTTATGGGACCGTGGGGTTAGAGCTAGAAATAGCA	1	bc
TGCTCTTAAT	GAAACACCGGTGCTAGTTAGTACGTCGTGGGGTTAAAGTAAGAATAAGCA	1	bc
GGACTAAATT	GAAACACCGGTGCTCCTAGAATCCACGTGGGGTTAGGGCAGGAATTGGAA	1	bc
AAACACCAAA	GAAACACCGGTTTAGTATGGTGGGAAGTGGGGTTAGAGCTAGAAATAGCA	1	bc
AGATCATCCA	GAAACACCGGTGGGAACAGAACGTTTTGGGGTTAGAGCTAGAAATAGCAA	1	bc
CACGCCCCCC	GAAACACCGGTAATCGAAAGCTCCCCGTGGGGATAGAGCTAGAAATAGCA	1	bc
AAAACCCTCA	GAAACACCGGTAATCTAAGGATCCCCGTGGGGTTAGAGATAAGCATGACA	1	bc
GACTAACACC	GAAACACCGGTAATATTAATATCCCCGTGGGGTTAGAGCTAGAAATAGCA	1	bc
AGATCATACA	GAAACACCGGTGAGAACAGAAGGTTTTGGGGGTAGAGCTAGAAATAGCAA	1	bc
TCAGCCCACA	GAAACACCGGTGAGGCGAGGACGTTAGATCTAGAAATAACCTATTAACCG	1	bc
CGGTCCCCAT	GAAACACCGGTTTGCTTAGTTCGTTTGTGGGGTTAGAGCTATAAATAGCA	1	bc
GTGGCAGAAA	GAAACACCGGTGAGGTGAGTCGTAGAAGTAGGATAACAACTGGAGAGTAC	1	bc
ATGAAAGCGG	GAAACACCGGTCCGAGAAGCTGAGGCTAGAGATAGAGCTAGCAAGCTAAG	1	bc
GTCTTAACCC	GAAACACCGGTCAGGGTTAGGTACAGGTGGGGTTAGAGCTAGAAATAGCA	1	bc
AGACCAGAAG	GAACCACCGGTGTACTTAGTGGGGAGGGGGGGTAAAGCTAGAAATAGCAA	1	bc
ACACGCCACT	GAAACACCGGTTGTAAGCGACGGTTTGTGGGGTTATAGCTAGAAATAGCA	1	bc
AATTCCCAGA	GAAACACCGGTCTCAGTTGGGTGGGAGGGGGTAGAAATATCATAATATCA	1	bc
CATTGACCAC	GAAACACCGGTTGTGGGGACCTCGGTGTGGGGGTAGTGGCATGTATACCT	1	bc
GGTGGCGAAA	GAAACACCGGTGAGAACCATACATTTTTGGGATTAGCCATTGAATATCAA	1	bc
GGCTACTCCC	GAAACACCGGTGGCAGCTAGCCCCTTGTGGGGTTAGAGCTATAAATAGCA	1	bc
ACGACCGCCC	GAAACACCGGTCCTCTAAGCTGCGTTTAGGGCTTGAAACAATAAGTTAAC	1	bc
AAACTATGTA	GAAACACCGGTACTAGGTGCTTACGGGTGGGGTTAGAGCTAGAAATAGCA	1	bc
AATATACTAG	GAAACACCGGTGATAAATGTTTGTCAGCGGGGTTAGAGCTAGAAATAGCA	1	bc
TGCTCAGAAT	GAAACACCGGTCTTCCTGACTTCTACGTGGGGTAAAGCTATAAATATCAA	1	bc
CGGTGGGATA	GAAACACCGTTCGTAGATAGTTAGAAGTGGGAATAGAGCTAAAAATAACA	1	bc
AGCATCTAAG	GAAACACCGGTTTTCGATAATAGGACGTGAACTTAAGGATAGTCCGTGAA	1	bc
GGCTCAGCAA	GAAACACCGGTGAGAACAGAAATGGGGTGAGAGCTAGATATAGCAAGTTA	1	bc
CTTTCCCACA	GAAACACCGGTGGCAATTCGATCTGAGTGGGGTTAGAGCTAGAAATAGCA	1	bc
CCATTACACC	GAAACACCGGTATACTGGATCCACGGGTGGGGTTAGAGCTAGAAATAGCA	1	bc
GGACGAGATA	GAAACACCGGTCATCATTGGAGCGTTAAGAGTAAGAAATACAAAGTAACC	1	bc
AATCGACGCC	GAAACACCGGTAGCATAGATCCACGAGTGGGGTTAGAGCTAGAAATAGCA	1	bc
GACATACACC	GAAACACCGGTGATCAAAATAACCTCGTGGGGGTAGAGCTAGAAATAGCA	1	bc
CCGCGAGCTG	GAAACACCGGTCGTCGTTCGTAGGTCGTGGGGTTAGAGCTAGAAATAGCA	1	bc
TATTCAACCC	GAAACACCGGTTGAGATAGTCAAAAAGTGGGGTAGAGATAGAAATAGCAA	1	bc
TCAAAACTTA	GAAACACCGGTGAGGAGAGGATGGTGGTGGGGATAGAGAAAGAAACAGAA	1	bc
AAACCATACC	GAAACACCGGTGGCAAACGTATGTCAGTGGGGTTAGAGCTAGAAATAGCA	1	bc
AACTAGGAAA	GAAACACCGGTATTAGTTACTCGCGGGTGGGGTTAGAGCTAGAAATAGCA	1	bc
AATCCACTGA	GAAACACCGGTTTCAAATGTATGTTTGGGGGGAGAGAGCGAGAGATAGCA	1	bc
TAATCAGACT	GAAACACCGGTCTTCCTAGATAAGTAGTGGGGAGCTAGCAATAGAAAGTT	1	bc
TATCTAGTCC	GAAACACCGGTTGAGATTATCAAACAGTGGGGTAGAGCTTGAAATAGCCA	1	bc
GTTCGCGATT	GAAACACCGGTCATCCTCCTCTAAATAGGGGGTAGACCTAAGACTAGCCC	1	bc
