TAAACCCAAT	GAAACACCGGTTTACTTAGTTAACTAGTGGGGTTAGAGCTAGAAATAGCA	3	bc
CAGGCAACTA	GAAACACCTGTGGCAGCCAGCCACTTGTGGGGTTAGAGCTAGAAATAGCA	2	bc
GTGCACTTCA	GAAACACCGGTTCCCGTTAGCTAGAAATAGCAAGTTAACCTAAGGCTAGT	2	bc
CTCCCCCACC	GAAACACCGGTTGAATGCGTCCACGTGTGGGGTTAGAGCTAGAAATAGCA	1	bc
CTGATAATAG	GAAACACCGGTTGGCTTTACTCCTTTGTGTGGTTATAGCTATAAATAGCA	1	bc
TAAGAAGAAC	GAAACACCGGTGGTGTTAGCTCTCGAACGAGCAAGTTAACATAAGGCTAG	1	bc
GTGGCCATGA	GAAACACCGGTTTAGTATGGGCTTAGTTTAGCGGGGTTACAGCTAGAAAT	1	bc
GACTCTGGAG	GAAACACCGGTACTCGTTACTTACTTGTGGGGTTAGAGCTAGAAATAGCA	1	bc
TAAACCCAAT	GAAACACCGGTTTACTTAGTTAACTAGTGGTGTTAGAGCTAGAAATAACA	1	bc
ACCCAATCAC	GAAACACCGGTTCCAAACGTATGTCATGTGGGGTTAGAGCTAGAAATAGC	1	bc
GCCAGACGCA	GAAACACCGGTAGAATGGATCCACGGGTGGGGTTAGAGCTAGAAATAGCT	1	bc
GAATAAGAAG	GAAACACCGGTGCTAATATCGTGGGGGTAGGGCTAGAAATAGCAAGTTAA	1	bc
AGGACATCCA	GAAACACCGGTCCTAACAGCAGAGTTTGGGGGTATAGAGCGAGATATAGC	1	bc
AGGGCACGAG	GAAACACCGGTGATCTTTGTCAAGTGGGGGGGTTTAGAGCTTAAAATGGC	1	bc
TTCGGCGACA	GAAACACCGGTGAGATGCCTCAAGTGGGTTGGGTTAGAGCTAGAAATAGC	1	bc
GATTCAAGAA	GAAACACCGGTTATCGTTAAGGCTTAGTGCGTGGGGTTAGAGCTAGAAAT	1	bc
GATGTCGGGA	GAAACACCGGTGAGATTCCTCAATGGGTTGGGTTAAGAGCAAGAATTGGA	1	bc
AAAATCCTCG	GAAACACCGGTGATGCGAGGTAGTTAGAGCTAGGAATAGGAAGGTAACCT	1	bc
CCCGCACACA	GAAACACCGGTAGCATGGATCCACGGGTGGTGTTAGAGCTCGAAATAGCA	1	bc
ACCCCGCCGA	GAAACACCGGTAGAATGGATCCACGGGTGGGGTTAGAGCTAGAAATAGCA	1	bc
GAGTCTGGTG	GAAACACCGGTTTAGTATGGGTTTAGTCTGGTGTGGTTAGAGCTAGAACT	1	bc
GCCACAATAC	GAAACACCGGTAATCTAAAGATCCCAGTGGGGATAGAGCTAGAAATAGCA	1	bc
CAATAAGCGA	GAAACACCGGTGCTAGCGGATTCGGCAGGGGGAATAGAGCTAAACATAGC	1	bc
AGTCCATCCT	GAAACACCGGTGACAAACGTATGTCAGGGGGGGTTAGGGCTGAAAATAGC	1	bc
AAGACCCACG	GAGACACCGGTCCTAGAAGTTGACTTAGAGCTTGAAATAGAAACAAGTCA	1	bc
GCCTCAAAAA	GAAACACCGGTGGTGGTAGAGCTAGAAATGGCATGGTAACCTAAATCTAA	1	bc
TCAGCCCACA	GAAACACCGGTGGGGTTATAGCTAGAGATAGCATGTTAACCTAATGCTAG	1	bc
ACGGCGGGGT	GAAACACCGGTCGTCGTTCGTAGGGCGTGGGGTTAGCGCTAGAAATAGCA	1	bc
TGATAGCCAC	GAAACACCGGTGTTCTTTGCTCGAGGGTGGGGCTAGAGCTAGAAATAGCA	1	bc
CCCCGACAAC	GAAACACCGGTAGAGTGAGTCCACGGGAGGGGTTCGAGCTAGAAGTAGCA	1	bc
ATTACATCCG	GAAACACCGGTGATAAAAGTAGAGTTAGAGCTAGAAATAGCAACAATATC	1	bc
CATTCTCCCC	GCCTCCCCGGTGGCCTTTCTATCTGAGTGGTGTTAGAGCTAGCACTAGCA	1	bc
GCCATCCACC	GAAACACCGGTGAGAAGGATCCCCGCGCGGGGGTGTTAGAGGTAGTAATA	1	bc
ACTGCAACAA	GAAACACCGGAGACAAAAGAATGTCAAGTGGGGATAGAACTAAAAATAGC	1	bc
AATAACCAAA	GAAACACCGGTTGCAATTCGATCTGAGTGGGGATAGAGCTAGAAATAGCA	1	bc
AATTAACAGA	GAAACACCGGTGGCAAGTCGATATGAGTGGGGTTAGAGCTAGAAATATCA	1	bc
AACCGACATG	GAAACACCGGTGTTAGCGGATTGGAAGGGGGGGTTGGGGCTAGAAATACC	1	bc
TACTCCATAA	GAAACACCGGTGGTGTTTGCTCTAGGATTGGCATATAGATCGAAATAGCA	1	bc
AATATATCAG	GAAACACCGGTGACAAATCTATGGAAGTGGGGTTAAAGGTAGAAATTGCA	1	bc
TGGCACTTCA	GAAACACCGGTTCCCGTTAGCTGGAAGTAGCAATATAACCTGAGGCTGGT	1	bc
AAAGCAAACC	GAAACACCGGTGGGGTTAGAGCTAGAAATCGCAAGTTAACCTAAGGCTAG	1	bc
ATAATAAACT	GAAACACCGGTTGGCATGGTTGGTTTGTGGGGTTAGAGCTAGAAATAGCA	1	bc
CCCACGGACG	GAAACACCGGTTCAACAGGCGTATTTTGTGGGGTTAGAGCTGGAAATAGA	1	bc
TCTCTGCCGC	GAAACACCGGTGTGAGGAGATTATGCGTGATAAATAGCAAGTAACCTAAG	1	bc
GGTAACTAAT	GAAACACCGGTGGCAGCTCGCTACTTGTGGGGTTAGAGCTAGAAATAGCA	1	bc
TCAATCACAA	GAAACACCGGTGGCAATTCGATCTGAGTGGGGTTAGAGCTAGAAATAGCA	1	bc
TCCGATGTAA	GAAACACCGGTACTAGTTACTTACGTGTGGGGTTAGAGCTAGAAATCGCA	1	bc
GCAACGCATA	GACACACCGGCCGACACGGGTGGGTGTGGAGCTAGAGATCGCAAAATAGC	1	bc
TTGTTATCAC	GAAACACCGGTGACAAACATATGTCTGTGGGTTTAAGGCTTGAAAGATGC	1	bc
GAATAGAAAC	GAAACACCGGTGTTATTAGCTGGAGGGTGGGGTTAGAGCTAGAAATAGCA	1	bc
ACGAGAGAGA	GAAACACCGGTGGGATTACCTAATTGGTGGGGTTAGAGGTAGAAATAGCA	1	bc
TGCCGCCCCC	GAAACACCGGTTGAATGGATCTCGGGGGGGGGGTTAGAGTTGGAATTGGC	1	bc
GAGGGCGATT	GAAACACCGGTGATAGCGCTCAAGTAGGGGTAGAGCTAGCAAGAACTAGT	1	bc
TCCAAAAACA	GAAACACCGGTGGGGGTAGACCAAGAGATATCAAGTTAACCTAAGGCTAG	1	bc
GCGGGAGAAA	GAAACACAGGTGAGATGCCTCAAGTGGGTGGGGTTAGAGCTAGAAATAGC	1	bc
GATACCACAA	GAAACACCGGTTGGAAGCGATGGTTTGTGGGGGTAGAGCTAGGAATAGCA	1	bc
CCATTCAACC	GAAACACCGGTCCTAATATCGTGGGGTTAGAGCTAGAAATAGCAAGTTAA	1	bc
CAATCCCTGA	GAAACACCGGTTTAGATTGGGTTTGGTTGAGTGTAGATATAGATAGAACT	1	bc
GAACAACTCA	CTAAACACCGGTAATCCAAAGATCCCCGTGGGGATAGAGCCAGAAATAGC	1	bc
ATACCATATA	GAAACACCGGTGTGCATTGTAACGTCCACGTGGGATAAGAGCTAGTAACA	1	bc
GCGTAGGTAA	GAAACACCGGTTGTATTAGCTGATTTGGGGGGGAGGTGGTAAAATAAAGA	1	bc
TCCACAACCA	GAAACACCGGTGGGGGTAGAGCTAGAAATGGCATGTTAACCTAAGGCTAG	1	bc
TTCTCACCAA	GAAACACCGGTGTGCGGAGATTATGCGTGAGAATTAGCAAAGAAACTAAA	1	bc
ATATAACCCT	GAAACACCGGTTGTAAGCGATCGTTTGTGGGGTTAGAGCTAGAAATAGCA	1	bc
AATGCTAGAA	GAAACACCGGTAGAATGGATTCACGTGTGGGGTTAGAGCTAGAAATAGCA	1	bc
CCCCGGGCCC	GAAACACCGGTAGAGTGGATCCACGGGTGGGGGTAGTGCTAGGAATAGCA	1	bc
TTAGTTAACA	GAAACACCGGTTGAAGTCATCAATAAGTGGGGTTAGAGTTAAAAAAAGAA	1	bc
TACTAAGCAA	GAAACACCGGTGCTAGCTACACACTGTGGGGGTTGGGCTAAAAAATAGAA	1	bc
CTCTGCCGGC	GAAACACCGGCTAGCAGAGGTTATGCGTGCGAAATCTCAAGCAACATCAA	1	bc
AAATAAATAC	GAAACACCGGTTGAGATTGTCAGAGAGTGGGGTTGAGCTTGAAATAGCAA	1	bc
TCATCAAGCA	GAAACACCGGTTATCGTTACGGATTAAAGCTAGGTTTAGCTAGTTCACCT	1	bc
TGTAACATAT	GAAACACCTGTGAGCATGATAACGTCCAGCTAGAAATAGCAAGTTAACCT	1	bc
ACACGACGCC	GAAACACCGGTAGAATGGATCGGCGTGTGGGGTTAGAGCTAGAAATAGCA	1	bc
GAGTCAGTAA	GAAACACCGGTACTAGTAGCTGAGGTGTGGGGTTAGAGCTAGAAATCGCA	1	bc
AGTTATATAT	GAAACACCGGTGTGCGTGCATACGTCGCGGGGGGGTTGGTGGTAGTAGTA	1	bc
TCCCTATGTC	GAAACACCGGTACTAGTTACTTACGGGTGGGGTTAGAGCTAGAAATAGCA	1	bc
GAACGAAAAT	GAAACACCGGTGCTAATAGTTTCGAAGTGGGGTTTAGAGCTGGAAAAGGC	1	bc
GAACAAGATC	GAAACACCGGTACTATAGATTTCGAAGTGGGGGTTAAGGTTGAAAATAGC	1	bc
AAACTATCTA	GAAACACCGGTGAGCATGGTATCGTACAGGGAGAAGAACCAAATTAACCA	1	bc
AAACCAGTGG	GAAACACCGGTTTAGTATGGGTTTAGTTTAGTGGGGTTAGATCTAGAAAT	1	bc
ACGACCTTCC	GAAACACCGGTGCCAAAAGTATGTCAAGTGGGGTTAGAGCTAGGAATAGC	1	bc
AAGATAACAC	GAAACACCGGTTGGCTTTACTCCTTTGTGGGGTTAGAGCTATAAATAGCA	1	bc
TGCAACAGAC	GAAACACAGGTGACCATGATAACGTCCAGGTAGTAATAGCAAGAAAAGCA	1	bc
GTAATCTGCC	GAAACACCGGTGAGCATGATACCGTCCAGCTATTAATAGCAAGATAACCT	1	bc
AAAGCAAGAA	GAAACACCGGTGGGGGATGAGAGAGAGATGGGATGGAAACAGAAAGAGAA	1	bc
TGCCTGCAAC	GAAACACCGGTGGTCATAGTTCGCGGGTGGGGTTAGAGCTAGAAATAGCA	1	bc
ACATTCACAT	GAAACACCGGTGGCAATTCGATCTGAGTGGGGTTAGAGCTAGAAATAGCA	1	bc
ATGACAGCAG	GAAACACCGGTGCTAGAAGCTGAGTTTGTGGGGTTAGAGCCGAAAATAGA	1	bc
ATGCGCGAGT	GAAACACCGGTTGTATGCGTCGGGTTCTGGGAATAGCAATTGAACCTACA	1	bc
GACAACCAAA	GAAACACCGGTGATCTAACTAAACTCGTGGGGATAGAGCTATAAATAGCA	1	bc
GTTTCATATA	GAAACACCGGTGACCACTCTAACTTCGCCGGGGGGGTAGAGCTAGTAACA	1	bc
CAAATCCATC	GAAACACCGGTGACAAACGTATGTCAAGTGGGGTTATAGCTAGAAATAGC	1	bc
GTCGGTTCGA	GAAACACCGGTGAGACGCCTCAAGTGGGGGGGGTTAGAGCTAGAAATAGC	1	bc
TCAGCCCCAA	GACACACCGGTGTGGTTAGAGTTAGAGTTAGGAAATTGCTAGTAGGCTCG	1	bc
AAAAGGGAAA	GAAACACCGGTTGTCGTTGATACGGTGTGGGGGTGGCGAGAAATAGAGAG	1	bc
TCCTTACTCC	GAAACACCGGTTGAGCCAATCAAAAGGTGGGGATGACCTAGTAATCGCAA	1	bc
AACATCTCCC	GAAACACCGGTCGCGGAACTGTGCCCGTGGGGTTAGAGCTAGAAATAGCA	1	bc
GTACTAAACA	GAAACACCGGTTATAATAGCGGATTAGTGGGGGGAGATATAGAAAGAAAA	1	bc
TCCCCCGGCT	GAAAAACCGGTAGTATGGGTACACGGGTGGGGTTAGAGCTAGAAATAGCA	1	bc
ATTCAATCAA	GAAACACCGGTGAGGAAAGAATGTCAAGTAGGGATAGAGCTAGACATAGC	1	bc
ACAGCCATAA	GAAACACCGGTTTGGTTAGAGCGAAAGAGGGGTAAGAAATAGAAATAGAA	1	bc
AATCCCCTAC	GAAACACCGGTAATCTACGGATCCCCGTGGGGTTAGAGCTAGAAATAGCA	1	bc
CGCCCAACAA	GAAACACCGGTGTTAGAGGTATAAAAAGCGGGGTAACCTAAAGCTAGACC	1	bc
AAAAACCTGA	GAAACACCGGTATACTAAGGGTTGAGGTGGGGATAGAAAGAGAAAGAAAG	1	bc
CCCCTACTCC	GAAACACCGGTTGAATTGATCCACGGGTGGGGTTAGAGCTAGAAATACCA	1	bc
CAACCGATTA	GAAACACCGGTCGTCGTTCGTAGGGCGTGGGGTTAGAGCTAGAAATAGCA	1	bc
AAATCAATGC	GAAACACCGGTTTAGGGTGGGTTTAGGTGAGTGGTGTTAGAGATAGAAAT	1	bc
GAGGCAAACA	GAAACACCGGTTAGGTTAGAGCTATAGATAGCATATTAACCTAAGGCTCA	1	bc
GCAATGGATC	GAAACACCGGTGAGCATGATAACGTCCCCGTGGTGTTAGAGCTAGAAATA	1	bc
AAGATATATA	GAAACACCGGTGAGCAAAGTATGTTCGTGGTATTTGAGATAGAACTAGCA	1	bc
ATTACAGTAA	GAAACACCGGACCTAGAAGCTTAGTTAGAGATAGAAATAGAAAAAAGTTA	1	bc
AATACGGCCC	GAAACACCGGTGCCCTTGATGGCATCGGGGGGGTTGAGCTAGGAATAGCA	1	bc
AGAACGCAAT	GAAACACCGGTGTTCGTTAGTAGATGGTGGGGGTGGTGGTAGAAGTAGCA	1	bc
AGACCTCCCC	GAAACACCGGTGTTCTTTGCTCGGGGGTGGGGTTAGAGCTAGAAATAGCA	1	bc
GGCTGTGAAA	GAAACACCGGTACTAGTTACTTACGGGTGGGGTTAGAGCTAGAAATAGCA	1	bc
CAAAACGATT	GAAACACCGGTGCTCGCGGTTTCGAAAGTGGGGTTAGAGCTAGAAATAGC	1	bc
GAAGCTAAAA	GAAACACAGGTAGGGTTAGCGATCGAGATGGCATATTAACCTAAGGCGCG	1	bc
GATGGCGCGA	GAAACACCGGTGAGATGCCACACGGTGGGGGGGTTATAGCTAGAAATACC	1	bc
TCTAAAGATG	GAAACACCGGTCCCCCTGGAATCTCCGTGGGGCAGAGCTAGGAATAGGCA	1	bc
TGTCCAGCTC	GAAACACCGGTAGAATGGATCCACGGGTGGGGTTAGAGCTAGAAGTAGCA	1	bc
AAACCAAACA	GAAACACCGGTTGGAATAGAGGGATTGAGGGGTTAGAGATAGAAATAGCA	1	bc
TACCATGTTA	GAAACACCGGTCTTCCTGGAATCTACGTGGGGTAGAGCTAGAAATAGCAA	1	bc
AAACAAAAAA	GAAACACCGGTGGGAAGAGAGCGTTAGTGAGGTTAGAGCTAGAAATAGCA	1	bc
GGATAGAAAA	GAAACACCGGTGCTAATTGCTAGCTGGTGGGGTTAGAGCTAGAAATAGCA	1	bc
TGTTCATCCC	GAAACACCGGTTGGGATAGAACAAAAGTGGGGTAGAGCTAGAAATAGCAA	1	bc
GAAATTGCAG	GAAACACCGGTGCCCTTTATGGGACCGTGGGGTTAGAGCTAGAAATAGCA	1	bc
GAATACAACG	GAAACACCGGTTGCGGCCAGCAAATTGTGGGGTTAGAGCTAGAATAAGCA	1	bc
TGTTCACAAT	GAAACACCGGTGGCAATTCGATCTGAGTGGGGATAGAGCTAGAAATAGCA	1	bc
GACGCCACCA	GAAACACCGGTAAGCTTAGGATTCCCGGGGGGATAGAGCTATAAATATCA	1	bc
TCAGCCGAGA	GAAACACCGGTGGGGTTAGAGCTAGAAATAGCAAGTTAACGTAAGGCTAG	1	bc
ACAGCCCTCT	GAAACACCGGTTGCACGAGGACGTTAGAGCGAGTAATAGCAGGATAACCT	1	bc
TATGCAACAA	GAAACACCGGTGAGGAACGAATGACAGAGAGCTTAGAAAAAGAAATCGCA	1	bc
CGTCGGCATG	GAAACACCGGTCGCAGTTCGAAGTGCGTGGGGTTAGAGCTAGAAATAGCA	1	bc
AAACTACACA	GAAACACCGGTTCTAATCGATGGTTTGTGGGGTTAGAGCTAGAAATAGCA	1	bc
GACTAAGACA	GAAACACCGGTACTAGTTACTTACGGGTGGGGTTAGAGCTAGAAATAGCA	1	bc
GAACCATCTA	GAAACACCGGTGACCATGGTATCGTAGCGGGGGGATTACAGGTAGTAGTA	1	bc
TCATCCACCC	GAAACACCGGTAGTGTAAATGTCCCCGTGTGGATAGAGCTAGAAATAGCA	1	bc
AGTAATATCT	GAAACACCGGTGAGCATGATAACGTCCCCGTGGGGTTAGAGCTAGAAATA	1	bc
AGTCAAGATG	GAAACACCGGTGTGCAGGGAATGTACGTGAGATCTAGCTAGGACTCGCAA	1	bc
GAGGGCGCCA	GAAACACCGGTGTGATGACTTAGGTTGGGGGGGTAGAGGTAAGAAAAAGA	1	bc
CGACCAATAA	GAAACACCGGTTTGGAATGGGCTTTGTTGGGTGAGGTTAGAGAAAGACAT	1	bc
GACTCTGTCT	GAAACACCGGTACTAGTTACTTACGGGTGGGGTTAGAGCTAGAAATAGCA	1	bc
AAACCCAACT	GAAACACAGGTTTTGAACGGTGGGTTGTGGGGTTAGAGCTAGAAATAGCA	1	bc
ATACTATATT	GAAACACCGGTGAGCATGATAACGTCCAGCTAGTAATAGCAAGTTAACCT	1	bc
TCAGCAGCAG	GAAACACCGGTGGGGTTAGAGCTAGAAATGGCAAGTTACTCTAAGGATAG	1	bc
AACCCCCACT	GAAACACCGGTTGTATGCGGTGGCTTGTGGGGTTAGAGCTAGAAATAGCA	1	bc
TCATCAGCCG	GAAACACCGGTGGGAGTAAATCTAGAAGGTGCTAGTTAATAGAAGGCGCG	1	bc
AAACCGCCAC	GAAACACCGGTGTTCTATGCTCGAGGGTGGGGTTAGAGCTAGAAATAGCA	1	bc
ACCCGACGAC	GAAACACCGGTAGAAAGGATCCACGGGTGGGGTTAGAGCTAGAAATAGCA	1	bc
GAAACATAAA	GAAACACCGGTGGGAATGCTAACAGAGCCGGGGGGTTAGAGCTAGAAATA	1	bc
GAATACTGTA	GAAACACCGGTGAGCATGATAACGTCCCCGGGGGGTTAGAGCTAGAAATA	1	bc
AGAAAAAAAC	GAAACACCGGTGGTCTTTGCTCGAGGGTGGGGTTAGAGCTAGAAATAGCA	1	bc
GAATAAGTCA	GAAACACCGGTAGTGGTAACCTAAGAGTGGGGTTGGAACTGGAATTGGCA	1	bc
AACCGCGATT	ACAGTCCGAAACACCGGTGCTAGAGGTTTCTAAAGTGGGGTTCAAGCTAG	1	bc
AAACCTATCG	GAAACACCGGTTTAGTATGTGGGGTTGTGGGTATAGAGCTCAAAATAACC	1	bc
TAATAGATGC	GAAACACCGGTTGGGAGAGTCTAAAAGTGGGATAGAGCTAGAAACAGCAA	1	bc
TCCAACTCCG	GAAACACCGGTTGCCTTTAGCCCCTTGTGGGGTTAGAGCTATAAATAGCA	1	bc
GCATCAGCCG	GAAACACCGGTGTGTTTAGAGCTAGAAATAGCAAGTTAACCTAAGGCTAG	1	bc
CCAAGCCGAC	GAAACACCGGTAGACTGGTACCACGGGAGGGGTTAGAGATAGAGCTAGCA	1	bc
GTGGTAAAGA	GAAACACCGGTGAGATGAGTTAAGTGGGGGGGGTAAGAGTTAGAATAAGA	1	bc
TCATTAAAAC	GAAACACCGGTGGCGATAGAGTGAGGGAGGGGTTAGAGATAGAAATAGCA	1	bc
GAACCAATCA	GAAACACCGGTTTTGTATGGGTTTAGGTGGGGGGGGATAGAGATAGAGAT	1	bc
CCGACAGTAC	GAAACACCGGTTGCCGTTACTCCTTTGTGGGTATAGAGCTATAAATAGCA	1	bc
AATACACAAG	GAAACACCGGTGCCAATTCGATCTCCGTGGGGTTAGAGCTAGAAATAGCA	1	bc
AAGCCATGAG	GAAACACCGGTGACAAACGTATGTCAAGGGGGGTTAGAGCTAAAATTAGC	1	bc
ACTTTCTCCC	GAAACACCGGTTGCGAAAATGTGGCGGTGGGGGTAGAGCTAGAAATAGCA	1	bc
TTCCCATCCC	GAAACACCGGTCGCGAGAGTGTACCGGTGGGGTACTAGATATAAATAGAC	1	bc
TACACTGTTA	GAAACACCGGTCCTAGTTACTTACGGGTGGGGTTGTGGCTAAAAATGGAA	1	bc
GACTCCCTAT	GAAACACCGGTACTAGTTGTTTACTGGTGGGGTTAGAGCTAGAAATAGCA	1	bc
AAACCAAGCT	GAAACACCGGTTGTAAGTACGGGTTTGTGGGGTTAGACTTAGGAATAGCA	1	bc
AGAACGCTAC	GAAACACCGGTGTTCTGTGGTCGTTGGTGGGGTTAGAGGTAGAAATAGCA	1	bc
TAGGTAAGGC	GAAACACCGGTGAAGTGCCTCAAGTGGTGGGGGATATAGATAGAAATAAC	1	bc
AAACAAGATC	GAAACACCGGTGCTCGTTGTGTGGAGGTGGGGTTAGAGCTAGAAATAGCA	1	bc
CCATCCAAAA	GAAACACCGGTGGGGTTAGAGCTAGAAATAGCAAGTTAACCTAAGGCTAG	1	bc
GAAATATAAC	GAAACACCTGTGAGCATGGTAACGTCGAGCTAGAAAAAGTAAGTTAACCT	1	bc
GACTCAGCAG	GAAACACCGGTACTAGTAACTTACTGGGGGGGGTAGAGGCAGAAATAGCA	1	bc
CTTTTACACA	GAAACACCGGTCGCGAAAATGTGCGGGTGGGGTTAGAGCTAGAAATAGCA	1	bc
TACGACCTAC	GAAACACCGGTAATGTAAGGGTCCCCGTGTGGATATAGCTAGAAAGAGAA	1	bc
TGGGGGGATG	GAAACACCGGTCGTGGTTCGTCGGGCGAGGGGATAGTGATAGAAATCGAA	1	bc
ATACAACAGA	GAAACACCGGTGTGCGGTGATCGTGGGTGGGGTTAGAGCTAGAAATAGCA	1	bc
GTCTTCGCGC	GAAACGCCGGTGAGATGCCTCAAGCGGGTGGGGTTAGAGCTAGAAATAGC	1	bc
TAAATAATTA	GAAACACCGGTTAGGATGATAACGTCGAGGGATAAAGAGCAAATTAACCT	1	bc
TAAATCCAAC	GAAACACCGGTCTAGTAAGTGAGCTGGTGGGGTTAGAGCTAGAAATAGCA	1	bc
ATCTCCCCCC	GAAACACCGGTGTGCGGAGATTATGCGTGAGAAATAGCAAGTAACCTAAG	1	bc
TTAGCACACA	GAAACACCGGTGGGGTTAGAGCTAGAAATAGCAAGTTAACCTAAGGCTAG	1	bc
GTAATTAGTC	GAAACACCGGTGAGCATGATAACGTCCAGCTAGAAATCGCAAGTTAACCT	1	bc
TGCCGGTTTG	GAAACACCTGTCGCGGATCGGGGGGGTAGTGGTAGGAGTAACAAGTAAAA	1	bc
GGGCAAGATG	GAAACACCGGTCGTCGTTCGACCCTTGTGGGGTAGAACTAGCAAGTTAAG	1	bc
CCTACAACAA	GAAACACCGGTGCCGTTAGTGCTAGGGAGGGGTAGTGCTTCGAATGATAA	1	bc
GGACCAGCAT	GAAACACCGGTCTTCCTGGATTGTGCGTGGGGTTAGACTTGGAAATGCCA	1	bc
ATTCAATCGC	GAGACACCGGTGACCAGCGTATGTCAGTGGGGATAGAGCTAGAAATAGCA	1	bc
ATGGCAGACG	GAAACACCGGTTAACGTGGAGGATTAGTGCGGGGGGTTAGAGAGAGAAAT	1	bc
ATGGACGAAA	GAAACACCGGTGAGATGCCTCAAGTGGGTGGGGTTAGAGCTAGAAATAGC	1	bc
TGGAACTACC	GAAACACCGGTGGCAGCCAGCCACTTGTGGGATTAGAGCTAGAAATAGCA	1	bc
AAACAGCCAA	GAAACACCGGTTTTCTTTGCGCGGGTATGGGTATAAATCTAAAAATAACA	1	bc
AGAATTAAGA	GAAACACCGGTGCTAATATCGTGTGGTTAGAGCTAGAAATAGCAAGTTAA	1	bc
TTACCACATA	GAAACACCGGTTGTCATGGATGGGTTGTGGGGTTAGAGCTAGAAATAGCA	1	bc
TAATCCAACA	GAAACACCGGTTACCAACGTATGTTAGTGGGGGTAAGAGCTAGAATTAGC	1	bc
TTCTGCATAA	GAAACACCGGTGGGAAAAGATCGAGAAAGGGCAAGCTACCAGAAGGCGAA	1	bc
CGACCGGAAC	GAAACACCGGTCTTCTTTGCTCGAGGGTGGGGTTAGAGCTAGAAATAGAA	1	bc
GGAAAGTATA	GAAACACCGGTGAGCTTGATAACGTCGAGCGAGTAATAGCAAATTAACCT	1	bc
AAATCCGTAA	GAAACACCGGTCCTATTTGCTTACGAGTGGGGTTAGAGCTAGAAATAGCA	1	bc
AGATAATAAC	GAAACACCGGTGTGCACAGAACGTTGTGGGGGTTGAGCTAAGAAAAACAA	1	bc
AACTAAAGCC	GAAACACCGGTTGTGGCCGTCGAGAGGGGGGGGAAAGAGCTAGATAACCC	1	bc
TCAGCACCGA	GAAACACCGGTGGGGTTAGAGCAAGAGTTAGAAAGTTAACCTAAGGCAAG	1	bc
TCAGCCCACA	GAAACACCGGTGAGAAAAAGGAAGGTAATCTAAGGTTAGTCTGATATCAA	1	bc
AAGACCGAAA	GAAACACCGGTGATAGTCGTTAAGTGGGTGGGTTTAGAGCTAAAAATAGA	1	bc
GCATTCACTC	GTAACACCGGTAGAATGGATCCACGGGTGGGGTTAGAGCTAGAAATAGCA	1	bc
GAATCACACT	GAAACACCGGTTGTAAGCGTTGGTTTGTGGGGTTAGAGCTAGAAATAGCA	1	bc
GCACCACGCC	GAAACACCGGTAGAATGAGTGCTAGGGAGGGGATAGAGCTAGAAATAGCA	1	bc
TACAACCCCT	GAAACACCGGTACTCTATAGCTCCCGGTGGGGATACTACCAGTAATAGCA	1	bc
CACCGACGCA	GAAACACCGGTAGAATGGATACACGGGTGGGGTTAGAGCTAGAAATAGCA	1	bc
TCAGCCCTCT	GAAACACCGTTGACACGAGGACGTTAGTGCTAGTAATAGCAAGTTAACCT	1	bc
ATCTGAGTTA	GAAACACCGGTGTGCGGAGGTTATGCGTGAGAAATAGCAAGTAACCTAAG	1	bc
ATAACATTTC	GAAACACCGGTTCTCGTGGCTTAGTTAGAGGGTTAAATAGCAGCAAGTTA	1	bc
CCTGGGAAAC	GAAACACCGGTTGAATGGAACCAGGGGTGGGGGTAGTAGCAAATATAGCA	1	bc
TCCTCCACCC	GAAACACCGGTGGTGGTGGAGCTACAAATAGCAAGTTAACCTATGGCTAG	1	bc
AGATAGTACC	GAAACACCGGTGTTCTTTGCTCGAGGTTGGGGTTTGAGCTAGAATTGGCA	1	bc
GCCTCCGCCG	GAAACACCGGTAGAATGAATCCACGGGGGTAGAGATAGATAGAAATAGCA	1	bc
TTCTCAAAAA	GAAACACCGGTGGGGTTAGTGCTAGAAATAGCATGTTACCCTAAATCGCG	1	bc
ATCACCCCGA	GAAACACCGGTCCGCGGAGATTATGCGTGAGAATAAGCAAGTAAACTAAA	1	bc
AATCCAGCTT	GAAACACCGGTCGTGGGGAACTCGGGGTGGGATAAATATCATGCGAACTT	1	bc
AGATCCTTAA	GAACACCGGGTGCGCGCGGAACGTTGTGGGGTTAGAGCTAGAAATAGCCA	1	bc
TGTCCAGATT	GAAACACCGGTTGTCTTTACTCCTTTGTTGGGTTAGAGCTATAAATAGAA	1	bc
ACTTGGCCCA	GAAACACCAGTAGAGTGGAACCAGGGGTGGGGGTAGAGCTAGAAATAGCA	1	bc
TGATTAGAAT	GAAACACCGGTGCTAATGGCATGTGGGTAGAGCTGGGAATGGCATGGTAA	1	bc
GCCTCATACA	GAAACACCGGTTAGCATGATGACTTCCGTGGGGTTAGAGCTAGAAATAGC	1	bc
TACAAAATCC	GAAACACCGGTTGAGATAATCAAAAAGTGGGGTAGAGCTAGAAATAGCAA	1	bc
ATCGGCCGCC	GAAACACCGGTAGAATGGATCCACGGGTGGGGTTAGAGCTAGAAATAGCA	1	bc
TCGGCAGAGA	GAAACACCGGTGGGATGACTGATAGACTTGTAATATTAAGCTAAGCCTAG	1	bc
AATCAACAAA	GAAGCACCGGTGGCCTTTCCATCTGAGTGGGGTTAGAGCTAGAAATAGCA	1	bc
TCAGCACACC	GAAACACCGGTGGGGTTAGAGCTAGAAATAGCAAGTTAACCTAAGGCTAG	1	bc
AAAAAAGATG	GAAACACCGGTGCGCATTATGGGATCGGGGGGGTAGAGCTAGGAATAGGA	1	bc
TCCACACGCC	GAAACACCGGTGGGGTTAGAGCTCGAGATGGCATGTTAACCTAAGGCTAG	1	bc
CATACACCAG	GAAACACTGGTGGCATTTCTATCTGAGTGGGGTTAGAGCTAGAAATAGCA	1	bc
GTTGAAGATA	GAAACACCGGTGAGCATGATAACATCGCGGTGGGATAAGAGCTAGAAATA	1	bc
GAAAACTATC	GAAACACCGGTGAGCTTGATAACGTCGCCGTGGGGTTAGAGCTAGAAATA	1	bc
TCAATAAACA	GAAACACCGGTGCTAATATCGTTGGGTTAGAGCTAGAAATAGCAAGTTAA	1	bc
CCGAACACAC	GAAACACCGGTTAGCTTTACTCCTTTGTGGGGTTAGAGCTATAAATAGCA	1	bc
TTCTAGCACC	GAAACACCGGTGTTGAAAGCTCGCGGGTGGGGTTAGAGCTAGAAATAGCA	1	bc
CAACTATATC	GAAGCACCGGTCGAGTTTTTCACCTAGCGGTAGAGAGCTAGACTTAGCCT	1	bc
TCCTATGCAA	GAAACACCGGTACTAGTTACTCACGGGTGGGGTTAGAGATCGAAATAGAA	1	bc
GAATCAACTG	GAAACACCGGTTAGCGTGATAACGTCGCGGGGGGGGTAGAGCTAGAAGTA	1	bc
GCCTATACAA	GAAACACCGGTACTAGTTACTTACGTGTGGGGTTAGAGCTAGAAATAGCA	1	bc
ACCCCCCTCA	GAAACACCGGTTTAGTATGGGTTTAGTTTAGTGGGGTTAGAGCTAGAAAT	1	bc
AGTCATCCCC	GAAACACCGGTGTTCTTTGCTCGAGGGTGGGGTTAGAGCTAGAAATAGCA	1	bc
CCCCGCGGAA	GTAACACCGGTAGGATGGATTCACGGGTGGGGTTAGAGCTAGAAATAGCA	1	bc
TCCTCAACAA	GAAACACCGGTGGGGTTAGCGTTAGAAATAGCATGTTAACCTAAGGCGAG	1	bc
ATTATATCTA	GAAACACCGGTGAGCATGGTATCTTCGAGCTAGAAATCGCAAGTTAACCT	1	bc
TCTCCAGATT	GAAACACCGGTCTTGCTGGGAGTGCTAGAAGTAGGATATTAACCTGATAC	1	bc
GGCAATCCCC	GAAACACCGGTAATCTTTAGATCCTCGTGGTGGTAGAGCTAGAAATAGCA	1	bc
ATATAATATA	GAAACACCGGTGAGCATGATAACGTCCCCGTGGGGTTAGAGCTAGAAATA	1	bc
TGCCGCACTT	GAAACACCGGTGCTGGAGGTTTGGAGGGTGGGGTTGGAGCTCGAAATCGA	1	bc
CAACACCTAC	GAAACACCGGTAATCTAAGGATCCCAATGGGGATTGAACTTGAAATAGCA	1	bc
TCAACCTCTT	GAAACACCGGTGAGCATGATAACGTCCCCGTGGGGTTAGAGCTAGAAACA	1	bc
AGAACGCACC	GAAACACCTGTGTTCTTTGGTCGAGGGTGGAAATAGAGATGGAAATCGCA	1	bc
TGTCCATCAT	GAAACACCGGTGACAAACGAATGTCAAGGGGGGTTATAGCTAAAAATAAA	1	bc
CACTGCCGAA	GAAACACCGGTAGAATGTATCTACGGGTGGGGTTAGAGCTAGAAATAGCA	1	bc
AAACAACAGC	GAAACACCGGTGTAGTTTGCTCGAGTGTGGGGTTAGAACTAGAAATAGCA	1	bc
TCCGCAAACC	GAAACACCGGTGGGGCTAGAGCTAGAAATAGCAAGATAACCAAAGGCTAG	1	bc
CGCTTTACCC	GAAACACCGGTTCCCTTTACTCCTTTGTGGGGTTAGTGCTATAAATAGCC	1	bc
GATAAAGCAG	GAAACACCGGTGCTCTTTATGGGACAGTGGGGTTAGAGCTAGAAATAGCA	1	bc
AACTCTGTAC	GAAACACCGGTACTAGTTACTTACGGGTGGGGTTAGAGCTAGAAATAGCA	1	bc
CAACGAAAAA	GAAACACCGGTGCTAGCGGTTTCGAAAGTGGGGTTAGAGCTAGAAATAGC	1	bc
AGGGAGGATT	GAAACACCGGTGCTATCGGTTTCGAAAGTGGGGTTAGAGCTAGAAATAGC	1	bc
CGATAATAAA	GAAACACCGGTGAGCATAATAAGATCGAGCGAGAAATATCAAAATAACCT	1	bc
AATCTAGATC	GAGACACCGGTCATCCTGGTATGTCAGTGGGGGATAGAGAGAAATATCGC	1	bc
TCAGCAGCCA	GAAACACCGGTGGGGTTAGAGCTAGAAATATCAAGTTAACCTAGGGCTAG	1	bc
GTCTTATCCA	GAAACACCGGTCGCGAAAATGTGCCGGTGGGGTTAGTGCTAGAAATAGCA	1	bc
AAGTCATCAG	GAAACGCCGGTGATAAAAGTATGTCAGGTGGGGATAGCGCTAGAAATAGC	1	bc
AGCAATAGAA	GAAACACCGGTGAGCATGATAACGTCCCCGGGGGGTTAGAGCTAGAAATA	1	bc
GAATCAAACT	GAAACACCGGTTGTCGTCGCGGGTTTGTGGGGTTAGAGCTAGAAATAGCA	1	bc
TCAGCCAACG	GAAACACCGGGGGGGTTAGAGCTAGAAATAGCAAGTTAACCTTAGGCTAG	1	bc
TCAGCCAACC	GAAACACCGGTAGGGCTAGAGTTAGAAATAGCATGTTAACCTAACGCTAG	1	bc
ATCCAACATT	GAAACACCGGTGTTCGGAGATTATGCGTGAGAAATAGCAAGTAACCTAAG	1	bc
ACTACACCCC	GAAACACCGGTGACAAACGTCTGTCCGTGGGGATTAAGCCTGGAATTGCC	1	bc
AAAGCAACAA	GAAACACCGGTGTGGTTAGAGCTAGAAATAGCAAGTTAACCTAAGGCTAG	1	bc
ACTTGGGCCC	GAAACACCGGTTGTGTGGAACTCGGTGTGGGAGTAATAGCAAGTTAACCT	1	bc
AGACCAAAAC	GAAACACCGGTGGGGTTTGAGCGAGGGAGGGGTTGGAACTAGAAATAGAG	1	bc
GAACTCAATA	GAAACACCGGTGAGCATTATAACGTTCCCGTTGGGTTAGAGCTATAAATA	1	bc
TCTTCAGAAA	GAAACACCGGTGGGATTAGAGCTAGATATAGCAAGATCAACTAAGACTAG	1	bc
AATTCATCCA	GAAACACCGGTGAGAACAGAACGTTTTGGGGTTAAAGCTAAAAATAACAA	1	bc
ATTCCCGTGG	GAAACACCGGTCTTGTATGGGTTTAGGTTGGTAAAGCTAGAGATAGCAAT	1	bc
ATGTACGCGA	GAAACACCGGTGTGCGGAGATTATGCGTGAGAAATAGAAAGTAACACGGC	1	bc
CACCGCGGAA	GAAACACCGGTAGAATGGATCCACGGGTGGGGTTAGAGCTAGAAATAGCA	1	bc
AAATAACTCC	GAAACACCGGTTGAGTTAATCAAAAAGGTGGGGTGAGCTAGAAAAATCAA	1	bc
GTAGTCGATA	GAAACACCGGTGAGCATCCGCTATAGGTAGCGGTTTAACCTAAAACTAGT	1	bc
TAAGTAGTTC	GAAACACCGGTGCTAATATCGTGGGGTTAGAGTTAGAAATAGCAAGTTAA	1	bc
ACCAGCGGCG	GAAACACCGGTCGTAGGAGCCGACGGGTTAGAGTTGGAAATGGAATGTTA	1	bc
CTTTGAGCAA	GAAACACCGGTGAGAGCAGAAGGTTTTGGGGTTAGAGCTAGAGATAGCAA	1	bc
TTCTTACCAC	GAAACACCGGTCGCGAACGTGTGCCGGTGGGGTTAGAGCTAGAAATAGCA	1	bc
ATATTATCTA	GAAACACCGGTTAGCGTGATAACGTCACCGGGGGGATAGAGCTATAAATA	1	bc
AAGTTCCAAA	GAAACACCGGTGCGAGGCCTTAGGTTGGGGGGGTTAAAGCTAGAAATAGC	1	bc
TAAGCAAACC	GAAACACCGGTGGGGTTAGAGCTAGAAATAGCATGTTCACCTAAGGATAG	1	bc
ACCCACATCC	GAAACACCGGTTTAGCAGGCGTTTTGTTTGGGGTGGTTGGTGCTAGTAGT	1	bc
AACCACCCCC	GAAACACCGGTATAGTGGATCCACGGGTGGGGTTAGAGCTAGAAATAGCA	1	bc
AAATATGTGA	GAAACACCGGTTTAGGATGCTTTCGGTTTGGGGTAGTTAGAGCTAGAAAT	1	bc
GTATTAGCCG	GAAACACCGGTCGCATTAATTTGCCGGTGGGGTTAGAGCTAGAAATAGCA	1	bc
GGAACATATT	GAAACACCGGTGAGCATGATAACGTCCCCGTGGTGTTAGAGCTAGAAACA	1	bc
TCACCACACA	GAAACACCGGTGGTAAGCGATGGAGAGTGGGGTTGTTGATCGAAATCGCG	1	bc
GTCATCTATC	GAAACACCGGAGAGCATGATAACGTCCAGCTAGAAATAGCAAGTTAACCT	1	bc
GTAAGCTAGA	GAAACACCGGTGAGCATGGTAACGTCCCCGTGGGGTTAGAGCTAGAGATA	1	bc
CGCCGATATT	GAAACACCGGTGCTAGCGGTTTCGAAAGGGGGGTTAGAGCTAGAAATAGC	1	bc
GGAAGAGATA	GAAACACCGGTGATCATGATAACGCCCCGGGGGTGGTAGAGCAAGAAATA	1	bc
TTATTCGTCC	GAAACACCGGTTGAGATAATCAAAAAGGGGGGTAGAGCTAGAAATAGCCA	1	bc
TACTATGCCC	GAAACACCGGTACCAGTCATGTACGGGTGGGGTTAGAGCTAGAAATAGCA	1	bc
GGGCTGTTTG	GAAACACCGGTCGTCGTTCGTAGGGCGTGGGGTTAGAGCTAGAAATAGCA	1	bc
ATCCCATCCC	GAAACACCGGTGACAAGCGATTGTGAGTGGGGATTAGAAAGTAACCTAAG	1	bc
CTCTCACACT	GAAACACCGGTTGCAAGCGCTGCTTTGTGGGGTTAGAGCTAGAAATAGCC	1	bc
ACTCCATAAA	GAAACACCGGTGACAAAAGTATGTCAAGTGGGGATAGAGCTAGAAATAGC	1	bc
TGCAGTGATT	GAAACACCGGTTCCCGTGAGCTAGAAATAGCAATTTAACCTAATGATAGT	1	bc
AACCCACTCC	GAAACACCGGTAATCTAAAGATCCCCGTTGGGATAGAGCTAGAAATAGCA	1	bc
ACGCCAGACT	GAAACACCGGTTTTCCTTGAATCTTTAGTTAATTAGAGCTAAGAATAGCA	1	bc
TCCCCATATT	GAAACACCGGTGCTAGTGGTTTCGAAAGTGGGGTTAGAGCTAGAAATAGC	1	bc
CCGAGCGAGA	GAAACACCGGTGAGATGCCTCAAGTGGGGGGGGTTGGAGCTAGAAAAAGC	1	bc
GTCTATTCCA	GAAACACCGGTTCGCGTTACTTAGGAGTGGGGTTATAGCTAGAAATAGCA	1	bc
CAATTGCACC	GAAACACCGGCTCAGCTGGTCAAAATTGTGGGGATAGCTCTAGAAATAGC	1	bc
GTGAGCGCCG	GAAACACCTGTGAGAGGACTCAAGTGTGTGGGGTTAGAGCTAAAAATAGC	1	bc
CCTCTAGCAC	GAAACACCGGTTGGCTTTACTCCTTTGTGGGGTTAGAGCTATAAATAGCA	1	bc
TTCGCATACA	GAAACACCGGTCGGGTAAGAGTGCCGGATAGCATAGTGACATAAGGCTCA	1	bc
CAGCGGATGA	GAAACACCGGTCGAGTATGTGAGGGCGGAGGTATAGAGCTAAAAATAACA	1	bc
GCACGCCACA	GTAACACCGGTAGCATGGATCCACGGGTGGGGTTAGAGCTAGAAATAGCA	1	bc
GACTAGCACA	GAAACACCGGTACTAGCGACTTATTGGTGGGGTTAGAGCTAGAAATAGCA	1	bc
TCCCGCGGCT	GTAACACCGGTATTACTGATCAACGGGTGGGGTTAGAGCAAGAAATAGCA	1	bc
GACTAACAAA	GAAACACCGGTGTTATTTCGATCTCCGTGGGGCTAGAGCTAGAAATAGCA	1	bc
ACCCCCTGCC	GAAACACCGGCGACAAACAGATGTCAAATCTAGGTAGAGCTCGTTATCGC	1	bc
AAACCCCAAT	GAAACACCGGTTGTCTGAGTTGATTAGTGGGGTTAGAGCTAGAAATAGCA	1	bc
CAACGCGTTC	GAAACACCGGTTCTATCTGTTTCGAAAGAGGTGGTAGTGCCAAAATTACC	1	bc
TATACTCACG	GAAACACCGGTTTACTTTGTGAACTAGTGGGGTTAGAGCTAGAAATAGCA	1	bc
CCCATCCTCC	GAAACACCGGTAGAAGAAGTTGAAGGGGGGTTAGAGATAGAAATAGCAAG	1	bc
GTATCACATA	GAAACACCGGTGAGAATGATATCTGCGAGGTAGTAGAGGTAAGAATAGCA	1	bc
AGGGATCAAC	GAAACACCGGTGATCTTTGCTAGAGGGTGGGGTTAGAGCTAGAAAAAGCC	1	bc
TCCACAGACG	GAAACACCGGTGGGAGTAGATCTAGTTATGGCAAGTGAACCAGAAGCTAG	1	bc
TACTTTGTCC	GAAACACCGGTTGTGGTTATTTAAAAGTGGGGTTGGGCTAGGAAGAGCCA	1	bc
ACTTCCGCAA	GAAACACCGGTGGCGCGAGGACGTTAGAGCTAGAAATAGCAAGTTAACCT	1	bc
ATACAACCAT	GAAACACCGGTTGTAAGCGATGGGTTGTGGGGGTAATACTAGAAATAGCA	1	bc
GAAATATCTG	GAAACACCGGTGATCATAATAACGGCCAGCGGGAAATAGCAGGTTAACCT	1	bc
CCCTTCCGCA	GAAACACCGGTAGTATTAATTCACGGGTGGGGTTAGAGCTAGAAATAGCA	1	bc
CCACGAAAAT	GAAACACCGGTGCTAGCGGATTCGAAAGTGGGGTTAGAGCTAAAAATAGC	1	bc
ACGATCACCC	GAAACACCGGTTCTATTTGCTCCTTTGGAGGTAGAGATATCTAGATAGCC	1	bc
CTCCGCGCCC	GCAACACCTGTAGATTGGAACCATGGGGGGGAGAAGAGCTAGAAATAGCA	1	bc
AGGTAGCGCG	GAAACACCGGTTATCGTTACGGATTAGAGCGTGGGGTTAGAGCTAGAAAT	1	bc
GTACTCTATC	GAAACACCGGTGAGCATGATAACGTCCAGCTAGAAATAGCAAGTTAACCT	1	bc
ATCACACCGT	GAAACACCGGTGTCCGGTGGTTATAAGTGGGAAGTTAACCGAAGCCTAAG	1	bc
GAGACAGTCG	GAAACACCGGTTATCGATACGGATTAGTGCGTGGGGTTAGAGCTAGAAAT	1	bc
TATTCACACC	GAAACACCGGTGGCAATTCGAACTAAGTGGGGTTAGAGCTAGAAATAGCA	1	bc
TCAACCCTCT	GAAACACCGGTGACGCGAGGACGTTAGAGCTAGAGATAGCACGTTAACCT	1	bc
AAGGGGGAGA	GAAACACCGGTTGGATGCCTCTCGTTGGGGGGGTTAGAGCTAGAAATCGC	1	bc
GAGTCAGACA	GAAACACCGGTTATCGTTACTTATTAGTGGGGGGAGAGATAGAAAGAGCT	1	bc
GCGTATATAC	GAAACACCTGTACTAGTTACTTCCGTGTTGGGTTAGAGCTAGAAATAGCA	1	bc
GAGATAGAGA	GAAACACCGGTTGAGATAATCGAAAAGTGGTGTAGAGCTAGAAATAGCAA	1	bc
GAATTAGTAC	GAAACACCGGTGCTAGCTGCTTCCAAAGGGGGGTTAGAGCAACAAATAGC	1	bc
ATTCCACCCG	GAAACACCGGTGACAATCGTGGGTCTGTGGGGTTAGAGCTAGAAATAGCA	1	bc
CTCTCGCAAA	GAAACACCGGTCCAACAGCTGTCCTGGGGGGTGTAAGAGCAAGAAATAGC	1	bc
CACTTGCAAC	GAAACACCGGTTTAACTTGCTCCTTTGTGGGGTTAGAGGTAAAAAAAACA	1	bc
AGCTCACCAA	GAAACACCGGTGAGAAGAGAACGTTTTGGGGATAGAGCTAGAAACAGCAA	1	bc
TATACCCAAT	GAAACACCGGTGGCCATTCGATCTTAGTGGGGTTAGAGCTAGAAATAGCA	1	bc
GTCTTATCTA	GAAGCACCGGTGTGCGGAGCTTATGCGTGAGAATTAGCAAGTAACCTAAG	1	bc
TCAGCCTACA	GAAACACCGGTGGCGCTAGTGCTAGAAATAGAAAGTTAACATAAGGATAG	1	bc
AACCCCTGAC	GAAACACCGGTGACAAACGTAAGTCTAGTGGGGTTCGAGCCAGAAATAGC	1	bc
CGGGGGATAG	GAAACACCGGTCGTCGTACGTCGGGAGTGGGGTTAGAGATATAAATAGAA	1	bc
ATCCCCCCCT	GACACACCGGTTGTAAGCTTTGGTTTGTGGGGTTAGAGCTAGAAATAGCA	1	bc
CTGTTATCCC	GAAACATCGGTCGCCTTTATTCCTTTGTGGGGTTAGAGCTATAAATAGCA	1	bc
TCAACAACCC	GAAACACCGGTGGGGTTAGAGCTAGAAATAGCATGTTAACCTAAGTCTCG	1	bc
AAGCGGGTAA	GAAACACCGGTCGTGGGTAAGTGGGCGTGGGGGTAATAGCAGGTATAGCT	1	bc
TCCACAAACA	GAAACACCGGTGCTAGCGGTTTCGAAAGTGGGGTTAGAGCTAGAGATAGC	1	bc
GTCATATCGA	GAAACACCGGTGAGCATGCTAACGGCGCCGGGGGGATAGAGCTAAACAAA	1	bc
GAATCATCCA	GAAACACCGGTTTTCGTGAATAGGGAGAGGTAGTAAAGCTAGAATTAGCA	1	bc
AGCTCACAGA	GAAACACCGGTGTGCGTGGATTATGCGTGAGAAATAGCAAGTAACCTAAG	1	bc
TCAACCATCT	GCAACACCGGTGGGTTTAGAGCTAGAAATAGCAAGTTAACCTAAGCCTAA	1	bc
TGTCCAGATT	GAAACACCGGTCTTCGTGGGGTAGAGCTAGAAATGGCAAGTTAACCTAAG	1	bc
GCCTGCAGCC	GTAACACCTGTAGTAGTGACATACGGGTGGGGTTAGAGCTAGAAATAGCA	1	bc
GGATAGGTAC	GAAACACCGGTGCTCGTTGCTTGCGGGTGGGGTTAGAGCTAGAAATAGCA	1	bc
AGCCTGTTAG	GAAACACCGGTTTTCGTTCGTAGGTTAGAGATAGAGATAGCGAGATATCC	1	bc
AAAACAAAGA	GAAACACCGGTGTAGATTGGAAGGTAGCGGGGGTAGAGGAACAAAAAGTA	1	bc
GAACACCACC	GAAACACCGGTAATCTAAAGATCCCCGTGGGGATAGAGCTAGAAATAGCA	1	bc
GCGATGTATA	GAAACACCGGTGGGCATGATAACGGTGAGGGAGAAATAGCAAGCTAACCT	1	bc
ATACTATAAT	GAAACACCGGTGAGCATGATAACGTCCCCGTGGGGTTAGAGCTAGAAATA	1	bc
AATCCAGAAA	GAAACACCGGTTGTGGGGGACTAGGTGTGGGAGAAGTAGCAAGTTAACCT	1	bc
GTTTGGGAAA	GAAACACCGGTGAGCATGACTACGTGCCGGTGGGGTTAGAGCTTGACATA	1	bc
ATGGGCCAGG	GAAACACCGGTGAGCTGCCTCAAGTGGGGGGGGTTAGAGCTGGAAATCGC	1	bc
AAACCATAAA	GAAACACCGGTGACCATCGTATCTCAAGAGCTGCTAGTGGCAAGATAAGC	1	bc
ATTGTACCAA	GAAACACCGGTGTGCGGAGATTGTGCGTGGGAAATAGCAAGTAACCTAAG	1	bc
AAATCAATAA	GAAACACCGGTGTAGAATGGGTTTAGGTGGGGGGAGAGCGAGCTAGAACT	1	bc
CTCCAACGCC	GAAACACCGGTGGGCTGGGACTATGCGTGAGAATTAGCAAGTAACCTAAG	1	bc
AGGCAGGTAG	GAAACACCGGTCTTCGTTGCTGGGGGGTGGGGTTAGAGCTAGAAATAGCA	1	bc
AATACTTCCT	GAAACACCGGTGACCGACAGATGGCAAGGGGGGTTAGAGCTGAAAAAAGA	1	bc
GGCTATGAGA	GAAACACCGGTACTAGGTACTTACGGGTTGAGTTAGAGCTAGAAATAGCA	1	bc
GAATCAGTCA	GAAACACCGGTACTAGTTACTTATTGGTGGGTTAGAGCTTGAAATAGCCA	1	bc
GCGCGACGCC	GAAACACCTGTAGAATGGGTACACGGGTGGGGTTAGAGATAGAAATAGGA	1	bc
AAAACATGAC	GAAACACCGGTTTAGTATGGGTTTAGTTTAGTGGGGTTAGAGCTAGAAAT	1	bc
TCTGCAGCAA	GAAACACCGGTGGGGTTAGAGCTAGAATGAGCAAGTTAACCTAAGGCTCG	1	bc
AATACAGAAG	GAAACACCGGTGCCCTTTATGCGAGAGTGGGGTTAGAGCTAGAAATAGCA	1	bc
TTGACCGAGA	GAAACACCGGTGGGATGCCTCAAATGGGGGGGGTTAGAGCTAGAAATAGC	1	bc
ATAACACAAA	GAAACACCGGTGGGAAGGGGAGCTTAGTGGGGTTAGAGCTAGAAAGAGCA	1	bc
CCCGGCGACA	GAAACACCGGTGAGATGCCTCAAGGGGGTGGGGTTAGAGCTAGAAATAGC	1	bc
CCACCACGAC	GAAACACCGGTAACAAAGTTATGCCGATGGGGGTAGAGGTAGAAAAAAGC	1	bc
ATTTAATCGC	GAGACACCGGTGAGCAACGATTATGAGTGAGAATTAGCAAGTAACCTAAG	1	bc
GAATTGAATG	GAAACACCGGTGCTAATATCGTGGGGTTAGGGCTAGAGCTAGAAAGTTCA	1	bc
GAGGGAGCCG	GAAACACCGGTTATAGGAAACACCGGGGTTAGAGCGAGATAGAGAAAGCA	1	bc
GAACGAGTTC	GAAACACCGGTGCTAGAAAGTTCGAAGGGGGGGTAGAAGTAGAAATAGCC	1	bc
AGTCCAGCAG	GAAACACCGGTGACAAAAGAATGTCAAGGGGGGTTAGAGCTAGAAATAGC	1	bc
ATCTAGCCAC	GAAACACCGGTGTTCTTTGGTCGAGGGTGGGGTTAGAGCTAGAAATAGCA	1	bc
CAAAGTGCCT	GAAACACCGGTGCTAGCGGGTTCGAAAGTGGGGTTAGAGCTAGAAATAGC	1	bc
GAACCACACG	GAAACACCTGTTTTAGTAAATGGTGAGTGGGGTTAGAGCTAGAAATAGCA	1	bc
GCCCGACGAC	GAAACACCGGTAGACTGGATCCACGGGTGGGGTTAGAGCTAGAAATAGCA	1	bc
AGAAAGTACA	GAAACAACGGTGTTCTTTACTCGAGAATGGGGTTAGAGCTAGAAATAGCA	1	bc
AAATCCAAAA	GAAACACCGGTTTAGAATGGGTTAGGTTAGTGGGGGTAGAGATAGAAATA	1	bc
GTGTGAGAAA	GAACCACCGGTGACATGCCTCAATAGGGGGGGTTTAGATCTAGAAATAGC	1	bc
GAATTATTTA	GAAACACCGGTGGGCACGTGGGGTTAGAGCTAGAAATAGCAAGTTAACCT	1	bc
GACAAAAAAC	GAAACACCGGTAATGTAAAGATCCCCGTGGGGATAGAGCTAGAAATAGCA	1	bc
ACGTCCGCAG	GAAAAACCGGTTGTCTATGCTGCTTTGTGGGGTTAGAGCTATAAATAGCA	1	bc
AATTCAACAG	GAAACACCGGTTGTCGTTACCGCTGTGCGGGAGGAATAGCAGGTTGACCT	1	bc
GGGGGCGATG	GAAACACCGGTGAGATGCCGCAAGGGGGGGGGGTTAGAGCTAGAAATGGC	1	bc
CAAAAAGGCT	GAAACAGCGGGGCTTAGAGCTTCGAATAGGGGGTAGAGCTAGGGATAGCA	1	bc
GCTTTCATAA	GAAACACCGGTGAGAACAGAACGTTTTGGGGTTAGAGCTAGAAATAGCAA	1	bc
TGCACTTATA	GAAACACCGGTGCCCGTTAGCACGTCCGGTTGGGGCTAGAGCTAGCAATA	1	bc
TGCACTACAC	GAAACACCGGTTCCCGTTAGCTAGAAGTAGCAAGATAACCTTAGGCTAGT	1	bc
AATCATTCAA	GAAACACCGGTGCCAGACGCATGTGAAGTGGGGTTAGAGCTAGAAATAGA	1	bc
GAGTTAGTCC	GAAACACCGGTGAGATGCCTCAAGAGGGGGGGGTTAGAGCTAGAAATCGC	1	bc
AACATATCAC	GAAACACCGGTTTTCGATCATAGGCTAGAGCTAGAAATAGCAAGTTAACC	1	bc
GTCATAGAAA	GAAACACCGGTGCGAATGACATAATAGTGGGGGTAGAGATAGAAGTAGTA	1	bc
CCCAGCCGAG	GAAACACCGGTAGTATGGATCCACGGGTGGGGTTAGAGCTAGAAATAGCA	1	bc
ATATACTAAC	GAAACACCGGTGTTCTTTGTGCGAGGGTTGGGTTAGAGCTAGAAATAGCA	1	bc
AACACTCTCT	GAAACACCGGTTTTCGATCATACGTTGGAGCTAGAATTAGCAAGTTAACC	1	bc
CACCGCCACT	GAAACACCGGTAGTAGCGATTCACGGGGGGGGGTAGAGCTAGAAATAGCA	1	bc
CCCTTGATCC	GAAACACCGGTTCAACCGACGTCTTTGTGGGGGTTAGAGCGAGAAATAGC	1	bc
GCAATCTTCA	GAAACACCGGTGACCATGGTACCGTACAGCTAGAAATAGCAAGTTAACCT	1	bc
GAGTCCGAGA	GAAACACCGGTGTAATGCCGTAAGTGGGGGGGTTTAGAGCAGGAAATGGC	1	bc
AACCGCTGCC	CTAAACACCGGTAGAATGGATACACGGGTGGGGTTAGAGCTAGAAATAGC	1	bc
AGACCGCATT	GAAACACCGGTCTTCTTTGATCGTAGGTGGGGATAGAGCTAGAAATCGCA	1	bc
CAGTCATCAC	GAAACACCGGTTGGCTTTACACCTTTGTGGGGTTAGAACTATAAATAGCA	1	bc
TAAACCCAAT	GAAACACCGGTTTAGTTAGAGCTCTAGATGGCTTGTTACCAGAAATATCA	1	bc
GAAGGCGCGA	GAAACACCGGTGAGATGCCTCAGGGGGGGGGGGTTAGGGCTAGAAATAGA	1	bc
ATACCCTTTA	GAAACACCGGTGATCATTGTAACGTCCGTCTTGAAATAGCAAGTTAACCT	1	bc
GAATCAGACA	GAAACACCGGTGATATGCCTCTAGGGGGGGGGGTTAGAGCTAGAATTAGA	1	bc
CTATCGATCG	GAAACACCGGTTGAGACAACTAAAAATGGGGGGTTAGCTAGAAAAAGCAA	1	bc
CCACGCCATC	GAAACACCGGTGGTAGCGGTTTAGGAGTGGGGTTAGAGCTAGAAATAGCA	1	bc
AATATACAAA	GAAACACCGGTGGCCATTCGATCGTCGTGGGGTTAGAGCTAGAAATAGCA	1	bc
GCCACCCTAC	GCCACCCCGGTAATCTCCCGATCCCCGTGTGGATAGAGCCAGCAATCGCA	1	bc
CAATAAGAGA	GAAACACCGGTGCTAGCGGATTAGAAAGGAGAAATAGAACTAAAAATAAC	1	bc
AGAAATATAT	GAAACACCGGTGAGCATGCTAACGGCCAGCTAGTAATAGCAAGTTAACCT	1	bc
TCAAACCACC	GAAACACCGGTAGTGTTAAAGCTAGCGATGGCATGTTAACATAAGGCTCG	1	bc
AGTGGTCGAG	CTAAACACCGGTGAGATGCCTCAAGTGGGTGGGGTTAGAGCTAGAAATAG	1	bc
GTATCAGACG	GGAACACCGGTTGTAGGAGATGGTTAGTTGGGTTAGAGCTAGAAATAGCA	1	bc
TAATAAGTAA	GAAACACAGGTTCTAGTTACCTACGGGTGGGGTAAGAGCTGGAATAAGAA	1	bc
ATCCCACAGA	GAAACACCGGTTGGCGGAGATGATGTGTGAGAAATAACATGTAACCTAAA	1	bc
AATCTATTAG	GAAACACCGGTTTTCGATCATAGGTTAGAGGTATAAATGGCAAGATAACC	1	bc
GCGATAAGCC	GAAACACGGGTTGGTATTGCTAGTAATAGCGAGTAGAGCTATGGCTAGCA	1	bc
GAACCATCAG	GAAACACCGGTGACAAACGTATGTCAGGTGGGGTTAAAGCTAGAAATAGC	1	bc
TTAACATAAA	GAAACACCGGTGGGGATAGAACGTCAAATGGGGATATAGCCAGAGAAAGC	1	bc
AAGGCAAGAT	GAAACACCGGTTATCGTTACGGATTATAGCGTGGGGTTAGAGCTAGAAAT	1	bc
GAAATATCTG	GAAACACCGGTGAGCTTGATAACGCCGAGCGGGTAGTACCAGGATTACCT	1	bc
ACACGACGAC	GTAACACCGGTAGAATGGATCCAAGGGTGGGGTTAGAGCTAGAAATAGCA	1	bc
ATCACCCTCC	GAAACACCGGTCCTATAAGCTGAGTTAGAGCTAGAAATAGCAACAAGTTA	1	bc
GAAAAAGTCC	GAAAAACCGGTTATCTAAAGTGGCCCGTGGGGATAGAGCTAGAAATAGCA	1	bc
CAATGCGGCA	GAAACACCGGTAGAATGGAACCACGGGTGGGGTTAGAGCTAGAAATAGCA	1	bc
ATGCCCGAAG	GAAACACCGGTCCTAGAAGCTGAGTTAGAGCTAGAAATAGCAACAAGGTA	1	bc
TCCGCCACCC	GAAACACCGGTGGGGTTAGAGCTCGAGAGGGCAAGTTAACCTAAGGATCG	1	bc
GATTTATATA	GAAACACCGGTGAGCATGCTAACTTCCAGCTAGTAATAGCAAGTTAACCT	1	bc
TACAGTGACT	GAAACACCGGTTCCCGTTAGCTAGAAATAGCAAGTTAACCTGAGGCTAGT	1	bc
TTGGGAGATC	GAAACACCGGTGAGATTCCTCAAGTCGGGGGGGTTAGCGCTAGAAATAGC	1	bc
CGCCGTTCCG	GAAACACCGGTCGTCGTTCGCAGGGCGTGGGGTTAGAGCTAGAAACAGCA	1	bc
TACAAAATCG	GAAACACCGGTGGACTTAATGGAACAGTGGGGTAGAGTTAGAAATAGGAA	1	bc
GACAAACTAA	GAAACACCGGTAAGCTAAGGATCCCCGGGGGGATAGAGCTGGAAATAGCA	1	bc
AACCCATTGC	GACACACCGGTTTAGAACTAGATTTAGTTAGTGGGTTTAGAGCTAGTTAG	1	bc
AACTTACTAA	GAAACACCGGTGTTCATAGATAGGTTGGGGGGAGAGAGCGAGAGATAGCA	1	bc
CGACTGGATG	GAAACACCGGTCTTCGTTCGTAAGGCGTGGGGTTAGAGCTAGAAATAGCA	1	bc
TCAGCCCCCC	GAAACACCGGTCGGGAAAATGCGCCGGAGGGGATAGTGATCGAAATAGCA	1	bc
TGTCCAGATT	GAAACACCGGTCTTCCTGGAATCTACGTGGGGTAGAGCTAGAAATAGCAA	1	bc
CCTCGCGGCA	GAAACACCGGTAGAATGGATCCACGGGTGGGGTTAGAGCTAGAAATAGCA	1	bc
TCACCCACCA	GAAACACCGGTTGAGTTCGAGGGTTTATGGGGATAATGATCAAATTATCA	1	bc
TCATCTTCCA	GAAACACCGGTGGGTTTAGAGCTAGAAATAGCAAGTTAACCTAAGGCTAG	1	bc
TACAATAGCG	GAAACACCGGTTATCGTTACGGATTAGAGCGTGTGGTTAGAGCTAGAAAT	1	bc
AGCCCGCCAC	GAAACACCGGTGTTCTTTGCTCGAGGGTGGGGTTAGAGCTAGAAATAGCA	1	bc
AACAAAGTCC	GAAACACCGGTAATCTAAAGATCTCCGTGGGGATAGAGCTAGAAATAGCA	1	bc
GTTGGCGCGC	GAAACACCGGTGAGATGCCTCAAGTGGGTGGGGTTAGAGCTAGAAATAGC	1	bc
CTCTCACAGA	GAAACACCGGTGTGCGGAGATTATGAGTGAGAAATAGCCAGTAAACTAAG	1	bc
GCAATAGCTA	GAAACACCGGTGAGCATGATAACGTCGCCGTGGTGGTAGAGCTAGAAATA	1	bc
ACCCACGGAA	GAAACACCGGTACTAGTTACTTACGGGTGGGGTTAGAGCTAGAAATAGCA	1	bc
ATCAGCAGAA	GAAACACCGGTGGGGTTAGAGCTAGAAATAGCAAGTTAACCTAAGGCTAG	1	bc
ATATAACAAA	GAAACACCGGTGTGCGGAGATAATGCGTGGGGAATGGGAAGGAAACTGAG	1	bc
CTCTCGCCCA	GAAACACCGGTCGAGAAAATGTGTTGGTGGGGTTAGAGCTAGAAATAGAA	1	bc
GCCGGCCGCT	GAAACACCGGTAGAATGGGTCCACCGGTGGGGTTAGAGCTAGAAATAGCA	1	bc
AAACCCGTTG	GAAACACCGGTTTAGGAAGGGGTTAGGTTAGTGGGGTTAGAGCTAGAAAT	1	bc
TCAGCAACCC	GAAACACCGGTGGGGTTCGCGCTATAAATGGCACGTTAACCTAAGTCTCG	1	bc
TGCCAACACT	GAAACACCGGTGGCCGCCAGCCACTTGTGGGGTTAGAGCTAGAAATATCA	1	bc
GTATTCAACA	GAAACACCGGTGCTAATATCGTGGTGGTGGGGCTAGAGCTAGCAATATAA	1	bc
AATCGACCAT	GAAACACCGGTTACAAACGTATGTCAAGTGGGGTTAGAGCTAGAAATAGC	1	bc
GATCGCGACA	GAAACACCGGTGAGATGCCTCAAGCGGGTGGGGTTAGAGCTAGAAATAGC	1	bc
GGCAACTTAA	GAAACACCGGTCGTAGTTACTAGCGGGCGGGGTTAAGGCTGGAAATAGAT	1	bc
TCATCAATCG	GAAACACCGGTTGTGGTAGACCTAGAAATAGGTAGTTAACCGAATGCTCA	1	bc
AATACGAAAA	GAAACACCGGTGGGGTTAGAGCTAGAGAGGGCAGAGTAACATAAAGATAG	1	bc
GGTTTATAAA	GAAACACCGGTGAGCACAAAAAGTTTTGGGGGTAGAGCTAGCTATAGATA	1	bc
TAAGCAGACT	GAAACACCGGTGGGGGTGGATTTGTAAAGGGGATGTAAACATAAAGATCG	1	bc
AGACAACCAA	GAAACACCGGTGTTCTTTGCTCGAGGGGGGGTTTGGGGCTGGAAATGGCA	1	bc
