AAAACCATTA	GAAACACCGGTTTAGTATTTGGGGTTATGGCTAGAAATAGCAAGTTAACC	1
AAACAGGAAC	CTAAACACCGGTGTTCTTTGCTCGAGGGTGGGGTTAGAGCTAGAAATAGC	1
AAACGCGATT	GAAACACCGGTTTTGGAGGTGGGGTAGGAGGTAGAAATAGCAAGTTAGCC	1
AAACGGGATT	GAAACACCGGGGCTATCGGTTTCGGGGGGGGGTTAGAGCTGGAAATAGCA	1
AACAACGCCC	GAAACACCGGTACTCTAAAGATCCCCGTGGGGATAGAGCTAGAAATAGCA	1
AACATGCTAG	GAAACACCGGTTTTCGATCATAGGTCGAGGGGTTAGAGCTAGAAATAGCA	1
AACCCGATAA	GAAACACCGGTTTTTTATCATAGGTTGTGGGAGTAAAGACAAAATTAACC	1
AACTATGTCA	GAAACACCGGTACTCGTTACTTAAGGGTGGGGTTAGAGCTAGAAATAGCA	1
AATCCATCAC	GAAACACCGGTGACAAACGTATGACAGTGGGGTTGGAGCAAGAAATAGAA	1
AATCCATCAC	GAAACACCGGTGACAAACGTATGTCAGTGGGGTTAGAGCTAGAAATAGCA	1
AATCCCGCAC	GAAACACCGGTGACAGACGCAGATCAGGGGGGGTTGAGGCTAGAAATGGA	1
AATTCCTCAC	GAAACACCGGTTTCGAACGTGTGTCTGGGGGGAGAAAGCTCGAGATAGCA	1
AATTGGGCAA	CAAAACACCGGTTGTGGGGAACTCGGTGTGGGAGAAATAGCAAGTTAACC	1
ACCTAGCAAC	GAAACACCGGTTCGACCGGCGTCTTTTGGGGGGTTAGGGCTAGAAATAGC	1
AGACAGCAAC	GAAACACCGGTGTTCTTTGCTCGAGGGTGGGGTTAGAGCTAGAAATAGCA	1
AGACAGCACC	GAAACACCGGTGTTATTTGCTCGATTGTGGGGTTAGAGCTAGAAATAGCA	1
AGACCGCACC	GAAACACCGGTTGTCTTCGCTCGTGTGTGGGGTTAGAGCTAGAAATAGCA	1
AGACCGGAAC	GAAACACCGGTGGTGTTTGATTGGGGGTGGGGTTAGAGCTAGAAATTGGA	1
AGCAAGCTAG	GAAACACCTGTTTTCTATCATAGGTCGTGGGGTTAGAGCTAGAAATAGCA	1
ATCATCGTCG	GAAACACCGGTCCTAGAAGCTGGGCTGGAGGGTTAGGGTAGAGCTAGAAA	1
ATCGCACCGA	GAAACACCGGTGTGGGGAGATTTTGCGATAGAAATATAAAGTAAGCCAAG	1
ATCTAACCGA	GAAACACCGGTGTGCGGAGATTATGCGTGAGAAATAGCAAGTAACCTAAG	1
ATCTTACCGA	GAAACACCGGTGTGCGGAGATTATTCGTGGGAAATAGCAAATAACCTACG	1
ATGACATACA	GAAACACCGGTGCGCGTGAGCTAGAAATAGCAAGTTAACCCTAAGCTTAG	1
ATGACCGCCG	GAAACACCGGTCCTCGATGGCGAGTTAGAGGTAGAAATAGCAAGATAACA	1
ATGACCGTCG	GAAACACCGGTCCTAGAAGCTGAGTTGTAGTGTGAGAGCTCGAAATAACG	1
ATGACCGTCG	GAAACACCGGTCCTAGAAGCTGGGTTTGAAGGGGTGGTGAGAGCTAGAAA	1
CAACTATATA	GAAACACCGGTCCTCGCTCGTAGGTTTAGAGTTGGAATTACCAGGTTAAC	1
CAATTACTAA	GAAACACCGGTGGCAATTCTATCTGAGTGGGGTTAGACCTAGAAAAACAA	1
CACCGAGATT	GAAACACCGGTGCTAGCGGCTTCGAAGTGGGGTTAGAGCTAGAAATAGCA	1
CATACGCCAG	GAAACACCGGTTTTCGTTCATTGTGAGTGGGGTTAGAGCTAGAAATAGCA	1
CATGCAAAAA	GAAACACCGGTGGGAATAGGGCTTGAGATAGCATGGAAATCTAAGGCGAG	1
CATTATGCAA	GAAACACCGGTAGTAGTTACTTATTGGTGGGGTTAGAGCTAGAAATAGCA	1
CATTCATCAC	GAAACACCGGTTCAAACGGTATCTTATGGGGGGTAGAGCCTGAAATAGCC	1
CCCCGCCGCC	GAAACACCGGTAGAATGGATCCAGGGGTGGGGTTAGAGCTAGAAATAGCA	1
CCCTCGAACC	GAAACACCGGGGCTAGAGCTAGAAATAGCAAGTTAACCTAAGGCAAATCC	1
CCCTCGCACC	GAAACACCGGTTCAACCGGCGTCTTTGGGGTTAGAGCTAGAAATAGCAAG	1
CCCTGGCACC	GAAACACCGGTTGAACCGGCCTGGGGTTGGGGCTAGAGCTAGAAATATCA	1
CCGTTAACAC	GAAACACAGGTTTTCGATCATAGGTCGAGGGGTTAGAGCTAGAAATAGCA	1
CGGCAACCAC	GAAACACCGGTGTTCTTTGCTCGAGTGTGGGGTTAGAGCTATAAATAGCA	1
CGGCGGGCTG	GAAACACCGGTCGTCGTTCGTAGGGCTAGAAATAGCAAGTTAACCTAATG	1
CGGCGGGTTG	GAAACACCGGTCGTCGTTCGTAGGGCGTGGGGTTAGAGCTAGAAATAGCA	1
CGGGGGTTTT	GAAACACAGGTCGTCGTTCGTGGGGTTAGAGCTAGAAATAGCAAGTTAAC	1
CGTTCAGCAA	GAAACACCGGTTGTGGGGGAATCGGTGTGGGGGTAAAAGCAAGATAACCT	1
CGTTCATCAA	GAAACACCGGTGCTAGAAAAAGCAAGTTAACCTAAGGCTAGTCCGTTATC	1
GAATCAGCCG	GAAACACCGGTTTTAGTAAATGGGGAGTGGGGTTAGAGCCAGAAATAGCC	1
GAATCAGCCG	GAAACACCGGTTTTAGTAAATGGTGAGTGGGGTTAGAGCTAGAAATAGCA	1
GAATCAGCCG	GAAACACCGGTTTTAGTAAATGGTGAGTGGGGTTAGAGCTAGGAATAGCA	1
GAATTAAAAA	GAAACACCGGTGAGAATAGTAACGTCCGGGGGGTAAGAGCTAAAATTGGC	1
GAATTAAAAA	GAAACACCGGTGCTAATAGTTAGCTCGTGGGGTTAGAGCTAGAAATAGCA	1
GAATTAAACA	GAAACACCGGTGCTGATAGTTAGCTCGTGGGGTAAGACCTAGAAAAAGCA	1
GAATTCCGCC	GAAACACCGGTAATATTAATAAACACGTGGGGTTAAAGTTAGAAATAGCA	1
GACACGCTCG	GAAACACCGGTTTTCGTTCATAGGTCGTGGGGTTAGAGCTAGAAATAGCA	1
GACTAAGTAA	GAAACACCGGTACTAGTTACTTACGGGTGGGGTTAGAGCTAGAGATAGCA	1
GACTATGTAA	GAAACACCGGTACTAGTTACCTACGGGTGGGGTTAGAGCTAGAACTAGCA	1
GACTCAGTAG	GAAACACCGGTACTAGTAACTTGCGGGTGGGGTTAGAGCTAGAAATAGCA	1
GAGTCAAGCG	GAAACACCGGTTATAGCTAGAGATAGGTTGTTAAAGAGATACTAGTCCCA	1
GAGTCAGCCG	GAAACACCGGTTTTAGTAAAGGTAGAGAGGGGTTGTAGACAGAAAGAGAG	1
GCACTCTGTC	GAAACACCGGTTAGCTGGATCACCGAGCGGGTTTAGAGATGGCTAGTGCG	1
GCCTCTGCAA	GAAACACCGGTGATAATTACTTACTTTGGGGGTTCGGCCTGGAAATAGCA	1
GGCCAGCACC	GAAACACCGGTCTTCTTTGGATCCGCGTGGGGATAGAGCTAGAAATAGCA	1
GGTAAATACG	GAAACACCGGTGCCTAGAAAGTGAAAGTTAAGCTAGGGATGGTACGTTAT	1
GTAATATATA	GAAACACCGGTCGTCGTTCGTACGGGAGCGCTTAGAGTTAGATATAGCAC	1
GTAATATATA	GAAACACCGGTGAGCATGAGCTAGAAATAGCAAGTTAAGCTAATGCTAGT	1
GTAATATATA	GAAACACCGGTGAGCATGATAACGTCCCCGTGGGGTTAGAGCTAGAAATA	1
GTAATATATT	GAAACACCGGTGAGCATGAGCTAGAAATAGCAAGTTAACCTAAGGCTAGT	1
GTATCAGACA	GAAACACCGGTACTAGTTGCTTACGGGTGGGGTTAGAGCTAGAAATAGCA	1
GTATTATATA	GAAACACCGGTCGTCGTTCTTAGGTGTTGGGTTCGAGCTAGAAATAGCAA	1
GTCCTGTATA	GAAACACCGGTTCTCATGATAACGTTGGGGGGAGAGAGCTAGAGATAGCA	1
GTTCTAGACT	GAAACACCGGTGAGCTTGATAACGTCGTGGGGTTAGGACTAGAAATAGCA	1
TAATCAAACC	GAAACACCGGTTGAGCGGGGGAGAGTTGGAAATAGAAAGCTAACCATAGG	1
TAATCAAGCC	GAAACACCGGTTGTGGTTACGAATAAGTGGTAGAGATCGAGAGTTAGCAT	1
TAATGGGCCA	GAAACACCGGTTGTGGGGAGCTCGGTGTGGGAGAAATAGCAAGTTAACCT	1
TACACTTAAT	GAAACACCGGTACCCGTTACTTACGGGTGGGGTTAGAGCTAGAAATAGCA	1
TCAACCCTCT	GAAACACCGGTGACGCGAGGACGTTAGAGCTAGAAATAGCAAGTTAACCT	3
TCAACCCTCT	GAAACACCGGTGACGAGAGGACGTTAGAGCTAGTAATAGCAAGTTAACCT	1
TCAGCAAAAA	GAAACACCGGTACTAGTTACTTACGGGTGGGGTTAGAGCTAGAAATAGCA	1
TCATTAATAA	GAAACACCGGTGGGGATAATAAGAAAGTGGGGTAGAGCTAGAAATAGCAA	1
TCCACTTCCT	GAAACACCGGTTCCCGTTAGCTCGTGGGGTTAGAGCTAGAAATAGCAAGT	1
TCCCCCCGCC	GAAACACCGGTAGACTGGATACACAGGTGGGGTTAGCGCTAGAAACAGCA	1
TCTTTCCCAC	GAAACACCGGTGGCAATTCGATCTGAGTGGGGTTGGAGCTAGAAATAGCA	1
TGCACTTACT	GAAACACCGGTTCCAGTTCGCTCGTAAGTGGGGTTAGAGCTGGAAATAGC	1
TGCACTTCAT	GAAACACCGGTTCCCGTTAGCTCGTAGTGGGGTTAGAGCTAGAAATAGCA	1
TTTCAAGATT	GAAACACCGGTCTGCGGGGAATATACGTGGGGTATAGCTAGTAATAGCAA	1
