AGCCCTCCCT	GAAACACCGGTTCCCGTTGGCTCTTAGTGGGGTTAGAGCTAGAAATAGCA	1	bc
TAATCAAAAC	GAAACACCGGTGCTACTAGTTAGCGGGTAGAGCTAGAGATAGAAATATCA	1	bc
GGATCATCCA	GAAACACCGGTGTTAACAGATAATAGCAGGGTTAACTACTGCAAATAGCA	1	bc
AAATTAACAC	GAAACACCGGTGCTAATAGTTAGCTCGTGGGGTTAGAGCTTGAAATAGCA	1	bc
TAATTCGTCA	GAAACACCGGTGAGGCTCCTCACAAATTGGGGCAAGGATAGGCATCGCAA	1	bc
TGCACATCAA	GAAACACCGGTGAGAACAGAAAATAGCAAGTTAACCTAAGGCTAGTCCGT	1	bc
ACTTCCGCCG	GAAACACCGGTGCTCTTTATGGGTTTGTGGGGTTAGAGCTAGAAATATCA	1	bc
TTCTTCGCGA	GAAACACCGGTGGCAAGAAAATGTCAGTGGGATTCGAGCTAGAAATAGCA	1	bc
CGATCACCAC	GAAACACCGGTTAGAACAGAAAATAGGAAGGTAACCTAATGGTAATACGT	1	bc
TATACTGCCT	GAAACACCGGTGCCCTTTATGGGACCGTGGGGTTAGAGCTAGAAATAGCA	1	bc
GTGCCAAACT	GAAACACCGGTTATCGGTACGGCTATAAATAGCAAGTTAACCTAAGGCCA	1	bc
AAACCCTCCC	GAAACACCGGTTTAGTATGTGGAGTTAAACCCAGACATAGCAAGTTAACC	1	bc
ATGTCACTAA	GAAACACCGGTGGCAGTAGCTTATGAGTTGGGGTTAGAACTAAAAATACC	1	bc
AACGTACTAA	GAAACACCGGTTTTCGATCATAGGTCGTGGGGTTAGAGCTAGAAATAGCA	1	bc
TGTTCAGCAT	GAAACACCGGTGTTCATGGAGTGTTGTGGGGTTAAGCCAGAATAAACAAG	1	bc
GGCTGTGTAG	GAAACACCGGTACTAGTTCCTTACGGGTGGGGTTAGAGCTAGAAATAGCA	1	bc
CCCTGCCACA	GAAACACCGGTTCAACCCGCCTCCGGGTTTAGCGCTAAAAATCGAAATAT	1	bc
AATCGAGATT	GAAACACCTGTTGTGCGGGAATCGGCGTGGGGGAAATAGCAAGTTAACCT	1	bc
CAGCACCTCC	GAAACACCGGTAATCTAACGATCCCCGTGGGGTTAGAGCTAGAAATAGCA	1	bc
CGATCCTTAA	GAAACACCGGTTAGGAAAGAAAATAGTAAGTTAACCTAAGGTTAGTCCGT	1	bc
GTCTTACACA	GAAACACCGGTGCTAATAGTTAACTCGTGGGGTTAAGGATAGAACTAGAA	1	bc
AGTCGGGTTG	GAAACACCGGTGGTCGTTCGTGGGGTTAGAGCTAGAGCTAGCAAGTTAAC	1	bc
CTGTTCACCC	GAAACACCGGTCGCGAAAATGTGCCGGTGGGGTTAGAGCTAGAAATAGCA	1	bc
ATTATCGCCG	GAAACACTGGTGCCCTTTATGTAACCGTGGGGCTAGAGCTAGAAATAGCA	1	bc
ATCACTGCAG	GGAACACCGGTCCTAGAAGCTTACGTGTGGGGTTAGAGCTAGAAATAGCA	1	bc
GACTACGCCA	GAAACACCGGTACTAGTAACTTACGGGTGGGGTTAGAGCTAGAAATAGCA	1	bc
GTGATGGTAA	GAAACACCGGTTATAGATCACAGGTCGTGGGATTACAAGAAGAAACAGGA	1	bc
CAATCACTCC	GAAACACCGGTGGCGATAATCACTGAGTGGGGTAGAGGCAGGAATAGCAA	1	bc
TACAATTCCC	GAAACACCGGTACTCTATAGCTCGCCGTGGGGATAGAGCTAGAAATAGCA	1	bc
CAACGAGATA	GAAACACCGGTGCTAGCGGAGTTAGAGCTAGAAATAGCAAGATAAACTAA	1	bc
GCGCTATCAC	GAAACACCGGTGAGCAAGGTATGTTAGTGGGGTTAGAGCTATAAATAGCA	1	bc
GAGCCACACC	GAAACACCGGTTATCTTTACGGCTAGAAATGGCTAGTTAACCTAAGGCTA	1	bc
TGGACTGCCG	GAAACACCGGTTGCGGTTAGGTCGTAGAGGGGAAAGAAACAGAAATAGCA	1	bc
CCGACAACAT	GAAACACCGGTTGCCGTTACTCCTTTGTGGGGTTAGAGCTATAAATAGCA	1	bc
ACAGCGCAAA	GAAACACCGGTGGGCTTTGCTCTAGGGTGGGGTTAGAGCTAGAAATCGCA	1	bc
ACTACAGACC	GAAACACCGGTTCAAATTGTATCTTAGAGGGGTTAGAGACAGTAAATGCA	1	bc
TAACCACATT	GAAACACCGGTTTACTTAGTTACCTAGTGGGGTTAGAGCTAGAAATAGCA	1	bc
GACTGGCCAC	GAAACACCGGTAGTGTGGAACTCGGTGTGGGAGAAATAGCAAGTTAACCT	1	bc
ATCAACTTAC	GCAACACCGGTGGGGGTTGAGTTAGAAATAGCCTAGAACCAGAAAGATAA	1	bc
GCAGGCGTGT	GAAACACCGGTAACGCGAGGACGTTAGAGCTAGAAATAGCAAGTTAACCT	1	bc
CCGCTGACTC	GAAACACCGGTCGTCTTCCGTCCGTTTTGGGCTTAGAATTGCAAGTTGCC	1	bc
AATTGTTCCG	GAAACACCGGTTCCAGAGAAATGGCAGTGGAAGTAAAGCCAAGATTGGCA	1	bc
AAACCCCAAC	GAAACACCGGTTTAGTATGTGGGGTTAGGGGTATAAATAGCGAGATAACC	1	bc
AAACTACTGC	GAAACACCGGTTTAGTTTGTGGGATTAGGGGTTGAAATAGCAAGTTACCC	1	bc
AGATCACCAA	GAAACACCGGTGCGAACAGATGGTTTGGGGGGTTAGGGCAAGAAATAGCA	1	bc
CACAGGGTTT	GAAACACCGGTGTTCGCGGTTTCGCCGTGGGGTTAGAGCTAGAAATAGCA	1	bc
ATCGAACGGC	GAAACACCGGTGTGCGGAGATTATGCGTGAGAAATAGCAAGTAACCTAAG	1	bc
CAGTCAACCC	GAAACACCGGTTTGAGTAAATCGTTTGGGTGGTTCTAGCAATAACAAGTT	1	bc
TCAATAAATA	GAAACACCGGTTGTCTTAGGTAGGGATGGGGCTAGAGCTAGAAAATGCAA	1	bc
AAAACGCCAA	GAAACACCGGTTGCCTGAGTTTACTAGTGGGGTTAGAGCTAGAAATAGCA	1	bc
AAAACCGTCA	GAAACACCGGTTACCTATGTAGAACAGTGGGGTTATAGCTAGAAATAGCA	1	bc
CAATCAGAAT	GAAACACCGGTTTAAGTACTTTGTGAGTGGGGTTAGAGCTAGAAATAGCA	1	bc
CAGCGAGTTG	GAAACACCGGTCGTAGTTCTTGGGGTTGGAGCTTGAAATAGCGCGTTCCC	1	bc
AAGTTAACAA	GAAACACCGGTTGGGTTTACTCCTTTGTGGGGTTAGAGCTATAAATAGCA	1	bc
AAACAGCAGA	GAAACACTGGTTTTGTATGCTGGGGTGGGGGTAGATATCTCGAAATAGCC	1	bc
AAACGAGACT	GAAACACCGGTGGTAGGTGATGGGTTGTGGGGTTAGAGCTAGAAATAGCA	1	bc
ACCTCACGCC	GAAACACCGGTTCAACGGGAGGGGGGGTAGGGCTAGAACTAGAAAGATAA	1	bc
TCAACCCTCT	GAAACACAGGTGACGCGAGGACGGTGGTGGGGTTAGAGCTAAAAATAGCA	1	bc
GATCATGACC	GAAACACCGGTGCCCTTTATGGGCCCGTGGGGTTAGAGCTAGAAATAGCA	1	bc
GAAAACGCCG	GAAACACCGGTTTTATTAAATGGTGGGGTTAGATATAGAAATAGCAAGTT	1	bc
GAATGCAGCA	GAAACACCGGTGCTAATAGTTAGCTCGTGGGGTTAGAGCTAGAAATAGCA	1	bc
GAATTATCTG	GAAACACCGGTTATCGTGATAGCTTCGCGGGGTTATAGCGAGAAATAGCA	1	bc
CCCGCCCTCC	GAAACACCGGTGGAATGTATCCACGGGTGGGGATAGAGCTAGAAATAGCA	1	bc
CCCCCCATGC	GAAACACCGGTTTAATCTGTGGGGTTTGAGCTAGTACTAGCAGGTTTACC	1	bc
TCCCCCCTAC	GAAACACCGGTCTTCCTGGTGTTTCGTGGGGTAGAGCTAGAAATAGCAAG	1	bc
AGGCAGTTAA	GAAACACCGGTGCTATTAGCTCTTAGTGGGGGTTTAACCTAAAACTAGTA	1	bc
ATTTCACCAA	GAAACACCTGTGTCCATTCATTATGCGTGAGAAAAAGCATATAAACTAAG	1	bc
GGGAAAAACG	GAAACACCCGTGGCAGCCACGCACTTGAGGAGTTAGAGAAAGAAATACCA	1	bc
CCCTCATCCA	GAAACACCGGTGAGAACAGAAAATAGCAGGGTATAGTAATACAAGTCGGT	1	bc
CTGTTAATAG	GAAACACCGGTTGGCTTTAATCCATTGTGGGCATAGAAATATAAAGAGCG	1	bc
CCCTAACCGC	GAAACACCGGTTGGCTTTACTCCTTTGTGGGGTTAGAGCTATAAATAGCA	1	bc
GAATCCCACG	GAAACACCGGTTTTACCAGCTTCTTTTGTTGGAGTTAGGAAAGAAAAATT	1	bc
GAGAACCTAA	GAAACACCGGTGGTGGTAGATGAATTAATGGTAGATTAACCTAATGAAAG	1	bc
TCAACCCTCG	GAAACACCGGTGATGGGAGATCGTTAGAGGTAGAAAGGCTAAGTAAAGCT	1	bc
CAACGAGCTT	GAAACACCGGTGCTAGCGGATTCGAAGTGGGGTTAGAGCTAGAAATAGCA	1	bc
GCGATATCAC	GAAACACCGGTGAGCTTTATAACTTTCTTGGGGTTAAAGCTAGAAATAGC	1	bc
AATCCCTTAA	GAAACACCGGAGACAAACGGATATCAAGCGGGTTGAGAGCTATCAATATC	1	bc
TCAACATTCT	GAAACACCGGTGACTCGAGGATGGGAGTAGGGCTAGAAATAGAAAGTTCA	1	bc
GTAACCTTTA	GAAACACCGGTCTTCGATGGTGGGGGTGGGGTTAGAGCTAGAAATAGCAA	1	bc
TGAGTTAAAA	GAAACACCGGTCCTAATAGTTAGCTCGTGGGGTTAGAGCTAGAAATAGCA	1	bc
AAACCGCCAC	GAAACACCGGTGACCTTTGCTCGAGGGTGGGGTTAGAGCTAGAAATAGCA	1	bc
TCCGCATACA	GAAACACCGGTGCCGGTAGAGTCGTAGAGGGCAAGGTACTCTAAGGATAA	1	bc
CACAAAATCC	GCAACACCGGTAATCTAAAGATCCCCGTGGGGATAGAGCTAGAAATAGCA	1	bc
GCCGCACTAA	GAAACACCGGTAAGGTAAAAACTACCGATAGGATAGTGACCTAAGGAGCA	1	bc
CGTTCTCCAT	GAAACACCGGTGGCCGTTCGATCTTAGTGGGGTTAGAGCTAGAAATAGCA	1	bc
TCGGCAAACG	GAAACACCGGTGGTGGTAGCGCTAGTGAGGGGTTGGTGCCCGAAAGAGAG	1	bc
AACTATCCCG	GAAACACCGGTGCCCTTAATTTATCCGTGGGATAAGACATAGAAATAGAA	1	bc
TACTCATCCC	GAAACACCGGTCGCGAAAATGTGCCGGTGGGGTTAGAGCTAGAAATAGCA	1	bc
CCGTCCAAAC	GAAACACCGGTTTACTTAGTTAATTAGTGGGGTTAGAGCTAGAAATAGCA	1	bc
GACACAACCA	GAAACACCGGTGGGCGCCGTGGAGAGGTGGGGTTGGGGCTGGAAATAGAA	1	bc
AAAGCAAAAC	GAAACACCGGTGGCGTTAGTGCTAGAGTTGGGATGTTACTCGAAGTCGCA	1	bc
TTAACAAACA	GAAACACCGGTGGGGTTAGAGCTAGAAATAGCAAGTTAACCTAAGGATAG	1	bc
AACATGCTAG	GAAACACCGGTTTTCGATCATAGGTCGTGGGGTTAGAGCTAGAAATAGCA	1	bc
ACAGCACACA	GAAACACCGGTGGTATTAGATCTATTGTGAGCTTAGTACCCGACATATCA	1	bc
ATGATAGATG	GAAACACCGGTCATAGAAGCTGCGTTAGAGCTGGATATAGCAAGTTAACC	1	bc
CAATCCCTGC	GAAACACCGGTTTAGTATGTGGGTTTAGAGCTAGAAATAGCAAGATAACC	1	bc
ACCCAGCCGA	GAAACACCGGCTAGCAATAGCAAGTTAACGTAAGGCTCGACCGTTATCAA	1	bc
AATCCCCAGA	GAAACACCGGTTTAGTATGTGGGGTTAGAGCTTGAAATAGCAAGTTAACC	1	bc
TCAGGCCAGA	GAAACACCGGTGAGATGCGTACCCTGGTGTGGAGATAGAAAGAGAAAGTT	1	bc
ATGTCAGGCG	GAAACACCGGTTATAGCTAGAAAGATCGAGTTAGACTAAGGCAAGTCAGT	1	bc
AAGATAGCAG	GAAACACCGGTTGGCTTTACGGCTTTGTGGGGTTAGAGCTATAAATAGCA	1	bc
CAGCGGCGCG	GAAACACCGGTAGCAATTCTATATGAGTGGGGTTAGAGCTAGAAATAGCA	1	bc
AATCAAGCCT	GAAACACCGGTCCCCTTTATAGGTCCGTGGGGTTAGAGCAAGAAAAACAA	1	bc
AGATCAAACC	GAAACACCGGTGAGGACAGAACGTTTTGGGGGTAGAGCTAGAAATAGCAA	1	bc
TTTTTGGCCC	GAAACACCGGTCGTGAGGAACTGCGGGTGGGGGTAGAACTAGGAATACCA	1	bc
AATTACCCAC	GAAACACCGGTAGTCTGGAACTCGGCGTGGGAGTAATAGTAAGTTAACCT	1	bc
GTAACATTCA	GAAACACCGGTGATCATAGCAACGTGTTGGGGGCTGAGAGGTGTTAGAAC	1	bc
TGGAGGGTTG	GAAACAACGGTGACGCGAGGGTTAGAGCTAGAAATAGCAAGTTAACCTAA	1	bc
TAGGTAGAGC	GAAACACCGGTGGGGTGACTCAAAAAGTAGAGCAGGACATAGCAAGTTAA	1	bc
GAACCATCAG	GAAACACCGGTGTTAAAAGAATGTGGGGGTAGAGCTAGAAACAGCAAGTT	1	bc
AATTGAACAC	GATACACCGGTTGGGTTGAACTCGGTGTGGGGGAAATAGCATGATAAGAT	1	bc
ATCATACCAG	GAAACACCGGTTGGCTATATTCCTTCGTGGGGTTAGAGCTAGAAATAGCA	1	bc
TACCCTTCAC	GAAACACCGGTGACCGACGGATGTCAGTGGGGTTAGAGCTAGAAATAGCA	1	bc
ATGAACGAGG	GAAACACCGGTCCTAGAAGCTCAGTTTGGGGGGTTAGAGCTAGAAATAGC	1	bc
GTGGTCGCCA	GAAACACCGGTGAGATGCCTCACCGGTTAGAGCTAGAAATAGAAAGTTAA	1	bc
GAGAGCGAGT	GAAACACCGGTTAGATGAGTCACCGAGTAGAGCTAGAAATAGCAAGTTAA	1	bc
CCTACTGCCG	GAAACACCGGTGCCCTTTATGGGCCCGTGGGGTTAGAGCTAGAAATATCA	1	bc
AATCAAGACG	GAAACACCGGTGTTCTTAGTGGTAGAGATAGCATAGTAATATAAGTCTAA	1	bc
GCATCCCGCG	GAAACACCGGTTAGAACTGAGGTTTTGTGGGGTTTGAGATAGAAATGGTA	1	bc
TCATCCATCT	GAAACACCGGTTACGCGAAGACGTTAGAGGGGGTAATAGCATGAATACCT	1	bc
AAATCCACCG	GAAACACCGGTTTTGGTAAATGGTGGGGTTCGAGCTAGAAATAGCAAGTT	1	bc
GTCTTATCCA	GAAACACCGGTCCTAGAAGCTGAGTTTGTGGGGTTAGAGCTAGAAATAGC	1	bc
TATCCAATAC	GAAACACCGGTGACAAACGTATGTCAGTTGGGATAGAGCTAGAAATAGCA	1	bc
CGCTCACCCA	GAAACACAGGTTCAACCGGCGTGGGGTTAGAGCTAGAAATAGCAAGTTAA	1	bc
ATGACAGTGC	GAAACACCGGTCCTAGAAGATGAGGCGGGGGGGTTAGAGAGAGAAATAGG	1	bc
GGATTATCTA	GAAACACCGGTGAGCATGGTAACGTCTGTGGTTATAGATCGAGAAAGCAC	1	bc
GAATGAGCAC	GAAACACCGGTTGTAGTGAATGCTGTGGGGGGGGATAGACATAGTAAGCT	1	bc
CCGTCAAACC	GAAACACCGGTTCACCCGACGTCGGGGTAGTTATAGCTATAGAAAGCTAG	1	bc
GAAAACCCAA	GAAACACCTGTTTAGTATGTGGGGTTAGAGCTAGAAATAGCAAGATAATC	1	bc
GACCCAGTTT	GAAACACCGGTCTTAGTTGCATCTAGGGGGGGGTAGAGGAAGTAGTAGGA	1	bc
GAATGAAATT	GAAACACCGGTGCTAGCGGTTAGCTCGTGGGGTTAGAGCTAGAAATAGCA	1	bc
GTATCATCTA	GAAACACCGGTGAGAATGATACGGTTTGGGGTTGTTACTACAAGAAGTAA	1	bc
ATCTAAGTCA	GAAACACCGGTACTAGTAGCTTAGGTGTGGGGTTAGAGCTAGAAATAGCA	1	bc
AAAAATTCTA	GAAACACCTGTGCGCATGATAACACAGCAAGGTTAGCGATAGCTAGTGCG	1	bc
TCAACAAACT	GAAACACCGGTGGGGCGAGGGTTAGAGATCGAGATAACTAATTAACATAA	1	bc
GTATCACCCA	GAAACACCGGTGTGCGGAGATGGTGGGGGTGTAGCAGCAAGTAGCCTGAT	1	bc
ATCATCAAAA	GAAACACCGGTGGGGTTAGAGCTATGAATAGCAAGTTAACCTAAGGCTAG	1	bc
GAGTATAGAG	GAAACACCGGTTCTCGTTACGGATTTTGTGGGGTTGGAGCTAGAAATAGC	1	bc
CGATAGCACC	GAAACGCCGGTGCAATTGGCGCGGGGTTAGAGCTAGAAATAGAAAGATAA	1	bc
AACATGCTAG	GAAACACCGGTTTTCGATCATAGGCCGTGGGGTTAGAGCTAGAAATAGCA	1	bc
AACCACGGCC	GAAACACCGGTGGACTGGATCGGACCGTGGGGTTAGAGCTAGAAATAGCA	1	bc
AACAAGCTAC	GAAACACCGGTTATCTAAAGATCCCCGTGGGGGTAGAAGTAGAAATAGCA	1	bc
TCATCATCAA	GAAACACCGGTGAGGACAGAACATAACAACTAAACCTAACGCTAGTCCGT	1	bc
TAATTAGTAA	GAAACACCTGTTGAGATAATCAGAAAGTGGGGTAGAGCTAGAAATAGCAA	1	bc
CCCGGCCACA	GAAACACCGGTGCAATCCCTGACTTGTGTGTGGATATAGATAGATCAAGT	1	bc
CAGGGCGATT	GAAACACCGGTGATAGCCCTCGCGATAGCGGGGTTAGCTCTAGCTATACC	1	bc
AATCTAACAG	GAAACACCGGTGCTAGTAGTTAGATCGTGGGGTTAGAGCTAGAAATAGCA	1	bc
GGCATATCTT	GAAACACCGGTTCGCATGATCACGTAGCGTGGGGAGAGCGAGAGATATAA	1	bc
TGCAACCTCT	GAAACACCGGTAACGCAAGGATTATAGCGGGAAATGGCCAGGTAACATCA	1	bc
AATTGGACCC	GAAACCCCGGTTGTGGGGAACTCGGTGTGGGAGACATAGCCAGTTAACCT	1	bc
AAACTAAATA	GAAACACCGGTTTAGGAGGTGGGGTTAGGGATAGAAATAGCAAGCTAACC	1	bc
GTAACTTCCT	GAAACACCGGTTCCCGTTAGCTAGTAGTGGGGTTAGAGCTAGAAATAGCA	1	bc
GGCAATTCCG	GAAACACCGGTGGGAGCCAGGCTATAGAGAGCATATTAATCTAAATCTAA	1	bc
CCCCGCGGTT	GAAACACCGGTATTCCTGGTACCCGGCAAGTTTAGCTAGGTCTCCTCCGG	1	bc
CACTGTCTCC	GAAACACCGGTAGTATTTACTCACGGGTGGGGTTAGAGCTAGAAATAGCA	1	bc
AATACATCCT	GAAACACCGGTGACAAACGTATGTCAGTGTGGTTAGAGCTAGAAATAGCA	1	bc
AAACACCTAC	GAAACACCGGTTTTGTTTGCTCGGGGATGGCTTTAGAGATCGAAATAGCC	1	bc
GATAATTACG	GAAACACCGGTGGCCTTTATGGGACTGTGGGGTTAGAGCTAGAAATAGCA	1	bc
GATTACGCAC	GAAACACCGGTTGTCTAGAGCTCGGCGTGGGGGAAAAAGCAGGTTAAGCT	1	bc
AATTTAACAG	GAAACACCGGTGGGCTTTACGGCTTTGTGGGGTTAGAGCTATAAATAGCA	1	bc
ATGGGCCTGA	GAAACACCGGTGTGGTGCGTCACCGGGTAGGTATAGAAATAGAAAGCTAA	1	bc
TCAATCATAA	GAAACACCGGTGCTAATAGTTAGCTCGTGGGGTTAGAGCTAGAAATAGCA	1	bc
AATCCTGCCC	GAAACACCGGTGACATTTATGGGACAGTGGGGTTAGAGCTAGAAATAGCA	1	bc
GTAAAATAAC	GAAACACCGGTGAGCTTGATTCCGGAGCGAGGTAACCTCTGGCAAGACCG	1	bc
AGAAAGCATA	GAAACACCGGTGATCTTTGTACGAGGGTGGGGTTAGAGCTAGAAATAGCA	1	bc
TTGACCTTCT	GAAACACCGGTTCTCGTTAGTGAGTGTTGGTAGAGCTAGAAATAGCAAGT	1	bc
GAATCCGTCA	GAAACACCGGTTTTTGATAGTGGGGGGGTTGGTGCTAGCTATAGATAGTT	1	bc
CATTCGGCCG	GAAACACCGGTGCCATCAGTGGGATTTGGGGGTTGAGCTTAGAAAAACCA	1	bc
AACTGGTCAT	GAAACACCGGTTCTCGGTAACTCGGAGTGGGGGTAGAACTAGAAAAAGCA	1	bc
GAAACCCCCC	GAAACACCGGTTTTATTAAATGGCGGGGGTAGATCTAGAAAGAGCAAGTT	1	bc
TGTGACGATT	GAAACACCGGTCTTCTTGGCGTTTCGGGGGGTAGAGATAGAGATAGAAAG	1	bc
AATTCAGCTA	GAAACACCGGTTGTGGTGGTGTTTCGGGGGGAGGAACAACAAGCAGACCT	1	bc
AATTAGCCAC	GAAACACCGGTTGTGTTTACCCCGGGGTGTGAGTAGAATCAAGTTAACCT	1	bc
GAGTTCATGC	GAAACACCTGTGAGATGACTCACAGGGTAGAGCAAGAAATAGCAAATTAA	1	bc
