AATTCATAAT	GAAACACCGGTGACAAACGTATGTCAGTGGGGTTAGAGCTAGAAATAGCA	1	bc
GAGGGATAGC	GAAACACCGGTGAGATGAATCAAGTGGTGGGGTTAGAGCTAGAAATAGAA	1	bc
TGCCAAGTTT	GAAACACCGGTCTTCCTGGAATCTACGTGGGGTAGAGCTAGAAATAGAAA	1	bc
GCGACCACCC	GAAACACCGGTAATCTAAAGTCCTTTGTGGGGTTAGAGCTAGAAATAGCA	1	bc
GACAATGCCA	GAAACACCGGTACTCGTTACTTACGGGTGGGGTTAGAGCTAGAAATAGCA	1	bc
TCCACGCCGC	AGTGACGAAACACCGGTAGAATGGATCCACGGGTGGGGTTAGAGCTAGAA	1	bc
ATACCAAAAC	GAAACACCGGTTGGAATCGATCGTTTGTGGGGTTAGAGCTATAAATAGCA	1	bc
AATAACCTAC	GAAACACCGGTAATCTAAAGATCCCCGTGGGGATAGAGCTAGAAATAGCA	1	bc
CAAACGCACC	GAAACACCGGTTCAACCGGCGTCTTTTGTGGGGTTAGAGCTAGAAATAGC	1	bc
CACTTGCAAG	GAAACACCGGTTCTCGCTCCTAGGTTTGGGGGTTAGAGCTAAAAATATCA	1	bc
TTCATGTCCG	GAAACACCGGTCGCGAAAATGTGCCGGTGGGGTTAGAGCTAGAAATAGCA	1	bc
GGCTCAGATT	GAAACACCGGTCTTCCTGGAATCTACGTGGGGTAGAGCTAGAAATAGCAA	1	bc
CCGCTAATAC	GAAACACCGGTCGGCATCAATTTAATGGGCGTATAGTCAGAACTCCCATG	1	bc
AATGGAAAAA	GAAACACCGGTGGGGGTAGAGTCGGAGAGGGCAAGATAGCATATGAACAT	1	bc
CCCCCACCCC	GAAACACCGGTAGGATGAGTCCACGGGTGGGGAAAGAGATATAAATATCA	1	bc
AACTCGCAAC	GAAACACCGGTTCAACAGGCGTCTTTTGTGGGGTTAGAGCTAGAAATAGC	1	bc
AGACTGTCTC	GAAACACCGGTCTTCATTGCTCGAGGGTGTGGTTAGAGCTAGAAATAGCA	1	bc
ATCACTGCCT	GAAACACCGGGCGGAGAAGGTTAGATTTAGGAAGTAAAGCTAAAGATAGT	1	bc
GGATAGGAAC	GAAACACCGGTGAGATTCGTCAGGTGGTGGGGTTAGAGCTAGAAATAGCA	1	bc
AATAATGCCA	GAAACACCGGTACTCGTTACTTGAGGGTGGGGTTAGAGCTAGAAATAGCA	1	bc
CGGTGGGTCC	GAAACACCGGTCGTCGTTCGCAGGGCGTGGGGTTAGAGCTAGAAATAGCA	1	bc
CAATATATAA	GAAACACCGGTGAGAACTGTACGTTTTGGGGTTAGAGCTAGAAATAGCAA	1	bc
AGGCGGGAAG	GAAACACCGGTCGTCGTTGGTCGGGCGTGGGGTTAGAGCTAGAAATAGCA	1	bc
AACAACTAAT	GAAACACCGGTTGCCGATCGCCACTCGTGGGGTTAGAGCTAGAAATAGCA	1	bc
CCCCAACCCA	GAAACACCGGTAGGAGGGATTCACGGGTGAGAAAAAACCTATAACCTACA	1	bc
TGGCGGGCTT	GAAACACCGGTCGTCGTTCGTAGGGCGTGGGGTTAGAGCTAGAAATAGCA	1	bc
CACCGTGCTT	GAAACACCGGTGCCCGCTGTCTCGTAGTTGGGTTAGAGCTAGAAATAGCA	1	bc
CATTTTACCC	GAAACACCGGTTCGCTTTACTCCTTTGGGGGTAGAGAGATAGATAGCGAA	1	bc
TTAATCCAAA	GAAACACCGGTTTACTTAGTTAACTAGTGGGGTTAGAGCTAGAAATAGAA	1	bc
GGAACTTCCA	GAAACACCGGTGAGCATGATAACGTCCGTGGGGTTAGAGCTAGAAATAGC	1	bc
TAAATGCAAG	GAAACACCGGTTTACGTACTTAACTAGTGGGGTTAGAGCTAGAAATAGCA	1	bc
GACCAAACCC	GAAACACCGGTGGCCGACTTAGAGCTAGAAATAGCAAGATAACCTAAGGC	1	bc
AAGCGAGAGA	GAAGCACCGGTGGGCGTGGGTTCGGCGTGGGGGTTAGAGCAAAAAATAGG	1	bc
CCGTCATCAC	GAAACACCGGTGGGCATCACACGTTTGGGGTTATAGCTATAAAAATCAAG	1	bc
ATAACCCCAT	GAAACACCGGTTTACTTAGTTAACTAGTGGGGTTAGAGCTAGAAATAGCA	1	bc
GAGGAGGTTG	GAAACACCGGTCGTCGAAAGAAGGGCGTGGGGGTTAAGGTAAGAAAAGAA	1	bc
AATACGCAAG	GAAACACCGGTGAGCAAAGAGAGGTCGTGGGGTTAGAGCAAGAAATAGCA	1	bc
AGGACCTTCT	GAAACACGGGTTCCTGGTAGTAGGTATAGGGGTTTGAGCTAGAAATAGCA	1	bc
GTATCATACA	GAAACACCTGTGAGCCCGATAACGTCGTGGGGTTAGAGCTAGAAATAGCA	1	bc
TGCAGATCAT	GAAACACCGGTTCACGGTAGCTAGGAGTGTGGTTAGAGCTAGAAATAGAA	1	bc
TAAATTAGAA	GAAACACCGGTTGCGATAATAAAAAAGTGGGTTAGAGCTAGAAATAGCAA	1	bc
CCCATACTTC	GAAACACCGGTGAGCATGATAACGACCGTGGGGATAGTGCTCGAAATAGC	1	bc
ACATCACAAT	GAAACACCGGTTGTAAGTGCTCGTTTGTGGGGTTAGAGCTATAAATAGCA	1	bc
ATGCACTCCC	GAAACACCAGTTCCCGTTGGCTCGTAGTGGGGATAGAGCTAGAAATAGCG	1	bc
GAAAGAGATA	GAAACACCGGTGAGCATGATAACGGCGTGGGGGTAGAGCTAGAAATATCA	1	bc
CTATCATCCA	GAAACACCGGTGAGAACAGATGTTTGGTTAGAGTTAGGAATAGAATGGTA	1	bc
GAGTTAGTAA	GAAACACCGGTTCTCGTTACTTACGGGTGGGGTTAGAGCTATAAATAGCA	1	bc
AAATCCCAAA	GAAACACCGGTTGAGTGGGATTAGTAGTGGGGGTAATACCAAATTAACCA	1	bc
TCAGCAAAAA	GAAACAACGGTGTGGTTAGATCTAGAAATAGCAAGTTAACCTAAGGCTAG	1	bc
TTAACGCTCG	GAAACACCGGTCCTAGAAGCTGGGTTTGTGGGGTTAGAGCTAGAAATCGC	1	bc
GAATTAAAGA	GGAACACCGGTGTGCGGAGATTATGCGTGAGAAATAGCAAGTAAACTAAG	1	bc
AATACTGCCT	GAAACACCGGTTCCCTTTATGGGGTGGTGGGGGTAGAGGTAAAAATAGCA	1	bc
GTGCCATATA	GAAACACCGGTGAGCCTGATAACGTCGTGGGGTTAGAGCTAGTAATAGCA	1	bc
GTACGAGAAT	GAAACACCGGTGCTGTTTGTTCTAGAGTGGGGTTAGAGCTAGAAATAGCA	1	bc
AGACGGGATC	GAAACACCGGTGCAAGCGGGGTGGAAGGGGGGGTAGAGCTAAGAATAAGA	1	bc
AAACCCGTCG	GAAACACCGGTTTTCTTTATGGGGCCGGGGGGTGAGAGATAGAGATAGCC	1	bc
TTCCACGCTT	GAAACACCGGTCGCGATAATGTGCCGGTGGGGCTAGAGCTAGAAATAGAA	1	bc
AATCGAGCAG	GACGGAAAAACGGGGACAAACGTATAGGAGGGGGGGTAAAGCTAGAAAAA	1	bc
TGCAAGTCCC	GAAACACCGGTTCTCGTTACCCCGGTGTGGGGTTAGAGCTATAAATAGCA	1	bc
AATAACCCCG	GAAACACCGGTCTACTTAGTTAACTAGTGGGGTTAGAGCTAGAAATAGCA	1	bc
TAAATAAAAT	GAAGCACCGGTTTACTTAGTTAACTAGTGGGGTTAGAGCTAGAAATAGCA	1	bc
ATATAAAAGA	GAAACACCGGTGTGGGGAGAGTTAGCGAGAGAAAGAGAAAGTAAGCTAAG	1	bc
ATACTATCCC	GAAACACCGGTTGTAAGCGAGGTTAGGGGTGGATAGAGCTAGTTAACGTA	1	bc
AGCACGTTCT	GAAACACCGGTTCCCGTTAGCTCGTAGAGGGGTTAGAGCTAGAAATAGAA	1	bc
GAGGGGGCGA	GAAACACCGGTGAGATGCCTCACGGGGTGGGGGTAGAGCCAGAAATAGCA	1	bc
TCATCATCAA	GAAACACCGGTGAGGATAGAACTATTTATGGCTAGAGCTCGAAAGACTAG	1	bc
CCAATATCTA	GAAACAGCGGTGAGCATTATAACGTCCGCGGGGTTAGAGCTAGAAATAGC	1	bc
CAGCCAACAC	GAAACACCGGTGGCATACGTATGTCAGTGGGGTTAGAGCTAGAAATAGCA	1	bc
CAGCATGCTT	GAAACACCGGTGCTATTGGTGTCGACGTAGGGTTAGAGCTAGAAATAGCA	1	bc
TTACACCCAC	GAAACACCGGTTTACTTAGTTCACTAGTGGGGTTAGAGCTAGAAATAGCA	1	bc
GTATTAAAAA	GAAACACCGGTGGGGATAAAGTAAGAAAAAGCAAGTAAACTAAAGCTAAG	1	bc
AATAGTCCCT	GAAACACCGGTTGTGGGTAACTCGGTGTGGGAGAAATAGCAAGTTAACAT	1	bc
GATAAAAGAT	GAAACACCGGTGGTGGGGAAATCGGTGGGGAAAGAAAAGCAAGTTAACGC	1	bc
AAGCCAAGCT	GAAACACCGGTTATCAGTGCGGATTTGTGGGGTTAGAGCTAGAAATAGCA	1	bc
GTTCTGCTCC	GAAACACCGGTCACGAAAATGTGCCGGTGGGGTTAGAGCTAGGAATAGCA	1	bc
CGTCTTGCCG	GAAACACCGGTCGCCGTTCTGAGGGCGTGGGGTTAGAGCTAGAAATAGCA	1	bc
ATATCGCAAA	GAAACACCGGTGGCAATTGGTTCTGGGTGGGGTTAGAGCTAGAAATAGCA	1	bc
TATCTAACCC	GAAACACCGGTCCTAGAAGCTTATGTGGTGGAGTTAGCGCTAGACCTAGC	1	bc
AGCTCGTCAA	GAAACACCGGTTCCCGGTAACTCGGAGTGGGGGTAAAGATAGAAATAGCA	1	bc
TACACACCAT	GAAACACCGGTTTACTTAGTTAACTCGTGGGGTTAGAGCTAGAAATAGCA	1	bc
GCGCGCGGGA	GAAACACCGGTGAGATGCCTCAAGTGGTGGGGTTAGAGCTAGAAATAGCA	1	bc
AATAGGGCCC	GAAACACCGGTTGTGGGGAACTCGGTGTGGGAGAAATAGCAAGTTAACCT	1	bc
AAACTATATC	GAAACACCGGTGAGCATGATACCGTCGTGGGGTTAGAGCTAGAAATAGCA	1	bc
AAAGTAAAAA	GAAACACCGGTCCTAGAAGCTGAGTTTGGGGGGTTAGAGCTAGAAATAGC	1	bc
TGTCCTTAAC	GAAACACCGGTGACAGAGGGATTAGAGGTAGGATAAGCAAAGAAAACTAA	1	bc
GACTCTGTTT	GAAACACCGGTACTCGTTGCTTACGGGTGGGTTTAGAGCTAGAAGTAGCA	1	bc
GATAGAGGAA	GAAACACCGGTTATGGATACATCGGTGTGGGGGTAGAGCTAGAAATAGCA	1	bc
ATGCACTTTC	GAAACACCGGTTCCCGTTAGCTCGTCGTGGGGTTAGAGCTAGAAATAGCA	1	bc
GTAGTAGAGA	GAAACACCGGTGAGCGAGATAACGACGTGAGGTTAGAGTTAGGAATGGCA	1	bc
AAACCAACCG	GAAACACCGGTTGTAGGCGTTGGGTTGGAGATAGAAAGATAAAGTAAGCA	1	bc
AACCACCCCC	GAAACACCGGTAGAATGGATCCACGGGTGGGGTTAGAGCTAGAAATAGCA	1	bc
ATGACATATA	GAAACACCGGTCATCGTGGTTGAGCTTGGGGGGATAGAGATAGATAGCGC	1	bc
AACTTACTAA	GAAACACCGGTTTGCACTCATAGGTCGTGGGGTTAGAGCTAGAAATAGCA	1	bc
CTGACCTCCG	GAAACACCGGTCCTAGCAGCTGAGTTTGTGGGGTTAGAGCTAGAAATCGC	1	bc
CGCAAACACC	GAAACACCGGTGGCAGTTAGCCGTGTGTGGGGTTAGAGCTAGAAATAGCA	1	bc
GGTTACTCAA	GAAACACCGGTGGCAGCCAGCCACTTGCGGGGTTAGTGTTAGAATAACCA	1	bc
CTGTCCTCCC	GAAACACCGGTCCTAGAAGCTGATTTTGTGGGGTTAGATCTAGAAATAGC	1	bc
TGAAATGTAG	GAAACACCGGTTGTGGGGAAATCGGAGTGGGAGAAATAAAGAGTTAACCT	1	bc
GGCAGCTCCA	GAAACACCGGTGGCGGGGAACCACTTGTGGGGGTAGAGCTAAGAATATCA	1	bc
CGGCCTGTTT	GACACACCGGTCGTCGTTCGTAGGGCGTGGGTTTAGATCTCGAAATAGCC	1	bc
CGCCACCAAC	GAAACACCGGTGTTCTTTGCTCGAGGGTGGGGTTAGAGCTAGAAATAGCA	1	bc
AGCACGCACA	GAAACACCGGTGCCCGTTGGATTAGAGTGGGGAAAGAGATAGAAATAGCA	1	bc
ACAGAAACGA	GAAACACCGGTGGGGGTAGAGCAAGCGAGAGCAATAGAAAGTAAGCTAAG	1	bc
TCATTCACAC	GAAACACCGGTGGCAATTCGATCTGAGTGGGGTTAGAGCTAGAAATTGCA	1	bc
AAGCGGGTGG	GAAACACCGGTCGACTTTGGTAGGACGTGGGGTTGGAGCTAGAAATAGAA	1	bc
ATCCATGTCT	GAAACACCGGTTCTAGGTACTTGCTTGTGGGGTTAGAGCTAGAAATAGCA	1	bc
ATATAGCAGA	GAAACACCGGTGTGCTGTGCTCGAGGGTGAGGATATAGATGTAAATAGAG	1	bc
AATCAATCCG	GAAACACCGGTGACAATCGTATGTCAGTGGGGTTAGGGCTAGAAATAGCA	1	bc
TAAACAAACA	GAAACACCGGTTATCTTAGCGAATTAGTGGGGTTAGAGCTAGAAATAGCA	1	bc
TGATCAACAA	GAAACACCGGTTAGAATAGATCGTTTTGGGGGTAGAGCTAGAAATAGGAA	1	bc
ATCTTGTACC	GAAACACCGGTCTCGAATGTGTGCCGGTGGGGTTAGAGCTAGAAATAGCA	1	bc
ACCTCCCCCC	GAAACACCTGTTCCACCGGCGTCTTTTGTGGGTTGAAAGATCGAGATAGC	1	bc
CAACGCGCCT	GAAACACCGGTGCTGGCGGTTTCGAAGTGGGGTTAGAGATAGAAATAGAA	1	bc
CCGTTAACAC	GAAACACCGGTTGGCTTTACTCCTTTGTGGGGTTAGAGCTATAAATAGCA	1	bc
AACTACTACG	GAACACCGGGTTGAGCGAACCTCGGTGTGGGAGAGATCGCAAGTTAACCT	1	bc
AGGAATATAT	GAAACACCTGTGAGCATGATAACGTCGTTGGGTTAGAGCTAGAAATAGCA	1	bc
AATCCCCCCC	GAAACACCGGTGACAAACGGATGGCAGTGGGGTTAGAGCTAGAAATAGCA	1	bc
CACACTTCTT	GAAACACCGGTGCTGGTGGATTTGAAGAGGGGAAATAGCCCTAAGTCTAA	1	bc
TAAACTTACC	GAAACACCGGTTCAGGTTATCTCGAAGTGGGGTTAGGGCAAGAAATAGAA	1	bc
GAAATCTTCA	GAAACACCGGTGAGGCGGAAAACGTCGTGGGGGTAAGAGCAAGAAAAGCC	1	bc
CCACGCCTCT	GAGACACCGGTCGCGCTACGTCGGGGGTGGGGTTAGAGCTAGAAATAGCA	1	bc
AAACTCGCAC	CTCAACACCGGTTCAACCTGCGTCTTTTGTTGTGTTAGAGATAGCAATAG	1	bc
GGGCCACGCG	GAAACACCGGGTATAGATCTAGAAATACCGGGTTAACGTAAGACTTAGCG	1	bc
CCCCCTCCCC	GAAACACCGGTTCAAGTTAGGTCGTGGGGTTCGAGATAGACATAGACAGG	1	bc
TGAGCAAAAA	GAAACACCGGTGAGGATAGAGCTAGAAATAGCAAGTTCTACTAAGGCTAG	1	bc
CAATTACTCA	GAAACACCGGTTCAACCGGCTTCTTTTGGGGGTTTAGAGATAGAAATAGC	1	bc
ACAACACCGT	GAAACACCGGTGACGGGAGATCGTGGGTGAGAAATAACATGGAAACAGCG	1	bc
AAACGGGGAA	GAAACACCGGTCGTAGAGGCTGCGGGGGGGGTGGAAAGACAAAGTTAACA	1	bc
CCCTTCCCCC	GAAACACCGGTTGGCTTTACTCTTTGGGGGGTAGAGCTATAAAAAGCAAG	1	bc
AGAACGCACC	GAAACACCGGTGTTCTTTGCTCGAGGGTGGGGTTAGAGCTAGAAATAGCA	1	bc
ACCGAACAAA	GAAACACCGGTGGGGTTAGATCAAGCGTGAGAGAGAGAAACTAACGCAAG	1	bc
TACACACAAA	GAAACACCGGTAACATTACGATACTAGTGGGGTTAGAGCTAGAAATAGCA	1	bc
ATGCACGTAG	GAAACACCTGTCCTCGAAGTGGGGTTAGAGCTAGAAATAGAAAGTTAGCC	1	bc
ATTACCCACC	GAAACACCGGTCCTAGAAGCTGAGTTTGTGGGGTTAGAGCTAGAAATAGC	1	bc
CCCCCCTCCC	GAAACACCGGTAGAATGCATCTACGGGTGGGGTTAGAGCTAGAAATAGCA	1	bc
TCAGCAAAAA	GAAACAACGGTGGGGTTAGAGCTAGAAATAGCAAGTTAACCTAAGGCTAG	1	bc
GACTGCAGCG	GAAACACCGGTTGTATTTATTGACTGGTGGGGTTAGAGCTAGAAATAGCA	1	bc
AAACCGCCCG	GAAACACCGGTTTTAGTAGATAAGTCGTGGGGTTAGAGCTAGAAATAGCA	1	bc
GCAAGAGGCA	GAAACACCGGTGGTGGGGGAGCAGGTAGGGGAAGAATAACCAAAAGAGGT	1	bc
AAACGAGCAC	GAAACACCGGTGCCAAACGTTTCTCAGTGGGGTTAGAGCTAGAAATAGCA	1	bc
TCCAACGTCA	GAAACACCGGTGCTAGGTACTTGGGGGTGGGGTTAGAGCTAGAAATAGCA	1	bc
TCAGCAAAAA	GAAACACCGGTGAGCATGATAACGTCTCGTGGGGTTAGAGCTAGAAATAG	1	bc
GAATACGAAT	GAAACACCGGTTTACTTAATTAACTGGTGGGGTTAGAGATAGAAATAGCA	1	bc
TATTTCTCAC	GAAACACAGGTGACGAAAATGTGCCGGTGGGGTTAGAGCTAGAAATAGCA	1	bc
TATGCAAAAA	GAAACACCGGTGGGGATAGGATCAGAGATGGGATAGAGATATAAGGCGAG	1	bc
CCGTTAACAC	GATACACCGGTTGGCTTTACTCCTTTGTGGGGTTAGAGCTATAAATAGCA	1	bc
AATAATGCCG	GAAACACCGGTTTACTTAGTTAACTAGTGGGGTTAGAGCTAGAAATAGCA	1	bc
TACTATATCA	GAAACACCTGTACTGGTAACTTACGAGTGGGGTATAGCTAGGAATAGCAA	1	bc
ATACTCACGA	GAAACACCGGTTTAGTATGGAGGGAAGTGGGGCTAGAGCTAGAAAGAGCA	1	bc
AATAATGCCG	GAAACACCGGTGCCTTTTATGGGACCGTGGGGTTAGAGCTCGAAATAGCA	1	bc
TGAACTTAAT	GAAACACCGGTTCACGTTAGCTCGTAGTGGGGTTAGAGCTAGAAATAGAA	1	bc
GTATTAACTA	GAAAACCCGGGGAGCATGTTAACGTCGTGGGGTTAGAGCTAGAAATAGCA	1	bc
GGGCACCAGC	GAAACACCGGTGATCTGTGCTCGGGGGTGGGAATAGAGCTAGAAATAGCA	1	bc
GTAAACTAAG	GAAACACCGGTGAGCATGATAACGTCGTGGGGTTAGAGCTAGGACTAGCA	1	bc
TACTATTTCA	GAAACACCGGTCCTAATTACTTACGGGTGGGGTTAGAGCTAGAAATAGCA	1	bc
CGCACATCCA	GAAACACCGGTTCCAATTAGATCGTAGTGGGGTTAGAGCTAGAAATAGCA	1	bc
AGTACTTCAT	GAAACACCGGTTACAGTTAGATCGCAGTGGGGTTAGAGCTAGAAATAGCA	1	bc
ATCCGACCTC	GAAACACCGGTGGGAGGGGTTTATGAGTGGGGTTTAGGATGGAAATAGAA	1	bc
TCATTCACGA	GAAACACCGGTGGCAATTCGATCTGAGTGGGGTTAGAGCTAGAAATAGCA	1	bc
CGATCACCCA	GAAACACCGGTGAGGAGAGAACGTTTGGGGGATAGAGCTAGAAATAGCCA	1	bc
CGGTGAGCTA	GAAACACCGGTGGGCGGAGATTATGCTTGAGATATAACTAGTAACCTAAC	1	bc
AGTCCGTCAA	GAAACACCGGTGGGAAGAGACTCTTTGTGGGTTAAAAACCAAAATAACCT	1	bc
AACGAACTAC	GAAACACCGGTAATCTACGGATGCCCGTGGGGATAGAGCTAGAAATAACA	1	bc
GAGACCCGCG	GAAACACCGGTTATCTTTACTTACTTGTGGGGTTAGAGCTAGAAATAGCA	1	bc
TGCACCAACG	GAAACACCGGTTTAGGATGGCCACTTGTGGGGTTAGGACTTGGAATTGCC	1	bc
GTGAGCGTGC	GAAACACCGGTGATATAAGTCAAGTGGTGGGGATAGAGCTAGAAATAGCA	1	bc
GACAACGAGA	GAAACACCGGTGCTAGCGGTTTCGAAGTGGGGTTAGAGCTAGCAATAGCA	1	bc
