TATGGCCGTC	GAAACACCGGTCCTAGAAGCTGGACCTGTTAGAGCTAGAAATAGCAAGTT	3	bc
TAAACCCAAT	GAAACACCGGTTTACTTAGTTAACTAGTGGGGTTAGAGCTAGAAATAGCA	3	bc
CCCGCGGCCC	GAAACACCGGTAGAATGGATCCACGGGTGGGGTTAGAGCTAGAAGTAGCA	2	bc
ATGATCTTTG	GAAACACCGGTCCTAGAAGCTGGACCGTTTAGAGCTAGAAATAGCCAGTT	1	bc
TCAGAATACA	GAAACACCGGTGGGGTTAGAGCTAGAAATAGCAAGTTAACCTAAGGCTAG	1	bc
CCCCGGCATG	GAAACACCGGTTGTAGTGGGGGGGGTGAGGGAGAGAGAGCGAGAGTTAGC	1	bc
CCCAGCATCC	GAAACACCGGTAATCTAAAGACACCCGTGGGGTTAGAGCTAGAAATAGCA	1	bc
TAAACCCAAT	GAAACACCGGTTTTCTTTGCTAAGTTGTGAGTTTAGAGTTAACATATGCC	1	bc
ACACTTCCAC	GAAACACCGGTTTTTGTTGCTCGAGGGTGGGGTTAGAGCTAGAAATAGCA	1	bc
GAAGCAACCA	GAAACACCGGTTTTGGTAAATGGTGAGTGGGGTTATAGCTAGAAATATCA	1	bc
AAATCCAGGG	GAAACACCGGTTTAGGATAGGGCGATGTGGGGTTAGAGCTAGAAATAGCA	1	bc
ATATCCGTCC	GAAACACCGGTCCTAGTAGTTAGACCGGGTGGAACTGCTAGTAACAACTT	1	bc
GAACCAAATA	GAAACACCGGTGTGGAATGTAGGGAAGGGGGGTTAGAGCTAGAAATAGCA	1	bc
CACAACTACT	GAAACACCGGTGCCAGCCAGCCACTTGTGGGGTTAGAGCTAGAAATAGCA	1	bc
TCACAGCACC	GAAACACCGGTGTTGTTTGCTCGGGGGTGGGGTTAGAGCTAGAAATAGCA	1	bc
GCCAGCGGAA	GAAACACCGGTAGTATGTATTCACGGGTGGGGTTAGAGCTAGAAATAGCA	1	bc
CGCTTACTAA	GAAACACCGGTGAGAACAGAACGTTTTGGGGTTAGAGCTAGAAATAGCAA	1	bc
TATCCACAAC	GAAACACCGGTGACAAACGTATGTCAGTGGGGTTAGAGCTAGAAATAGCA	1	bc
GACTTAGTCA	GAAACACCGGTCTTGATAGCTTCTGGGAGCGGGAAATCTCAAGTTAACCA	1	bc
AAAACACATG	GAAACACCGGTTTGGTATGAAGGGAAGTGGGGATAGAGCTAGAAATAGAG	1	bc
ATGATAGACG	GAAACACCGGTGCTAATAGTTAGCTCGTGTGGTTAGAGCTAGAAATAGCA	1	bc
GAACCAGACT	GAAACACCGGTCTTCCTGGAATCTACGTGGGGTAAAACTAAAAATAGCCA	1	bc
AATTGATCTA	GAAACACCGGTTGGGGTGAACTCGGTGTGGGAGCAATAGCAAGTTGACCT	1	bc
CGGTTGGATC	GAAACACCGGTCCTCGTTGTTAGGTCTGGGGGTTGAGCGAGAAATATCAA	1	bc
AACACGTCAG	GAAACACCGGTTACCAATGAATGGTAGTGGGGTTAGAGCTAGAAATAGCA	1	bc
AAGAGAGCAA	GAAACAACGGTGTTGTTTGCGCGAGGGAGGGGAAGGGACTAGAAATAGAA	1	bc
AGACCCGATT	GAAACACCGGTTTTGCTGGGATGTAAGTGGGGTAAGGGTAAAAATAGCAA	1	bc
CCCACCCTCC	GAAACACCGGTGAAGCCGGGGCGTTTGGGGGGGTTAGGGCTGGAAATGGC	1	bc
AGCCAACAAA	GAAACACCGGTGTTCTTTGATCGTGGGTGGGGATAGAGATAGAGCTAGCA	1	bc
GATTTATCTA	GAAACACCGGTGAGCGTGATCACGTTGGTGGAGATATAGCTAGTTATCCC	1	bc
TTGACCTTCC	GAAACACCGGTTCCCGTTAGCTCGTAGTGGGGTTAGAGCTAGAAATAGCC	1	bc
CCTTGGGCAC	GAAACACAGGTTCAACCGGCTTCTTTTGTGGGGTTATAGCTAGAAATACT	1	bc
TGATAAGTCT	GAAACACCGGTACTAGTTACTTACGGGTGGGGTTAGAGCTGGAAATAGCA	1	bc
GAGTCAATAA	GAAACACCGGTTGTGGTAGAGGATGTGAGAGGTTAGAGATATAAGTCGCA	1	bc
GTGTTAGTGC	GAAACACCGGTGGGGATAGACAAAGAGTGGGCAAGAGCAAGTAATGCCAG	1	bc
TAAACGGAGG	GAAACACCGGTCGCCGTTCGTAGGGGTTGGGGTAGAGCTATAAATAGCCA	1	bc
TAAGCAATAC	GAAACACCGGTGGGGTTAGAGCTAGAAATAGCAAGATAAACTAAGGCTAG	1	bc
GCCAAAAACA	GAAACACCGGTGGGAGCCAGCCACTTGAGGGGTTAGAGCTAGAAAGAGCA	1	bc
TGAACTTACA	GAAACACCGGTGAGCATGATAACGTCCGTGGGGTTAGAGCTAGAAATAGC	1	bc
AGTTAGCCAC	GAAACACCTGTTTTGTTTGCTCCGGGGTGGGATTAGTGCTAATTTTAGCT	1	bc
CACTTGCACG	GAAACACCGGTTTACGCTCCTAGTTCTTGGGGTTAGGGCTTGAAATTGGC	1	bc
ATTCTATCCC	GAAACACCGGTGGCGAAAATGTGGGGGTAGGGCTAGAAATAGAAAGATAA	1	bc
GACTACGACG	GAAACACCGGTGGCAGCCAGCCACTTGTGGGGTTAGAGCTAGAAACAGCA	1	bc
TTGGCAAACG	GAAACACCGGTGGTGGTTGCGCTAGAAGAAGCAGGTTAACCAAGGGCTAG	1	bc
ATGTCAAAAA	GAAACACCGGTGCTAAAAGCTAGACGGGTTAGAGCTAGAAATAGCAAGTT	1	bc
AGACAAGAAT	GAAACACCGGTCTTCTTGGAATCTACGGGGGGTATAGATATAAATAGAAC	1	bc
GCCTCAGCAA	GAAACACCGGTTCTAGTAACTTACAGTGGGGGTTAGACCTAAAATAAGAA	1	bc
GCCAGAAGCC	GAAACACCGGTGGTCGTTATGGGAGGGTGGGGTTAGAGCTAGAAATAGCA	1	bc
CGACCCGTTG	GAAACACCGGTTTAGTATGGAGGGAAGTGGGGTTAGAGCTAGAAATAGCA	1	bc
AAATTAACAA	GAAACACCGGTTTAGTTTGCACGGTAGTGGGGTTAGAGCTATAAATAGCA	1	bc
GAATACGCCC	GAAACACCGGTTTTCTAAAGTGGCGCGTGGGGTTAGAGCTAGAAATAGCA	1	bc
AAATCACCGT	GAAACACCGGTTTTCTTAGATTATGAGTGGGGTTAGAGCTAGAAATAGCA	1	bc
GAATTAAACG	GAAACACCGGTGTTAGTAAATGGCGAGTGGGGTTAGAGCTAGAAATAGCA	1	bc
AAATCCCTCC	GAAACACCGGTTTAGTATGGAGGGTAGTGGGGTTAGAGATAGAAATAGCA	1	bc
AACGAAATAC	GACACACCGGTACTCTAAACATCTTCGTGGGGTTAGAGCTAGAAATAGCA	1	bc
AATTTATCAA	GAAACACCGGTCGTGGGGAACACGGGGGGGGATAGAGAGCGAGATAACCA	1	bc
GAGCCAACCC	GAAACACCGGTTATCGTTACGGATCTGTGGGGTTAGAGCTAGCAATAGCA	1	bc
GTATTAGACT	GAAACACCGGTTAGCATGAATAGGGCGTGGGGTTAGAGCTAGAAATAGCA	1	bc
AAACCAAGTA	GAAACACCGGTTTTGTTTGGAGGGTAGTGGGGTTAGAGCTAGAAATAGCA	1	bc
AACTTTCTAA	GAAACACCGGTATTAGATACTTGGGCGTGGGGTTAGAGCTAGAAATAGCA	1	bc
CACACCCGCC	GAAACACCGGTTGTGTGGAACTCGGTGTGGGAGAAATAGCAAGTTAACCT	1	bc
CAATGAGTTC	GAAACACCGGTGCTAGTGGTTTCGAAGTGGGGTTAGAGCTAGAAATAGAA	1	bc
GTCTGACGAA	GAAACACCGGTAGAATGAGTCCACGCTGGGGAAAGAGCTAGAAATAGCAA	1	bc
TCCACAACCA	GAAACACCGGTGTGGTTAGAGCTAGAAATAGCAAGTTAACCTAAGGCTAG	1	bc
TAAGTCAATC	GAAACACCGGTTTTCGATACGGAGTTGTGGGGTTAGAGCTAGAAATAGCA	1	bc
AAAACATTCC	GAAACACCGGTGACGCGAGGACGGCGGTGGGGTTAGAGCTAGAAATAGCA	1	bc
CCAGCATCAA	GAAACACCGGTGAGGACAGAACGCTTTTTGGTTAGAGCTAGAAATAGCAA	1	bc
GCATTATCTA	GAAACACCGGTGGGCTTTACTCCTTAATTAGCTTGTTAATCTAAATCTAG	1	bc
TCAATCTACA	GAAACACAGGTGGCGTTAGAGCTAGAGATAGAGAGTTAACCTGAGGATCG	1	bc
AACTCGCTAA	GAAACACCGGTTGCAATTCGTTCTGCGTTGGGTTAGAGCTAGAAATAGCA	1	bc
TATCCAGAGA	GAAACACCGGTCTTGCTGGAATCTACTTGGGGTTGAGCTAGGAAATAGCA	1	bc
TGCTCTGAAT	GAAACACCGGTCCTCCTTACTTACACGTGGGGTTAAGCCTGGAAATGCAA	1	bc
CCGTACACAA	GAAACACCGGGTGCATTTACTACTTTGTGGGATTAGAGCTATCACTAGCA	1	bc
CATTGCCGCC	GAAACACCGGTAGAATGGATCCACGGGTGGGGTTAGAGCTAGAAATAGCA	1	bc
ATGACAGAAG	GAAACACCGGTCCTAGAAGCTGGACCGGGGAGAGCTAGAAAGAGCAAGTT	1	bc
TCCGCATCCT	GAAACACCGGTGTCCGTTAGCTCAGAATGGGCATAGAAATCGAAATCGAG	1	bc
TCAGCTACCA	GAAACACCGGTGGGGTTAGAGCTAGAAATAGCAAGTTAACCTAAGGCTAG	1	bc
AAGTTGACAG	GAAACACCGGTTTTCGTTAATCGGTTGTGGGGTTAGAGCTAGAGATAGCA	1	bc
GAATGAGCTT	GAAACACCGGTTTTAGTAAATGGTGAGTGGGGTTGGAGCTAGAAATAGCA	1	bc
CCCCGTTATT	GAAACACCGGTGCTAGCGGTTTCGCAGTGGGGTTAGCGCTTGTAATCGTA	1	bc
GCATTAAGCC	GAAACACCGGTGGAAAGGATCCACGCGTGGGGTTAGAGCTAGAAATAGCA	1	bc
AGAGTGATAA	GAAACACCGGTTTTGGAACATAGGTAGAGGGGTTAGAGATAGAAGTCGAA	1	bc
GGTTACTCCA	GAAACACCGGTGGCTAGAAATAGCAAGTTAACCTAAGGCTGGTCCGTTAT	1	bc
GACCCCGTGA	GAAACACCGGTTTTAGTTACTTACGGGTGGGGTTCGAGCTAGAAATAGCA	1	bc
GACAAACTAA	GAAACACCGGTTTTCGGTGATTGTTCGTGGGGATTGAGCTAGAACCAACA	1	bc
CCCATACGAA	GAAACACCGGTAGAATGGGTCCACGGGTGGGGTTAGAGCTAGAAATAGCA	1	bc
TTGTTTTCTA	GAAACACCGGTTTAGTATGGAGGGCAGTGGGGTTAGAGCTAGAAATAGCA	1	bc
TCCCCCCCCC	GAAACACCGGTAGAATGGATCCACGGGTGGGGTTAGAGCTAGAAATAGCA	1	bc
TATTGGGTCC	GAAACACCGGTTGTGGGGAACTCGGAGTGGGAGAAATAGAGAGTTAACAT	1	bc
AGACCACATC	GAAACACCGGTGTTCTTGGATCGTGGGTGGGGTAAGAGCAAGAAAAGGAA	1	bc
AAACCATCCT	GAAACACCGGTTACAAACGGATGGCAGTGGGGTTAGAGCTAGAAATAGCA	1	bc
GCCTCCGACC	GAAACACCGGTGCAACCGGTACCGTTTGGGGGGATAGAGCTAGATAGCTC	1	bc
GACACAGGCT	GAAACACCGGTGTTATCAAATGGAGAGAGGGGCTAGAGCTCGAAGTAGTT	1	bc
GAATAAAACC	GAAACACCGGTTGAAGTAATTAATGAGTGGGGTTGAGGTAGAAAAAAGAA	1	bc
CATCAGCATA	GAAACACCGGTGGGGTTAGAGCTAGAATTAGCAAGTTAACCTAAGGCTAG	1	bc
TTTTTATCAC	GAAACACCGGTCGCGAAAGTGTGGGGGTAGGGTTAGAGATAGAAAGAGAA	1	bc
GGCTCTTCAA	GAAACACCGGTACTAATTACACACGGGGGGGTTTGGGGCAGGAATAAGCA	1	bc
TCAATACTCA	GAAACACCGGTGGCGCGAGAGCTAGAAATAGCGATATAACCTTAACCTAG	1	bc
GAAGCCCAGA	GAAACACCGGTGTAATGCCTCAAGTAGTGGGGTTAGAGCTAGAAATAGCA	1	bc
AAATAGCAGA	GAAACACCGGTGTTCTTTAATCGGGGGTGGGGTAAGTGCCAAAATAACCA	1	bc
CGGCTGCTTC	GAAACACCGGTCGTCGTTCGTAGTGGGGTTAGAGCTAGAAATAGCAAGTT	1	bc
GATCTATATA	GAAACACCGGTGGGGTTAGAGCTAGAAATAGCAAGTTAACCTAAGGCTAG	1	bc
AACCACCTCA	GAAACACCGGTAATCTAAAGACCCCCGTGGGGATAGAGCTAAAATTAGCA	1	bc
GAAGCAAGCA	GAAACACCGGTTAGCGTTGCGGATTTGTGGGGATAGAGCTAGAAATATCA	1	bc
CCGTAAACGA	GAAACACCGGTGTGCGGAGCTTATTTGTGGGAAATGGCATGTAACCTAAG	1	bc
AATTAGGCTC	GAAACACCGGTTGTGATGAACAAGGAGTGGGAGAAATAGCCAATTAACAT	1	bc
TCAACGCAAC	GAAACACCGGTGACGCGAGCACGGTGGTGGGGTTAGAGCTAGAAATAGCA	1	bc
CAATGGGCCA	GAAACACCGGTTGTGGGGAACTCGGTGTGGGAGAAATAGCAAGTTAACCT	1	bc
AACACGCCCT	GAAACACCGGTTCTCGATAATTCGTAGTGGGGTTAGAGCTAGAAATAGCA	1	bc
ATTTCCGCAC	GAAACACCGGTCCTAGAAGAGTGTGAAAGAGGTAAGAGATAGAAATAGAA	1	bc
AATACTTCCT	GAAACACCGGTGCCCTTTATTTTGCAGTGGGGTTAGAGCTAGAAATAGCA	1	bc
CGCTCCTCCA	GAAACACCGGTGAGTACAGAAAGTTATGGGGTTAGAGCTAGAAATAGCAA	1	bc
AAAAATGAAG	GAAACACCGGTGCCCTTTATGGGACAGTGGGGTTAGAGCTAGAAATAGCA	1	bc
GTGTGCGCAA	GAAACACCGGTGAGATGCCTCAAGTGGGGTTAGAGCTAGAAATAGCAAGT	1	bc
CGGTCCTAGA	GCAACACCGGTGAGATGCCTCCGGTTGTGGGTTTAGGCCTGGAATTGCCA	1	bc
CCAACCCCAC	GAAACACCGGTGACCCTTGGACCTTTGTGGGGTAAGAGCCATGAATAGCA	1	bc
GAAATCTATC	GAAACACCGGTGGGGTTAGAGCTAGAAATAGCAAGTTAACCTCCGGCTAG	1	bc
TGAACACTAT	GAAACACCGGTGAGGCGAGAACGGTGGGGGGGTTAGAGCTAGAAATAGAA	1	bc
ATCACATCCT	GAAACACCGGTTGCAGGCGATGGGTTGGGGGATAACAGCTAAAAGCAAGA	1	bc
AAATAGGAAA	GAAACACCGGTTGTGGTTGACCGTGGGTGGGAGTAATACCAAAAAAAGCA	1	bc
CGGTTATCCA	GAAACACCGGTGAGAACAGAACGTTTTGGGGTTAGAGCTAGAAATAGCAA	1	bc
TGCTCTGAAT	GAAACACCGGTATTCCTGGAATCTACGTGGGGTTGAGCTAGAAAAAGCAA	1	bc
CGCAGATACT	GAAACACCGGTTCTCGTTAGTTCGAAGTGGGGTTAGAGCTAGAAATAGCA	1	bc
CCATTACTAC	GAAACACCGGTTGTCATTACTGGTTTGTGGGGTTAGAGCTAGAAATAGCA	1	bc
TCAACACATT	GAAACACCGGTGACGTGAGTACGGTGGTGGGGTTAGAGCTAGAAATAGCA	1	bc
TATCCCCTAC	GAAACACCGGTATTCCTGGAATCTACGTGGGGTAAGGCTAGAAATAGCAA	1	bc
ATTACATAAC	GAAACACCGGTGAGAAAGGTAACGTACGTGGGGTTAGAGCTAGAAATAGC	1	bc
TTCTCAGCTT	GAAACACCGGTCTTCCTGGAATCTACGTGGGGTAGAGCTAGAAATAGCAA	1	bc
ACACCACCAT	GAAACACCGGTTGTAAGCGATGGTTTGTGGGGTTAGAGCTAGAAATAGCA	1	bc
TAACCACACA	GAAACACCGGTTGTAAGCGATCGATTGAGAGCATATCGCTCTAAATCGCA	1	bc
CTGATAGCCC	GAAACACCTGTTGTAGTTGCTGCTTTGTGGGGTTAGAGCTAGAAATAGCA	1	bc
AAATGGGTAC	GAAACACCGGTTGTGGGGAACTAGGTGTGGGAGAAATAGCAAGTTAACAT	1	bc
GCGTAACCCC	GAAACACCGGTTGTCTAAAGTCCTTTGTGGGGTTAGAGCTAGAAATAGCA	1	bc
CACCGCAGGC	GAAACACCGGTTGAGTGGATCCAGGGGTGGGGTTAGAGCTAGAAATAGCA	1	bc
TGATTATCAA	GAAACACCGGTGAGAACAGTACATTTTGGGGTTAGAGCTAGAAATAGCGA	1	bc
AGAATAAGCC	GAAACACCGGTTTTAGTAAATGGTGAGTGGGGTTAGAGCTAGAAATAGCA	1	bc
CAAATGCTCG	GAAACACCGGTTTTCGTTCATAGAAAGTGGGGTTGAGGCTGGAAATAGAA	1	bc
ATCAAACAGA	GAAACACCGGTGTGCGGAGATTATGCGTTAGAAATAGCAAGTAACCTAAG	1	bc
GGAACCTACT	GAAACACCGGTGTACTTAGTTAACTTGTGGGGTTAGAGCTAGAAATAGCA	1	bc
TAAATTATTA	GAAACACCTGTTGAGATAATCAAAAAGTGGGGTAGAGCTAGAAATAGCAA	1	bc
GACCCTGTCA	GAAACACCGGTACTAGTTACTTACGGGTGGGGTTAGAGCTAGAAATAGCA	1	bc
ATGTATGTAA	GAAACACCGGTCCTAGTTGCTTGACCGGGTAGATCTAGAAATAACAAGTT	1	bc
ACGATAGCCG	GAAACACCGGTTGTCTTAGCTGCATTGGGGGGTGAGAGCAATAAATAGCA	1	bc
ACCAGCAGCC	GAAACACCGGTAGAATGGGTCCAGGGGGTGGGTTAGAGGTATAAATAGCA	1	bc
GGATCAACAA	GAAACACCGGTGAGAATAGAACGTTTGGGGGGTAGAGCTAGGAATAACAA	1	bc
GAAGCAGAAG	GAAACACCGGTTTTGGTAGATGGAGAGAGAGCATGGTAATAGAAATAGAA	1	bc
CCAAGCCGCT	GAAACACCGGTAGAGCGGGTCTAAGGGCTGGAAATAGCAAGGAAACCGAA	1	bc
CCGCGTCACA	GAAACACCGGTTGGCTTTACTCCTTTGTGGGGTTAAAGCTATAAATAGCA	1	bc
CGAGCAACAA	GAAACACCGGTGAGGACAGAACGTTTTGTGGTTAGAGCTAGAAATAGCAA	1	bc
ACTTGGCCCA	GAAACACCGGTTGTTGGGAACTCAGAGTGGGAGATATAGCGAGTTAACCT	1	bc
TCATACGTCT	GAAACACCGGTGACGCGAGGACGGTGGTGGGGTTAGATCTAGAAATAGCA	1	bc
GCGTTAAAAA	GAAACACCGGTTGGCTTTGCTCCTTTGTGGGGTTAGAGCTATAAATAGCA	1	bc
GTACCATACA	GAACCCCCGGTTGGGTTAGAGCGAGAGTGGGGTAGTTAAAGTAAGTCTAA	1	bc
GGGATATATC	GAAACACCGGTGGGGTTAGTGCAAGAAATAGCTAGTTAACCTACGTCTAG	1	bc
AAGTTAGCAC	GAAACACCGGTTGGGGTTAACTCTGTGTGGGAGAAAAAGCAAATAAACCT	1	bc
CCGTCCATCC	GAAACACCGTTTCCACTAACTCAGTTGTGGGGTTAGAGCTAGAAATAGCA	1	bc
CAGTAAAGAC	GAAACACCGGTTGTCTTTACGGCTTAGTGGGGGTAGAGGCATAAATAGCT	1	bc
GACAATGTCG	GAAACACCGGTGACCTATAGAGGCCCGTGGGGATAGAGCTAGAAATAGCA	1	bc
TCCACATACG	GAAACACCGGTGGCGTTCAAGCTATAGATAGCATGTTAACCGAAGTCTAG	1	bc
CAGTGGGCTG	GAAACACCGGTCGTCGTTCGTACGGGGGGGGATAGAGCTCGAGATAGCAT	1	bc
CAACGACAAC	GAAACACCGGTAGTATGGATCACGGGGTGGGGTTAGAGATAGAAATAGCA	1	bc
AAATTAGCAG	GAAACACCGGTTTTAGTAAATGGTGAGTGGGGTTAGAGCTAGAAATAGCA	1	bc
GACCCTTCCT	GAAACACCGGTTCTAGTTAGTTCGTTGTGGGGTTAGAGCTAGAATTAGAA	1	bc
GAGACCATCG	GAAACACCGGTTATCGATACGGGTTTGTGGGGTTAGAGCTAGAAATAGCA	1	bc
AACGTTCATC	GAAACACCGGTGAGAACAGAACGTTTTGGGGTTAGAGCTAGAAATAGCAA	1	bc
TAATTAGTTT	GAAACACCGGTTGAGATAGTCACAAAGTGGGGTAGCGCTAGAACTAGTAA	1	bc
TCCCCCCAAC	GAAACACCGGTAGACTTAATCCACGGGTGGGGTTAGAGCTAGAAATAGTA	1	bc
ATAATCTAGA	GAAACACCGGTGAGCATGATAACGTCCGGAGGGATAGAGAGAAAAATAAC	1	bc
GAAAAAGATG	GAAACACCGGTGGGGTTAGAGCTAGAAATAGCAAGTTAACCTAAGGCTAG	1	bc
GGATAACCCC	GAAACACCGGTTTTAGTAAATGGTGAGTGGGGTTAGAGCTAGAAATAGCA	1	bc
AGACCAACGA	GAAACACCGGTGAAGACTGTACGGTTAGAGCTAGGAGTTGGAAGTAAAAA	1	bc
GGCAACTCTA	GAAACACCGGTGACAACCAGACCCTTGTGGGGTTAGAGCTAGAAATAGCA	1	bc
CGTACCTCCA	GAAACACCGGTGCGAAGAGAACGTTATGGGGTTAGAGATAGAAATAGCAA	1	bc
ATCATACATA	GAAACACCGGTGGGGGTAGAGTATGCGTTAGGAATAGAAAGTAAGGTTAG	1	bc
AAGTTAACCC	GAAACACCGGTTGGCTTTACTCCTTTGTGGGGTTAGAGCTATAAATAGCA	1	bc
AAAACCATAT	GAAACACCGGTTTAGTTTGGTGGGTAGTGGGGTTAGAGCTAGAAATAGCA	1	bc
AAGACGGCAA	GAAACACCGGTGGTCTTTGCTCGAGGGAGGGGATAGAACTAGAAATAGAA	1	bc
AAATCAATAC	GAAACACCGGTCTAGAATGGATGGCAGTGGGGTTAGAGCTAGAAATAGCA	1	bc
CGTTAGCAAC	GAAACACCGGTGGCAATTCGATGTGAGTGGGGTTAAAGGCAGGAAAAGGA	1	bc
TCCTCAGTAA	GAAACACCGGTGGTGTTTGCGTTAGGAATAGCATGTTAACCTAAGGCTCG	1	bc
CTGTAAACAT	GAAACACCGGTCGGGTTTATTCTTTTGTGGGGTTAGCGATATAAATAGCA	1	bc
GCGTCCGCCG	GAAACACCGGTGGGGTTAAATGGTGAGTGGGGATAGAACTCGAAATAGAG	1	bc
GAGTCACACT	GAAACACCGGTTATCGTTACGGATTTGTGGGGTTAGAGCTAGAAATAGCA	1	bc
ACTACTGCAG	GAAACACCGGTGCCCTTTGTGGGACCGTGGGATTAGAGCTAGAAATAGCA	1	bc
AATAAATCAG	GAAACACCGGTGCCCTTTGTGGGACCGTGGGGTTAGAGCTAGAAATAGCA	1	bc
CCTCCAACAC	GAAACACCGGTGGGGTTTAATCCTTTGAGGGGGTAGATCTATAAATAGCA	1	bc
ATGCCAGCAG	GAAACACCGGTCACAGACGTTTGACAGGGTGGTGCTAGCTATAAATAGTA	1	bc
GTCTTTTATA	GAAACACCGGTAGGATTAGCTCTCGAAATGGGATATTACTCTAAGGATAA	1	bc
GCAATCTGTA	GAAACACCGGTAGAATGCATCCACGGGTGGGGATAGAGCTAGAAATAGCA	1	bc
ATATTATACC	GAAACACCGGTTGTAAGCGTTGGCTTGTGGGGTTAGAGCTATAGATATCA	1	bc
GTATCATCTA	GAAACACCGGTGGGGTTAGAGCTAGAAATAGCAAGTTAACCTAAGGCTAG	1	bc
AATCCCTCGA	GAAACACCGGTTTCGAACGGATGTCAGTGGGGTTAGAGCTAGAAATAGCA	1	bc
GGCCCATACG	GAAACACAGGTTGCAGCCAACCACTTGTGGGGTTAGAGCTAGAAATAGCA	1	bc
CCCTGTCTCA	GAGACACCGGTAGAATTTATCCACGGGTGGGGTTAGAGCTAGAAATAGCA	1	bc
ACCTCCCCGC	GAAACACCGGTATAAGGGGTCTATGGGTGGGGCTTTAGCTGTAAACTGCA	1	bc
ACCACACTAA	GAAACACCGGTTGTCGAACAGCAGTTGTGGGGTTAGAGCTAGACATAGAA	1	bc
CGCTGGCCTG	GAAACACCGGTCGTCGTTAGTAGGGGTGGGGTTAGAGCTAGAAATAGCAA	1	bc
CTGCGCGTCG	GAAACACCGGTCGTCGTTCCTAGTGGTTGCGAGATAGCTAGAGATAGCTA	1	bc
ATCAACCACT	GAAACACCGGTTGTCAGCGATGGTCTGTGGGGTTAGAGCTAGAAATAGCA	1	bc
GGGTAACGCG	GAAACACCGGTGATCGTTACGGATTTGTGGGGTTAGAGCTAGAAATAGCA	1	bc
AATCCTTCCG	GAAACACCGGTTCCCTTTGTTGGACCGTGGGGTTAGAGCTAGAAATAGCA	1	bc
ATGCTCTTCC	GACACACCGGTTCCCGTTCGCTCGTAGTGGGTTTAGAGCTAGACATAGCA	1	bc
TCATTAAAAC	GAAACACCGGTTTACTTAGCTAATTGGTGGGGTTAGAGCTATAAATAGCA	1	bc
AACGATCATC	GAAACACCGGTGAGAACAGAAGGTTATGGGGTTAGAGCTAGAAATAGCCA	1	bc
AAATCGATGC	GAAACACCGGTTTAGCATGGAGGGAAGGGGGGTTAGAGGTAGAAATAGCA	1	bc
ATCAGCCCCC	GAAACACCGGTAGAATAAATCGACGGGAGGGGTTAGAGCTAGAAATAGCA	1	bc
GAATTATCCA	GAAACACCGGTGGGGTTAGAGCTAGAGTTGGCTAGGAACCATAAAGCTAA	1	bc
GAAGCAGCGA	GAAACACCGGTTTTAGTAAATGGTGAGTGGGGTTAGAGCTAGAAATAGCA	1	bc
AATATATCAG	GAAACACCGGTGACCAACGAATGTCAGTGGGGTTAGAGCTAGAAATAGCA	1	bc
TGTCCATAAA	GAAACACCGGTGAGAATAGAACGTTTTGGGGATAGAGCTAGAAATAGAAA	1	bc
AACACAGTTT	GAAACACCGGTTTTCGTGCATAGGACGTGGGGATAGCGCTTGAACTTACA	1	bc
CCGTTAGAAA	GAAACACCGGTACGCGTTACTCATTTGTGTGGTTAGAGCTAGAAATAGCA	1	bc
TTATCCGCCC	GAAACACCGGTTTTAGTAATTGGCGGGTGGGGTTAGAGCTAGAAATAGCA	1	bc
ACTCAACACG	GAAACACCGGTTCCCTTTATGGGTCTGTGGGGTTAGAGCTAGAAATAGCA	1	bc
CAATCAACAA	GAAACACCGGTATAGACTGGAGGGTTTAGAGTTAGAAATAGAAATATAAA	1	bc
AGGTCACGCG	GAAACACCGGTGATCGTTGCGCGTTGGTTGGGTTAGAGCTAGAAATAGCA	1	bc
AACCCCTCCG	GAAACACCGGTGGCAACCGGCCACTTGTGGGGTTAGAGCTAGAAATAGCA	1	bc
AAACCAGTGT	GAAACACCGGTTTAGTCTGGAGGGAAGTGGGGTTAGAGCTAGAAATAGCA	1	bc
CATTCAACAC	GAAACACAGGTGGCAATTCGATCTGAGTGGGGTTAGAGCTAGAAATAGCA	1	bc
TCAATACTCA	GAAACACCGGCGACGCGAGGACGGTGGTGGGGTTAGAGCTAGAAATAGCA	1	bc
GAACTAATGA	GAAACACCGGTTTTGTATGTAGGGCAGTGGGGTTAGGGCTAGAATTAGCA	1	bc
TAAACGCAAC	GAAACACCGGTGTACTTAGCTATATAGTGGGGTTAGAGCTAGAAATAGCA	1	bc
TTTATAGATT	GAAACACCGGTCTTCATGGAATCTACGTGGGGGAGAGCTAGAAATAGCAC	1	bc
CGGTGGGCTA	GAAACACCGGTCGGCGCGGGAATGGGGGGGGCGAGATCGCCAGATACCAA	1	bc
TACACCCACC	GAAACACCGGTAATCTAAGGATCCCCGTGGGGTTAGAGCTAGAAATAGCA	1	bc
TACAATCTCA	GAAACACCGGTACTAGTTACATACGGGAGGGGGTAGAGCTAGAAATAGCA	1	bc
CATCGGCTTG	GAAACACCGGTCGTCGTTCGTAGGGGGTGGGTTTAGGGTAAGAATAGCCA	1	bc
GAAATACAAA	GAAACACCGGTGACGTTAGAGCTAGGGAGAGCAAATAAATCTAAGTAGCA	1	bc
AGACACCACG	GAAACACCGGTGGCAGTCGGCCGCGTGTGGGGTTAGAGCTAGAAATAGCA	1	bc
AAACCAAGAC	GACACACCGGTGATTTTAGCTCGAGAGGGGGGGTTAAGCTAGGAAGAGCC	1	bc
CCCCGACAAC	GAAACACCGGTAGAAAGAATCAACGGGGGGGGGTTGAGCTAAAAAAAACC	1	bc
TACAATTCCC	GAAACACCGGTGCCCTTTATGGGGCCGTGGGGTTAGAGCTAGAAATATCA	1	bc
ACGTTACCAG	GAAACACCGGTTTTCGATCATACGTCGTGGGGTTAGAGCTATAAATAGCA	1	bc
CGACCGCAAA	GAAACACCGGTGAGCATTGAACGTGTGGGGGTTTAAGGCAAGAATAGCAA	1	bc
TAACCCGTGT	GAAACACCGGTTTAGTATGGAGGGAAGTGGGGTTAGAGCTAGAAATAGCA	1	bc
GAATTATTCA	GCAACCCCGGTTGGGTTAGTGCTAGAAATAGCAAGTTAACGTAAGGCCAG	1	bc
GGGCCGAGCG	GAAACACCGGTTTTCGTTGCGCATTTGCGGGGTTAGAGCTAGAAATAGCA	1	bc
GCCAAAAGCT	GAAACACCGGTGGCCGCCGTGGAGAGGTGGGGTTAGAGCTAGAAATAGCA	1	bc
CCTACCTCCA	GAAACACCGGTGAGGCGAGAACGTTTTGGGGTTAGATCTCGAAATAGCCT	1	bc
AACATACCCG	GAAACACCGGCTTTCGAACATAGGTCGTGGGGTTAGAGCTAGAAATAGCA	1	bc
GACTCTCTCC	GAAACACCTGTACTAGCTGCTTATGGTGTGGGGTAGAGCCAGGAATAGCA	1	bc
CATACTGACG	GAAACACCGGTGCCCTTAATTGGCCCGTGGGGTTAGAGCTAGAAATAGCA	1	bc
TCCACCCAAT	GAAACACCGGTTTACTTAGTTCACTGGTGGGGTTAGAGCTAGAAATAGCA	1	bc
CGCCATCCAC	GAAACACCGGTTGTCTTTACTCGTTGGTGGGGTTAGAGCTAGAAATAGCA	1	bc
TCTTCAGATC	GAAACACCGGTCTACCCGGAGTCTATGGGGGGTAGAGCTCGAGATAGCGA	1	bc
AATATGTCAG	GAAACACCGGTTTTCGATCATAGGCCGTGGGGTTAGAGCTAGAAATAGCA	1	bc
ATAACCCAAT	GAAACACCGGTTGTCTGAGATAGCTTGTGGGGTTAGAGCTAGAAATAGCA	1	bc
AAACGCCGCC	GAAACACCGGTAGAATGTATCAACGGGTGGGGTTAGAGCTAGAAATAGCA	1	bc
CAGAGAGCTT	GAAACACCGGTGCTAGCGGCTTCGATGTGGGGTTAGAGCTAGAAATAGCA	1	bc
ATACGGGATG	GAAACACCGGTTGTCGTCGGTGGGTTGTGGGGTTAGAGCTAGAAATAGCA	1	bc
TCCTTCAACC	ACTGACGAAACACCGGTCGCGAAAATGAGGGGGAAGGGCCAGAAACAGAA	1	bc
TTGTGCTAGA	GAAACACCGGCGGCGTACCTGAGGCGGGGGGAGTAGAAGAAGTAACAGGA	1	bc
GAAAATGCCA	GAAACACCGGTACCCGTTATGGACGCGTGGGGTTAGAGCTAGAAATAGCA	1	bc
AAATTCATCA	GAAACACCTGTTTAGTATGTAGGGAAGTGGGGTTAGAGCTAGAAATAGCA	1	bc
TATGCATAAA	GACACACCGGTGACGATCGAGTGTGAGCGTGGATGTCAATCGAACGAGAA	1	bc
AACATGTCAC	GAAACACCGGTGACAAACGTATGTCAGTGGGGTTAGAGCTAGAAATAGCA	1	bc
AACTTACAAC	GAAACACCGGTTTCCATTCATTGTTTGTGGGGTTAGAGCTAGAAATAGCA	1	bc
ATGTCAACGG	GAAACACCGGTGAGCGTTACTTATTTGTGGGGTTTAAGCTAGAAATAGCG	1	bc
AGCCACCGCC	GAAACACCGGTGGAATGGATCCGAGGGTGGGGTTAGAGCTAGAAATAGCA	1	bc
CATCGGGATG	GAAACACCGGTCGTCGTTCGTTGTGGGGGGGTTAGAGCTAAAAATAGCAA	1	bc
AGTAAATCCG	GCAACCCCGGTGAGATCAGCAGGTTTTGGGGTTAGAGTTCTAAAAAGCAG	1	bc
TGCGCCGAGT	GAAACACCGGTGAGCGGTATCAAGTGGTGGGGTTAGAGCTAGAAATAGCA	1	bc
ATACCAGCCG	GAAACACCGGTTGTAGGAAATGGTGTGTGGGGTTAGAGCTAGAAATAGCA	1	bc
GGACAGTACG	GAAACACCGGTGGCAGCCGGCCGCTTGGGGGGGTAGAGCTAGAAATAGCA	1	bc
TCCTAACCGA	GAAACACCGGTGGGGGGAGAGCAAGAGAGAGAAAGTTCACCTAACGCAAG	1	bc
AGCAGGGTAG	GAAACACCGGTGGTCGATCATAGGTCGTGGGTTGGGAGCTAGAAAGAGAA	1	bc
TCAGAAATCA	CTAAACACCGGTGTGGTTAGAGCTAGAGATAGCAAGTTAACCTAAGGCTA	1	bc
GAAACAAATA	GAAACACCGGTTAACTTTATAGCGTAGTGGGGGTTAGAGCAAGAAAAACC	1	bc
AAGACCGTAT	GAAACACCGGTCCTAGAAGCTGGACCGGTTAGAGCTAGAAATAGCAAGTT	1	bc
TCGGCCCACA	GAAACACCGGTCTAGCTAGCGCAAGTTATCGGATGGTAACCTCATTTTCA	1	bc
AGTTAAACAA	GAAACACCGGTGAGAACAGATCATTTTGGGGTTAGAGCTAGAAATAGAAA	1	bc
AGTCATCACC	GAAACACCGGTGTTCTTTGCTCGAGTGTGGGGTTAGAGCTAGAAATAGCA	1	bc
CCCTTGCTAG	CTAAACACCGGTTGTCGTTCATCGGGCGTGGGGTTAGAGCTAGAAATAGC	1	bc
ACCTGACACC	GAAACACCGGTAGAATCGATCCATTGGGGGGGTTAAAGTCAAAAAAAGAA	1	bc
AATACCTCTC	GAAACACCGGTGTAGAACGGATGGCAGTGGGGTTAGAGCTAGAAATAGCA	1	bc
TTGTCCACCC	GAGACACCGGTTACGGATATGGGTGTTTGGGGTTAGAACTAGCAAGAGCA	1	bc
TGGTCAAGAG	GAAACACCGGTTATCTTTACGGATTTGTGGGGTTAGAGCTAGAAATAGCA	1	bc
AAAAAGCACG	ACAGGCCGAAACACCGGTGGTATTAGCTCGAGGGTGGGGTTAGAGTTAGA	1	bc
ATACTATCAC	GAAACACCGGTGACCATCGTAACTCAGTGGGGTTAAAGCCTGAAAAAGCA	1	bc
GACCAACTAC	GAAACACCGGTAATATAAGTATGCCCGTGGGGATAGAGCTAGAAATAGCA	1	bc
ATCTAACCGA	GAAACACCGGTGTGCGGAGATTATGCGTGAGAAATAGCAAGTAACCTAAG	1	bc
CCCCCCCGTT	GAAACACCGGTAGACTGGATCCACGGGTGGGGTTAGAGCTAGAAATAGCA	1	bc
TTAACTTACT	GAAACACCGGTTGCAGGTGGCGTGTTGTGGGGTTAGAGCTAGAAATAGCA	1	bc
AAATGCTTGC	GAAACACCGGTTTTCGATCATAGGTCGTGTGGTTAGAGCTAGAAATAGCA	1	bc
GTGATAAGCG	GAAACACCGGTTCTAGTTACGGATTTGTGGCTTTAGATCTCAAGATAGCC	1	bc
AAAACCTAAC	GAAACACCTGTGTAAAACGTATGTTAGTGGGGTTAGAGCTAGAAATAGCA	1	bc
CAACCCATAC	GAAACACCGGTTTACTTTAGTGCGTAGTGGGGTTAGAGCTAGAAATAGCA	1	bc
CATTCTGCCA	GAAACACCGGTGCCCTTTGTGGGATCGTGGGGTTAGGGCTGGAATTAGCA	1	bc
GGAAAAAGAT	GAAACACCGGTGCTGTTAGAGTTAGAAATAGGTTGTAAATCTAAATATAG	1	bc
AAACCCCTAC	GAAACACCGGTTTAGTATGGATGGGGGTGGGGTTAGAGCTAGAAATAGCA	1	bc
TTCTCCCCCT	GAAACACCGGTCGCGAGAATGTGGTGTTAGTGCTAGAAATAGCTAGTTCA	1	bc
GCAGCCTACA	GAAACACCGGTGGCGTCAGAGCTAGAGATAGCAAGTTAACCTAAGGCTAG	1	bc
TAAATATCCC	GAAACACCGGTTCCCGTTAGCAAAAAGTGGGGTAAAGCCTAGAAAAACAA	1	bc
GAGTAAAAGA	GAAACACCGGTGAGCGGTGAGGATTTGTGAGAAAAAACAAATAAACAACA	1	bc
AAAAATCCCT	GAAACACCGGTTCCCTTTATTAGCTAGTGGGGTTAGAGCTAGAAATAGCA	1	bc
GAAAATGCAA	GTAACACCGGTGCCCTTTATGAGACCGTGGGGTTAGAGCTAGAAATAGCA	1	bc
GACAAAATAC	GAAACACAGGTAATCTAAAGATCCCCGAGGGGATAGAGCTAGAAATAGAA	1	bc
TAATCTATAA	GAAACACCGGTGGTGTTAGAGCTAGAAATAGCAAGGTAACCTAAATCTAG	1	bc
AAACAACTAC	GAAACACCGGTGTTATTTGGACGTAGGAGGGGTTCGAGCTAGAAATCGCA	1	bc
GAAATATCAA	GAAACACCGGTGGGGTTAGAGCTAGAAATAGCAAGTTAACCTAAGGCTAG	1	bc
TGGACCTTCT	GAAACACCGGTTCCGGTAATCGGAACGGGGGGAGGAAGAAAAATAAAGTT	1	bc
GAAACATACG	GAAACGCCGGTTTTAGTAAATGGTGAGTGGGGTTAGAGCTAGAAATAGCA	1	bc
GCACCAGATG	GAAACACCGGTCTTCCTGGAAGCTTCGTGGGGTAGAGCTAGAAAAATCAA	1	bc
ATGCACCTCC	GAAACACCGGTGCTCTTTGCTGGACCGTTTAGTGCTAGCAATAGCTAGTT	1	bc
CGCCGTGATG	GAAACACCGGTCGCCTTTCGTAGTGGTTGGGTTTGAGCTAGTAATAGCAA	1	bc
CAGTTAATTC	GAAACACCGGTCGGCGTTACTCCTGTTTGGGGTTGAAACAATGACTAGAA	1	bc
CATTTGGCCA	GAAACACCGGTTGTGGGGAACTCGGTGTGGGAGAAATAGCAAGTTAACCT	1	bc
GGAATTTATT	GAAACACCGGTGGGGGTAGAGCTAGAGATAGCAAGTTAACCTAAAGCTAG	1	bc
GACCCAAGCA	GAAACACCGGTTATCGGTGCGGATTTGTGGGGTTAGAGCTAGAAATAGCA	1	bc
GCGGGAAAGA	GAAACACCGGTGAGGTGAGTCAATGGGAGGGGATAGAGCTATAAATATCA	1	bc
ATATTACACC	GAAACACCGGTCGCGAGAGTTGGCTTTTGGGGTTAGAGCTAGAAATAGCA	1	bc
GGCACATCCG	GAAACACCGGTGGCAGCCAGCCACTTGTGGGGTTAGAGCTAGAAATAGCA	1	bc
CAATGGGAAA	GAAACACCTGTTCTAGGGGACTCGGAGTGGGGGTAGAGCTAGAAATAGCA	1	bc
AAACAGGCCG	GACACGCCGGTGTTCTTTGCTGGAGGGTGGGGTTAGAGCTAGAAATAGCA	1	bc
CGACGCGTTC	GAAACACCGGTTTTAGTAAATGGTGAGTGGGGTTAGAGACAGAAATAGCA	1	bc
ATACTATACC	GAAACACCAGTTGTCATCGTTACGTCGGGGGGGTTGAGCCAGGAACTGCA	1	bc
CCCATAACCC	GAAACACCGGTTGGCTTTACCCCTTGGTGGTGTCAGTGCTATAAATAGCA	1	bc
ACTCATGAAG	GAAACACCGGTGCCCTTTGTGGAACCGTGGGGTTAGAGCTAGAAATAGCA	1	bc
GAATCAAAAA	GGAACACCGGTTTTAGTAGATGGTGAGTGGGGTTAGAGCTAGAAATAGCA	1	bc
AAAAAAACCG	GAAACACCGGTGCCCGTTAATGGACCGTGGGGTTAGAGCTAGAAATATCA	1	bc
GCCCAAGGCT	GAAACACCGGTGTTCGTGGTGTCGAGGTGGGGTTGAGGCTGAAATAGCAA	1	bc
CCCCGCGGTT	GAAACACCGGTACTATCGGTTTCCGGGTGGGGTTAGAGCTAGAAGTAGCA	1	bc
ACTTGAACAA	GAAACACCGGTTGGGGGAGACCCAGTGTGGGAGAAATAGCCTGAGACCCT	1	bc
CATTCATCCC	GAAACACCGGTGCCCTTTATGGGACCGTGGGGTTAGAGCTAGAAATAGCA	1	bc
GACTCCGCCC	GAAACACCGGTTTTAGTAAATGGTGAGTGGGGTTAGAGCTAGAAATAGCA	1	bc
ACACACCAAA	GAAACACCGGTGTTGTTAGCTCGAGGGTGGGGTTAGAGCCAGAAATCGCA	1	bc
TAATCATCCT	GAAACACCGGTTTTCGTAAATTGGGAGTGGGGTTAGAGCTAGAAATAGCA	1	bc
TTCCCTTCAT	GACACACAGGTTCCCGTTAGCTGGTTGTGGGGTTAGAGCTAGAAATAGCA	1	bc
GAAACCCCCC	GAAACACCGGTTTTAGCAAATGGTGAGTGGGGTTAGAGCTATAAATAGCA	1	bc
AATACCGCCT	GAAACACCGGTGCCGTTAATGGGAGCGTGGTGTTAAAGATAGAAATAGCA	1	bc
ATGTCAGAAA	GAAACACCGGTCCTAAAAGCTTCTGGGTTGGGTAGAGCTAGGAATAGCAA	1	bc
AGTGGGCGAT	GAAACACCGGTGAGATGCCTCAAGTGGTGGGGTTAGAGCTAGAAATAGCA	1	bc
CAACGACGCC	GAAACACCGGTAGAATGGATCCACGGGTGTGGTTAGAGCTAGAAATAGCA	1	bc
ATGTAACCCG	GAAACACCGGTGGCCGGCGGTCATGTGTGGGAATAGAGATGGAACTTGAG	1	bc
GGAATACATC	GAAACACCGGTGGTGTTAGCGCTAGAGATGGCATGGTGCCCGAAAGCTCG	1	bc
TGATCCTCCA	GAAACACCGGTGACGACAGAGCGTTTGTGGGTTATAGCTAGAAATAGCAA	1	bc
TAAGTGAAAA	GAAACACCGGTGTGGTTAGAGATAGAAATAGCAAGTTAATCTAAGGCTAG	1	bc
CATTGGGATA	GAAACACCGGTGGTCGTTCGAGGGGATAGGGCTTGGAGCAGCAAGTAAAA	1	bc
TTACGGGCCC	GAAACACCGGTCCTAGAAGCTGGACCGGTTAGAGCTAGAAATAGCAGGTT	1	bc
TCGCCATATT	GAAACACCGGTTGGCTTTACATCTACGTGGGGTTAGGCTTGTAATAGCAA	1	bc
AATCCCTTTC	GAAACACCGGTTTAGTCTGGAGGGAAGGTGGGTTGGAGCTAGAAGTAGGA	1	bc
GCCTCTGAAA	GAAACGCAGGGACTAGATCCTTACGTGGCAGGTTAGAGCTAGACATAGCC	1	bc
AACCGATGCC	GAAACACCGGTAACATACGTACGCCGGTGGGGATAGAGCTAGAAATAGCA	1	bc
AAACGCCTCC	GAAACACCGGTTTAGTGTGTAGGGAGGTGGGGTTAGAGCCAGAAATAGCA	1	bc
GAAACACATA	GAAACACCGGTGGGGTTAGTGCTAGAGAGAGCATAGAAATCTAAGGCGCG	1	bc
GCAATAAAAA	GAAACACCGGTGAGCATGATAACGTCGGTGGGGTTAGAGCAAGAAATAGA	1	bc
CAAAGCGTTT	GAAACACCGGTGCTCGAAGTTTCGAAGTGGGGTTAGAGCTAGAAATAGCA	1	bc
CACCATGCTT	GAAACACCGGTACTAGCTACTTACGGGTGGGGTTAGAGCTAGAAATAGCA	1	bc
TTAACTTCTT	GAAACACCGGTTCCCGTAGAGTTAGAATTGGGTTGTTAACCGAAATCTAA	1	bc
GACCAGCACC	GAAACACCGGTAATCTTAGCACGCGGGTGGGGATAGAGCTAGAAATAGCA	1	bc
CACTAGGAGA	GAAACACCGGTAGTCGTTCGTAGGGGTGGGGTTAGAGCTAGAAATAGCAA	1	bc
GACTGTAACC	GAAACACCGGTACTAGTTACTTACGGGTGGGGTTAGAGCTAGAAATAGCA	1	bc
ATATCCGCCG	GAAACACCGGTCCTAGAAGCTGGACCGGGGAGAGCTAGCAATAAAAAGTT	1	bc
TGCTCATCAC	GAAACACCGGTGAGGACAGTACGGTTTGGGGGTAGAGCTAAACATATCAA	1	bc
GAAAAACTAC	GAAACACCGGTGCTCTAAGGTACCTCGTGGGGATAGAGCTAGAAATAGCA	1	bc
CCCCCAAGCC	GAAACACCGGTAGACGGGACGGATGGGTGGGGTTAGAGCTAGAAATAGCA	1	bc
TCATCACTAA	GAAACACCGGTGACGCTAGGACGGTGGTGGGGTTAGAGCTAGAAATAGCA	1	bc
GCCCCCTGCC	GAAACACCGGTTGAAGGTATGCACTTGTGGGGTTAGAGCTAGAAATAGCA	1	bc
GCGCGCGGGC	GAAACACCGGTGAGATGCCTCAACGGGTGGGGTTAGAGCTAGAAATAGCA	1	bc
TAAACACACT	GAAACACCGGTTTTCTTAATTAACTAGTGGGGTTAGAGCTAGAAATAGCA	1	bc
