ACATTCATAA	GAAACACCGGTGGCAATTCGATCTGAGTGGGGTTAGAGCTAGAAATAGCA	3	bc
CATAATTAAT	GAAACACCGGGTAGAGCTAGAAATAGCAAGTTAACCTAATGCTAGTCCGT	2	bc
GAGGGAGTCC	GAAACACCGGTGGGGTTTACTCTAGAGTGGGGTTGGTGATATAAGTCGAA	1	bc
ATCTCTTCGT	GAAACACCGGTGCCCGTGGGGTTAGAGCTAGAAATAGCAAGTTAACTTAA	1	bc
AGCACTTTGA	GAAACACCGGTTCCCGTTGGGTGAGAGCTGGAAGTACAAAGGAAACCGAA	1	bc
AGACCATTAA	GAAACACCGGTTTAGTATGTGGGGATAGAGCTAGAAATAGCATGTTAACC	1	bc
GTCTTTGCCA	GAAACACCGGTCCTAGAAGCTTGGGTTAGGGGTAGAAACAGGAAATTACC	1	bc
AAGCCCGTCC	GAAACACCGGTTCCCGTGGCGTTAGAGCTAGAATTAGCAAGTTAACCTAA	1	bc
TGAACTTAAA	GAAACACCGGTTCCCGTGGGGTTAGAGCTAGCAATAGAACGTTAACCTAA	1	bc
TGTACCATAT	GAAACACCGGTGACAAACTTATGTCAGTGGGGTTAGAGCTAGAAATAGCA	1	bc
TAAATAAAAT	GAAACACCGGTTGACTTAGTTAACTAGTGGGGTTAGAGCTAGAAATAGCA	1	bc
TTATTATCCG	GAAACACCGGTCCTAGAAAATGGGGATAGGGGTTGAAATAGCAAATTGCC	1	bc
CCATCCCACC	GAAACACCGGTTTAGTATGTGGGGTTAGAGCTAGAAATAGCAAGTTAACC	1	bc
TCCACCGCCT	GAAACACCGGTTCCCGTGGGGCTAGAGCTAGAAATAGCAAGTAAACCTAA	1	bc
CCTATTACAC	GAAACACCGGTTGCCTTTATTCGACCGTGGGGTTAGAGCTATAAATAGCA	1	bc
TATTCCCTAT	GAAACACCGGTGGCAAGTCGATGGGGGTGGGGTTAGAGCTAGAAATAGCA	1	bc
AATACACTAT	GAAACACCGGTGACGAAAGGGTTAGAGTGGGGTTAGACCTAGAAACATAA	1	bc
GAATTCCTCC	GCAACACCGGTAATATAAAGATCCTCGTGGGGATAGAGCTAGAAATAGCA	1	bc
ACCACGCCGC	GAAACACCGGCTAGAAATAGCAAGTTAGCCTAAGGCTAGACCGTTATCAA	1	bc
ATTCACATCC	GAAACACCGGTTCCCGTGGTGTTAGAGCTAGAAATAGCAAGATAACCTAA	1	bc
AAACAGCAGA	GAAACACCGGTTTTGTTTGTGGGGTTGGGGGGTTAGAGAGAGAAATAGCA	1	bc
TAGAGCGAAT	GAAACACCGGTTTACTTAGGTAAGTAGTGGGGTTGGAGCTAGTAATAGAA	1	bc
TCACCACTAC	GAAACACCGGTGACGCGTGCGCTAGAGCTGGGATTAGCATGTTAATATAA	1	bc
TACGTTTCCT	GTAACACCGGTTTACTTAGGTATCTAGCTAGAATTAACAAGTTAACCTCA	1	bc
TTCACCTACC	GAAACACCGGTCCTAGCAGCTTGGGTTAGAGCTAGAAGTAGCAAGTTAAC	1	bc
AACCGCCGCA	GAAACACCGGCTAGAAATAGAAAGATAAGCTATGGCTAGTCCGTTAACAA	1	bc
TAGCCAAGTG	GAAACACCGGTTATCGTTACGGATTTGTGGGGTTAGAGCTATAGCTAGCT	1	bc
AATCCATCAC	GAAACACCGGTGACAAACGTATGTCACCGGTTAGTATGTTGGGTTAGAGC	1	bc
AATCCTGTGG	GAAACACCGGTGCCCTTTGTGGGGACGTGGGGTTAGAGCTAGAAATAGCA	1	bc
TGAATATAGA	GAAACACCGGTCGTCGTTCGTAGGGGGGGGGTTAGAGCTAGAAATAGCAA	1	bc
CCCTGACGAC	GAAACACCGGCGATAATAGTTAGCTCGAGCGAATAGTGCTCGGATAACAA	1	bc
TTCTTGTAAC	GAAACACCGGTTTTAGATGATGGGGTGTGAGGTAAGAGTAAGAAATAACA	1	bc
TTAATTAAAA	GAAACACCGGTTCTAATAGTTAACTAGTGGGGTTAGAGCAAGAAATAGAA	1	bc
TAAGCACACA	GAAACACCGGTGGGGTTAGAGCTAGAAATAGCAAGTTAACCTAAGGCTAG	1	bc
TGCACCCTCC	GAAACACCGGTTCCCGTAAGCTCCCAGTGGGGTTAGAGCTAGAAATAGCA	1	bc
GTAACCCACC	GAAACACCGGTGACGCGAGGGTTAGAGCTAGAAATAGCAAGTTAACCTAA	1	bc
TGCACAACAT	GAAACACCGGTTCCCGTGGGGTTAGAGCTGGAAATAGCAAGTTAACCTAA	1	bc
GGCATATACA	GAAACACCGGTTGTCGTTAGTAGGGGTGGGGTTAGAGCTAGAGATAGCAA	1	bc
GAATGAGATG	GAAACACCTGTTTTAGTGGATGGGGAGTGGGGTTAGAGCTAGAAATAGCA	1	bc
GAGTACCGCG	GAAACACCGGTTATCGTTACGGGTTTGTGGGGATAGAGCTAGAAATAGCA	1	bc
AAACGGGATC	GAAACACCGGTGCTATTTGCTCGGGGGGTGGGGTTAGAGCTAGAAATGGA	1	bc
GTGGGCGGCG	GAAACACCGGTGGGGTTAGAGCTAGAAATAGCAAGTTAACCTAAGGCTAG	1	bc
ATTACATCTC	GAAACACCGGTCACCAATGTTTGGCAGTGGGGTTAGACCTAAAATTACCA	1	bc
AGCCCCCTGC	GAAACACCGGTTTAGCATGTGGGGTTAGAGCTATAAATAGCAAGTTAACC	1	bc
TTCGCTGACT	GAAACACCGGTTCCCGGGGGGTTAGATCTAGAAATAACAATATAACCTAA	1	bc
CCGTTCCCCC	GCCACCCCGGTTGGCTTTCCTCCTTTGTGGGGTTAGAGCTATAACTCTCA	1	bc
ACACCGCACA	GAAACACCGGTGGGAAGAGATGGATTGTGGGGTTAGAGCTAGAAATAGCA	1	bc
AGGCCCAGCG	GAAACACCGGTTATAGTTGCGGATTTGTGGGGTTAGAGCTAGAAATAGCA	1	bc
GAATATTTTA	GAAACACAGGTACTAGTTACTTACGGGTGGGGTTAGAGCTAGAAATAGCA	1	bc
AACATGCTAG	GAAACACCGGTTTTCGATCATAGGTCGTGGGGTTAGAGCTAGAAATAGCA	1	bc
TTCTGCTTCG	GAAACACCGGTCGTCGTAGCTGGGGTTAGAGCTAGAAATAGCAAGTTAAC	1	bc
ACGTAAACGC	GAAACACCGGTGTGCGGAGATTATGCGTGAGAAATAGCAAGTAACCTAAG	1	bc
TGACCGCATT	GAAACACCGGTGTTCCTTGCCTCGGGGGGGTGGTTAGGGCTTAGAAAAGC	1	bc
ATCCTGTCCC	GAAACACCGGTGTTCTTTGCTCGAGGGGTGGGGTTAGAGCCAGAAATAAC	1	bc
GCGGGCCGGA	GAAACACCGGTTGGGATAGAGATAGAAATAGCAGGTTAACCCGATACTAG	1	bc
CTGGGCCAGC	GAAACACCGGTGGGGTTAGAGCTAGAAATAGCATGTTAACCTAAGTATAG	1	bc
TGATCGCACC	GAAACACCGGTTTCCTTTGCCCGAGAGGTGGGGTTAGAGCTAGAAAGAGC	1	bc
TAATCAACAA	GAAACACCGGTGGGGTTAGAGCTAGATATAGCAAGTTAACCTAAGGCTAG	1	bc
TATCACCAAA	GTAACACCGGTGGCGATTGGATCTGAGTGGGGTTGGAGCTAGAAATAGAA	1	bc
CCCTATCTAC	GAAACACCGGTACTACCTACTTCTTTTTGGGGTTTGGGCCTGAAATAGGC	1	bc
TACCGATTCT	GAAACACCGGTTCCCGTGGGGTTAGAGCTAGAAATAGCAAGGTAACCTAA	1	bc
CACTGACCTT	GAAACACCGGTGCTCGCAGATTATACGTGGGGAAAGGCATGGAAACAGCA	1	bc
TAATTGCTAC	GAAACACCGCGGATAGCTAGAAATAGGAGGTTATACAGATACTAATACGT	1	bc
AGACCGGAAT	GAAACACCGGTGTTCTTGGCTCGAGGGGGGGGGTTAGAGCTAGAAATAGC	1	bc
AATCCTTCAC	GAAACACCGGTGACAAACGTATGTCAGTGGGGTTAGAGCTAGAAATAGCA	1	bc
TTCTTAACCA	ATGACAAAACACCGGTCCTAGAAGCTGGGGTTAGAGCTAGAAACAGTAAG	1	bc
GTGATAGACG	GAAACACCGGTCCTCGATCGTAGGGTAGGGGTTGAAGCTGCAAATTACCC	1	bc
GAATAAGCAC	GAAACCCCGGTTTTCTTTAATGGTGAGGGGGGGTATAGCCATAAATACTA	1	bc
AGACTGGTTC	GCAACACCGGTGTTCTTTGTTCGAGGGGTGGGGTTAGAGCTCGAAGAAGT	1	bc
GTACACTATA	GAAACACCGGTTTAGCATGTGGGGTTAGCGCTAGAAATAGCATCTCAACC	1	bc
GCATCACGCG	GAAACACCGGTTATCGTTACGGATTTGTGGGGTTAAAGCTAGAAATAGCA	1	bc
ATCCCCTCAC	GAAACACCGGTCACAGAAGCTGGGGTTAGGGCTAGAAATAGCAAGTTAAC	1	bc
GTATTATCCC	GAAACACCGGTCCTAGAAGCTGGGGTGAGAGCTAGAAATAGCAAGTTAAA	1	bc
GCCCTATGCC	GAAACACCGGCTAGAAATATCACGTAAAACTATGACCAGACCGTTATCCG	1	bc
CGTCCAACAC	GAAACACCGGTTTTCTTTGCTTCTTTGTGGGGTTAAATCTCAAATTAGCA	1	bc
CCAAGCCACC	GAAACACCGGCTAGCAATATCAAGTAAAACTAAGGCTAGTCCGTTGTCAG	1	bc
AACATGTCAC	GAAACACCGGTTCTAGATGATGGGGCTTGGGCTTGAAGTAGCAAGTTACA	1	bc
TGATTAATAA	GAAACACCGTGTAGAGCTAGAAACAGCAAGTTAACCTAAGGCTAGTCCGT	1	bc
TTCTTCCCAA	GAAACACCGGTCCTAGATGCTGGGGTTAGAGCTTGAAATAGGAAGTTAAA	1	bc
GCCAGCTATA	GAAACACCGGTAGAATGGAGTAAGGGGTGGGGTTGGGGTTGGAAAGAGCA	1	bc
CACTCTGAAA	GAAACACCGGTGCCAGTTAGTTCTGAGTGGGGTTAGAGCTAGAAATAGCA	1	bc
AGACCTATGT	GAAACACCGGTTTCGGTGGTGTTGGAGGAGGTAATAGTAGGAAATCAAAC	1	bc
TAATCTTCCC	GAAACACCGGGTACCGCTATAACGAACGAGGTAACATAACTCTAGACCGT	1	bc
AAAACCCCCT	GAAACACCGGTTTACTATGTGGGGTAGGGGGTATAGAGCGAGAAATAGCA	1	bc
ATGACTTCCG	GAAACACCGGTTCCCGTGGGGGTAGTAGTAGAAATAGCAACTTAACCTAC	1	bc
GAAACATAAA	GAAACACCGGTGCGCATTACGGACGAGAGCGCGAAATAGCAAATTTCGAA	1	bc
CAGTAATATA	GAAACACCGGTCGTCGTTCGTAGGGGTGGGGTTAGAGCTAGAAATAGCAA	1	bc
CCGCTAGCAA	GAAACACCGGTTGGCATTACTCTTTTGTGGGGTTAGATCTGTAAATAACC	1	bc
TTCCTCTAAC	GAAACACCGGTCCTATAAGCTTGGGTTAGAGCTAGAAATAGGAAGTTAAC	1	bc
TCTATCCTCA	GAAACACCGGTTACGAGAGGCTTAGAGCTAGAAATATCAAGATAACCTAT	1	bc
TTAAACCTCA	GAAACACCGGTGACGCGAGGGTTAGCGCGAGAAATAGCAAGTTAACCAAA	1	bc
GTAAAGTAAA	GAAACACCGGTCGTCGTTGGTAGGGGTGGGGGTTAAGCCAAGAAATAGAA	1	bc
CGGCTAAAAC	GAAACACCGGTTGTCTTTGCTCGATGGGTGGGGTAGAGGCAAGAAATAGA	1	bc
TCGACAGTCA	GAAACACCGGTGCTGGTAGCTGTAATAGTTGCTAGGTATTCTAGGTAGAG	1	bc
AAGTAAAGGA	GAAACACCGGTTATCGGAGAGGATGTGTGAGAAAAGAGAAGAAAATAACT	1	bc
CAACCCCAAA	GAAACACCGGTGGCAATTCGATCTGAGAGGGGTTAGGGGTAGAAAAAGCA	1	bc
TCTACACTCC	GAAACACCGGTGACGAGAGGGTTAGAGCTAGAAATAGGCTGTTAACCTCA	1	bc
GAATTCCGCC	GAAACACCGGTGCAAAGGGTTAACTGGTGGGGATAGAGCTAGAAATAGCA	1	bc
TAATACGAAA	GAAACACCGGTTTACTTAGTTAACTAGGGGGGTTAGAGCTAGAAATAGCA	1	bc
AGAGTCAAAC	GAAACACCGGTGATCGTTGCGTATTTGTGGGGTTAGAGCTAGAAATAGCA	1	bc
TGTCCAGCTT	GAAACACAGGTCTTCCTGGAATCTACGTGGGGAAGAGCTAGAAATATAAG	1	bc
CGATGACAAA	GAAACACCGGTGGCAATTCGATCTGAGTGGGGTTAGAGCTAGAAATAGCA	1	bc
ATCAACAAAA	GAAACACCGGTGGGGTTAGAGCTAGAAATAGCAAGTTAACCTAAGGCTAG	1	bc
GACATTATCC	GAAACACCGGTTCCTATGGGCATACAGCTAGATATAGCTAGATAACCCAA	1	bc
TACTTCGCCG	GAAACACCGGTCCTAGAAGCTGGGGTCAGAGCTAGAAATAACAAGTTAAC	1	bc
CGATAACACC	GAAACACCGGTTGGCTTTACTCCTTTGTGGGGTTAGAGCTATAAATAGCA	1	bc
TACGATGAAA	GAAACACCGGTGGGGTTAGAGCTCGAAGTAGCAAGTTCACCTAAGGCTAG	1	bc
AATCTTCTCC	GAAACACCGGTCGTAGAAGCTTGTGTTAGAGCTTGAAGCAACAAGTTAAA	1	bc
CCGTCGCAAC	GAGACACCGGTTCAACCGGCGCCTTTTGGGGGGTTAGAGCTAGAAATAGC	1	bc
TTCAGCAACA	GAAACACCGGTGGGGTTAGCGCTAGAAATAGCAAGTTAACATAAGGCTAG	1	bc
TTAACCTTTT	GAAACACCGGTGACGCGAGGGTTAGAGGTGGGAATAGCAATTTAACCTAC	1	bc
CCGTCAACCG	CTAAACACCGGTTGTCTTTCCTCCTTTGGTGGGTTAGAGCTATAAATGGC	1	bc
CAGTGCCAAA	GAAACACCGGTGGCAATTCGATCTGAGTGTGGGTAGGGCAAGAAATAGCA	1	bc
GACCGTGAGA	GAAACACCGGTACTAGTTACTTACGGGCGGGGTTAGAGCTAGAACTAGCA	1	bc
GTACTCTGTA	GAAACACCGGTCGTCGGTCGCAAGGGGGGGGGTTGGGCTAGAAATAGCAA	1	bc
CGCATATCCC	GAAACACCGGTTCCCGTGGCGCTATTGCTATAATTAGCATGTAAACCTAA	1	bc
ACATTAATAA	GAAACACCGGTGGGGATAGAGCTAGAAATAGCTGGTTAACCTAATACCAG	1	bc
CGGTCAACAG	GAAACACCGGTTAGAGTTACGCGTTTTGGGGGTGGTAGTTAGAAATAGCA	1	bc
CGTCCACAAC	GAAACACCGGTGGTAATTGGATCTTAGTGGGGTTAGAGCTAGAAATAGCA	1	bc
TTCTTCGAGC	GAAACACCGGTCCGAGAAGCTGTGGTTAGAGCTAGAAATAGCAAGAGAAC	1	bc
TAATCACACA	GAAACACCGGTGGCAATTCGATCTGAGTGGGGTTAGAGCTAGAAATAGCA	1	bc
ATGATTAATC	GAAACACCGGGTAGAGCTAGAACTAGCTAGTTAACCTGATGCTAGTCCGT	1	bc
ACAACGCACT	GAAACACCGGTGTTGTTAGGTCTAGGGATAGAAATGACAAAGAAACAGAA	1	bc
TAATAAACGC	GAAACACCGGGTAGAGCTAGAAATAGCAAGGTAACCTAAGGCAAGTCAGT	1	bc
TAATTACTAA	GAAACACCGGGTAGAGTTAGAAATAGCAAGTTAAACTAAGGCTAGTCCGT	1	bc
AAACTATATC	GAAACACCGGTCGTCGTTCGTAGTGGTGGAGTTAGAGCTAGAAATAGCAA	1	bc
TCCGCACGCA	GAAACACCGGTGGGACTAGAGCTAAACTTAAAATGTTAACCTAAGCCAAG	1	bc
AAAACACACC	GAAACACCGGTTATAAGAGATTGTTTGTGGGGTTAGAGCTAGAAATAGCA	1	bc
TTCTACGTAA	GAAACACCGGTACTGGATACTTACGGGTGGGGTTAGAGCTAGAAATAGCA	1	bc
TAAACCACCG	GAAACACCGGTTTACGTAGTTAACTAGTGGGGTTAGAGCTAGAAATAGCA	1	bc
ACGTTTATCA	GAAACACCGGTGAGCACAGCCTAGTAATAGCAAGAGAACCTAAAGCTACT	1	bc
ATGAATGTAA	GAAACACCGGTAGTAGATGCTGAGGTGTGGGGTTAGAGCTAGAAATAGCA	1	bc
GAAACATAAA	GAAACAACGGTGAGCATGATAACGTCGGGGGGGTAAGAGCAAGAGATAGC	1	bc
GAAGCAGCGA	GAAACACCGGTTTTGGTAAATGGAGAGTGGGGATGGAGCTCGAAATAGAG	1	bc
TGTAAAGCTT	GAAACATCGGTGGCACTAGTGAGTTAAGGTGAGTCTAGTCCTTTATAGAA	1	bc
TACGCAAAAC	GAAACACCGGTGGGGTTAGAGCTAGAAATGGCAAGTTAACCTAAGGCTAG	1	bc
GCGGGCGGCC	GAAACACCGGCTAGAAGTGGCAGGGTAACATATGGCTAGTCCGTTATAAG	1	bc
AACTCTCTAA	GAAACACCGGTACTAGATCCTTGCGCGTGGGGTTAGAGCTAGAAATAGCA	1	bc
TAATCTTCCT	GAAACACCGGTTTTCGTTAATTGTGAGTGGGGTTAGAGCTAGAAATAGCA	1	bc
GTCTTCTAAC	GAAACACCGGTCATAGAAGCTGGGGGTAAAGCTAGAAGTAGCAATTTAAC	1	bc
GACCCCAGCG	GAAACACCGGTAATAGTTACGGATTTGTGGGGTTAGAGCTAGAAATAGCA	1	bc
GGGTCATCCG	GAAACACCGGGTATGATTTCGAAATTGTGGGGTTAGAGATGGAAATAGCA	1	bc
TTCTTACCAA	GAAACACCGGTGCCAGTTGCTGCTGATTGGGCTTGGAGCTGCAAGTTAAC	1	bc
AATACCGAAT	GAAACACCGGTTGTCTGAGTTTCTGTGTGGGGTTAGAGGTAGGTTTAGCT	1	bc
CAGCCCGTTG	GAAACACCGGTCTTGTATCTGAGGGTAGAGCTATAGAAATAACGATATAA	1	bc
AAGTCACGAG	GAAACACCGGTTATCTTTGCTGATTTGTGGGGTTAGAGCTAGAAATAGCA	1	bc
AGGGGGCGAC	GAAACACCGGTGTGGTTAGAGCTAGAATTGGCAAGTTACCCTAAGGATCG	1	bc
TTAGCCTCAC	GAAACACCGGTCGCGAAAGAGCTCGAGAGGGGTAGTAAATCGAAAGAGAG	1	bc
CGCCCGCAAC	GAAACACCGGTTTTCTTTGCTCGAGGGGTGGGGTTAGAGCTAGAAATAGC	1	bc
GCAACAAATA	GAAACACAGGTGGGGGTAGATAGGGGAAGGGCAAGAGCTACTAAGACTAA	1	bc
AATAAGGCAC	GAAACACCGGTGCCCTTTGTTGGACCGTGGGGTTAGAGCTAGAAATAGCA	1	bc
ATCTTACCCC	GAAACACCGGTCCTAGAAGCTGGGGTTAGAGCTAGAAATAGCAAGCTAAC	1	bc
CATTCTTCTC	GAAACACCGGTCCTAGAAGCTGGGGTTAGAGCTGGAAATAGCAAGTTAAC	1	bc
GAATCACTCT	GAAACACCGGTTTTAGGAAATGGTGAGTGGGGGTAGAGGCAGGAATAGCA	1	bc
TGAAACTTCT	GAAACACCGGTGACGCGAGGGTTAGAGCTAGAAATAGCAAGTTAACCTAA	1	bc
CCGTTATAAA	GAAACACCGGTAGGCTTTCCTCCTTTGGGGGTTAGGACCTGTAAATGCCA	1	bc
CACACACACA	GAAACACCGGTGGCCATTCGATCTGAGTGGGGTTAGAGCTAGAAATAGCA	1	bc
GCGTTAACCG	GAAACACCGGTTATCTTTACTGCTTTGTGGGGTTAGAGCTAGAAATAGCA	1	bc
AGAATATGTA	GAAACACCTGTACTAGTTACTTACGTGTGGGGTTAGAGCTAGAAATAGCA	1	bc
GGCACTCCTA	GAAACACCGGTTCTCGTGGGGATAGAGTTAGAAATAGCAAGATAACCTAA	1	bc
ATATTAAACT	GAAACACCGGTGGTAAGAGATGGCTTGTAGGGTTAGAGCTAGAAATAGCA	1	bc
AATACCTACT	GAAACACCGGTTGACTTAGTTAACTAGTGGGGTTAGGGCTGGAATTAGCA	1	bc
CCGATATATA	GAAACACCGGTGGGCTTGATACCGTTGCGGGGGTATAGCTATAGATATAG	1	bc
GACTCGCACC	GAAACACCGGTTAACCTGGCGGCTTTGGGGGGGTAGAGCTAGAAATAGCA	1	bc
AAATATGTGA	GAAACACCGGTACTAGATACGGACGGGTGGGGTTAGAGCGAGAAATAGCA	1	bc
GACTAATACG	GAAACACCGGTTACCGTTAGGGATTTCGGGGGGTTAGAGTTAGAATTACC	1	bc
AAACCGAAAC	GAAACACCGGTTTTCTTTGCTCGATTGGTGGGGTTAAAGCTAGGACTAGC	1	bc
GGCTTAACAA	GAAACACCGGTGCTAATAGTTAGCTCGTGGGGTTAGAGCTAGAAATAGCA	1	bc
AGCAATCAAC	GAAACACCGGTGTTCGTTGCTCGAGAGGTGGAGTTAGCGCTAGAACTAGC	1	bc
TGAAATCAAT	GAAACACCGGTTATCGTGGTGTTAGAGATGGGTTAGGGATGGTAACATCA	1	bc
GGGTCCTCCG	GAAACACCGGTGTTAGTAAATGTAGAGAGGGGTTATAGCTAGAAATAGCA	1	bc
CACACAAGCT	GAAACACCGGTGGCAATAGAATTTGAGTTGGCATAGAACTATAAGTCTAA	1	bc
AAACAACTGA	GAAACACCGGTTTAGTATGTGGAGTTAGAACTAGAAATAGCAAGTTAAAG	1	bc
AATACTCCAT	GAAACACCGGTGCCCTTTGTGGGCCCGTGGGGTTAGATCTAGAAATAGCA	1	bc
TCCACCCCCC	GAAACACCGGTGACGCGAGGGTTAGAGCTGGAAATAGCAAGTTAACCTAA	1	bc
GACTATGGCC	GAAACACCGGTACAATGTATTCACGGGTGGGGTTAGAGCTAGAAATAGCA	1	bc
AATTCTCCAA	GAAACACCGGTGGCAATTCGATCTGAGCGGGGTTAGAGCTAGAAATAGCA	1	bc
AAAGCGCAAA	GAAACACCGGTGGTGTTTGCTCGAGGGCTGGGTTGAGAGCATAAATAGAG	1	bc
TAATCACCCT	GAAACACCGGTTATGGGAGGGTTAGAGCTAGAAATAGCAAGTGAACCTAT	1	bc
TGTCCAGCTT	GAAACACCGGTCTTCCTGGAATCTACGTGGGGTAGAGCTAGCAATAGCAA	1	bc
CATTAGGAAA	GAAACACCGGTACTAGTTACTTACGGGTGGGGTTAGAGCTAGAAATAGCA	1	bc
AGTTAACAAA	GAAACACCGGTGGCAATAGGATATGCGTGGGATAAGAGATAGAAATAGCA	1	bc
GTATTACAAT	GAAACACCGGTGCTAATAGTTGGCTTGTGGGGTTGGAGCTAGAAATAGCA	1	bc
CAAGCCGCCG	GAAACACCGGTGTCCTTTGTGGGACCGTGGGGATAGAGCCATAAAGAGCG	1	bc
AAAAACCTAG	GAAACACCGGTTTAGTATGAGGGGTTAGAGCTAGAAATAGCAAGTTAACC	1	bc
GACTGTAACC	GAAACACCGGTACTAGTTACTTACGTGTGGGGTTAGAGCTAGGAATAGCA	1	bc
GTAATATCCG	GAAACACCGGTTTTCGTGACTGGTTAGCGTGTTTAGAGATCGACATATAA	1	bc
GAGTCCTGCT	GAAACACCGGTTACCGTGGGGTTAGAGCTAGAAATAGCAAGTTAACCTAA	1	bc
CAATTAGTTC	GAAACACCGGGGATAGCTGGTTATAGGTGGGTATCGTAATAGTAATAGGT	1	bc
GAATCCCCCT	GAAACACCGGTTTTAGTAAATGTAGAGTGGGATTAGAGCTAGAAATCGCA	1	bc
GAACGAGCTT	GAAACACCGGTGCTAGCGGATTATGCGTGGGGATCTAGAAAGAAATAGTG	1	bc
TGCGTATCCT	GAAACACCGGTTCTCGTGGGGTTCGCGCTAGAAATAGCCAGTAAACCTAA	1	bc
ACAATCACAA	GAAACACCGGTGGCAAGTCGTTCTTAGTGGGGTTAGAGCTAGAAATAGCA	1	bc
ATCAAGTCCT	GAAACACCGGTGCCCTTTGGCCGGGGGGTGGGGTTAGAGCTAGAAATAGC	1	bc
TCAGTTAACA	GAAACACCGGTTGGCTTTACTCCTTTGTGGGGTTAGAGCTATAAATAGCA	1	bc
CGACGGCCAC	GAAACACCGGTGTTCTTTGCTCGCGGGTTGGGGTTAGAGCTAGAAATAGC	1	bc
TGAAAGCAAT	GAAACACCGGCGTCGCGAGGGTTAGGGGTGTAGATAGAAAGATAAACTGC	1	bc
GCCACATCCT	GAAACACCGGTTATAGTTACGGATTTGTGGGGTTAGAGCTGGAAATAGCC	1	bc
CCCTCTGACC	GAAACACCGGTACTAGTTACTTCCGGTGGGGGTTAGAACTAAAAATAGCA	1	bc
GTCATTTCTA	GAAACCCCGGTCGTCGTTCGTCGGGGAGGGGTTTGCGCTAGGAATCGCAA	1	bc
CCCCGCCAAT	CTAAACACCGGCTAGATATAGCAAGTTAACCTAATGCTAGTCCATTATCA	1	bc
CCCTTCACCA	GAAACACCGGTCCTCGATGCTCCGTTTAGAGCTAGAAGTAGTAAGTTACC	1	bc
GAATCATCAA	GAAACACCGGTGCTAATAGTTAGCTCGTGGGGTTAGAGCTAGAAATAGCA	1	bc
TTCTTCACAT	GAAACACCGGTCCTAGAAGCTGGGGTTAGGGGTTGAAATAACAAATTAAC	1	bc
GACAACCCCC	GAAACACCGGTATTCTAAAGTTCCCCGTGGGGATAGAGCTAGAAATAGCA	1	bc
GTATCACCCC	GAAACACCGGTGTTCTTTGATCGTGGGAGGGGGTTAGAGCTAGAATAACC	1	bc
GCGTCCCGCG	GAAACACCGGTTATCCTTGCGGGTTTGTGCGGTTAGTGCTAGAAATAGCA	1	bc
TCCGCACACA	GAAACACCGGTGGGGTAAAAGCTACCGAGGGCATGGTGACCTAAAGATAG	1	bc
AAAACCCCCA	GAAACACCGGTTTACTTAGTTAATTAGTGGGGTTAGAGATAGAAACAGCA	1	bc
CGGCTACAAC	GAAACACCGGTGGGCTTTGCTCGAGTGGGGGGTTTAAAGCTAGAAATACC	1	bc
GACTCCGTCG	GAAACACCGGTATTAGTAAATGGCGAGTGGGGTTAGAGCTAGAAATAGCA	1	bc
CGTCAGCAAA	GAAACACCGGTGTTATTTGCTCGAGGGTGGGGTTAGAGCTAGAAATAGCA	1	bc
TAAACCCCCA	GAAACACCGGTTACGCGAGAGTTATAGCTAGAAATAGCAAGTTAACCTAA	1	bc
GCATTGTACA	GAAACACCGGTCGGCGTTCGTAGGGTTGGGGGTAGAGCTATAAATAGCAA	1	bc
AAATCGCCCG	GAAACACCGGTTTTCGAACATGGGGAGTGGGGTTAGAGCCAGAAATAGCA	1	bc
GCATTCAACA	GAAACACCGGTGCTAATAGTTAGCTCGTGGGGTTAGAGCTAGAAATAGCA	1	bc
TCCCTCAGCC	GAAACACCGGGTAGAGCTAGAAATAGCAAGTTAACCTAAGGCTAGTCCGA	1	bc
GTCGTCTACA	GAAACACCGGTGATAGGCGCTGGGGTTAGAAGTAGAAATAGCAAGATAAC	1	bc
GTATTAGACA	GAAACACCGGTGCTAGTAGTTAGCTCGTGGGCTTAGACTTATAAGTTGCA	1	bc
GCCTCTGTCA	GAAACACCGGTACTATTTACTTACTGGTGGGGATAGAGCTCGCAATCGCA	1	bc
TGCCCACACT	GAAACACCGGTTCCCGTGGGGTTAGAGTTAGAAATAGCAAGTAACCTTAA	1	bc
ACAGCACCAA	GAAACACCGGTGGGGTTAGAGCTAGAAATAGCAAGTTAACCTAAGGCTAG	1	bc
GAATACTCCG	GTAACACCGGTTTTAGTAAATGGTGAGTGGGGTTAGAGCTAGAAATAGCA	1	bc
ACTTGAACAA	GAAACACCAGTTGTTAGCAACTTAGCGTGGGGGTAGTAGCATATTAACTT	1	bc
ATGCGGGATT	GAAACACCGGTGGGGTTAGAGCTAGAAATAGCAAGTTAACCTAAGTCTAG	1	bc
GCGTCAACCC	GAAACACCGGTTATCGTTACGGCTTTATGGGGTTAGAGCTAGAAATAGCA	1	bc
TTGCTCTCCA	GAAACACCGGTTCTAGTTGCTGATTTTAGGGGTTGAAATAGCAAATAAAA	1	bc
AATAGTTCCT	GAAACACCGGTTCTCGGGGGGTCAGAGCTTGAGATAGCAAATGATCCCAT	1	bc
AGACCGCACA	GAAACACCGGTGTTGTTTGTTCGGTGGGGGGGGTAAAAGCTAGAATAAGA	1	bc
TTCTTCGAAC	GAAACACCGGTCCTAGAAGCTGGGGTTAGAGCGAGAAATAGCAAGTTAAC	1	bc
TACACTTTAT	GAAACACCGGCTTCCGTGGGGTTAGAGCTAGAAATAGCAAGTAAACCTAA	1	bc
GCCCTCCGTC	ACGGGACGAAACACCGGCTAGACATAACACGTTCACCTCCGGCTAGTCCG	1	bc
CATTATGGAA	GAAACACCGGTACCAGTTACTTACGGGTGGGGTTAGAGCTAGAAATAGCA	1	bc
GAATTATATC	GAAACACCGGGTAGAGCTAGAAATAGGAAGTTAACCTAAGGCTAGTCTGT	1	bc
GAGACCCAAG	GAAACACCGGTTTTCGTTGCGGTTTTGTGTGGTTATAGCTAGAAATAGCA	1	bc
AATTACGCCC	GAAACACCGGTGCCGTTAATCGGACCGTGGGGTTAGACCTAGAATTACCA	1	bc
GTAATCCCCA	GAAACACCTGTTTACTTAGTTAACTAGTGGGGTTAGAGCTATAAATAGCA	1	bc
GAGTCTGTAC	GAAACACCGGTTTTAGTAAATGGTGAGTGGGGTTAGAGCTAGAAATAGCA	1	bc
TGGTTCGGAC	GAAACACCGGTGGGGTTAGAGCTAGAAATAGCAAGTTAACCTAAGGCTAG	1	bc
AAATTCTCCC	GAAACACCGGTTCTAGAAGATGGGGTTAGAGCTAGAAATACAAAGTTACC	1	bc
GCATTCAAAC	GAAACGCCGGTGCTAATAGCTAGCTCGGGGGGTTTAAGCTAGAAATAGCC	1	bc
TGCTCTTTCC	GGAACACCGGGCACCGCTAGCTCTAAGAGGGTATAGTGCTACTAACCGCA	1	bc
GTATTCTCTA	GAAACACCGGTCGTCGTTCGTAGGGGGTGGGTTTGAGCTAGAAATAGCAA	1	bc
GAGTAACAAG	GAAACACCGGTTATCGTTACGGGTTTGTTGGGTTAGAGCTAGAAATAGCA	1	bc
GCACTGTATA	GAAACACCGGTGAGCATGAGCTCGGAGGAGCAAGTAACAGCAAGACCACA	1	bc
CCCAACCTCC	GAAACACCGGTAATCTAAAGCTACCCGTGGGATAGTAACTTAAAATAGCA	1	bc
AAACCAGTCA	GAAACACCGGTTTTAGAAAAGGGGTAGTGGGTTTAGATAGAGAATTAACA	1	bc
GCTCCGCGGC	GAAACACCGGTTAGAGCTAGAAATAGCAAGTTAACCTAAGGCTAGTCCGT	1	bc
AGCCAGGAAA	GAAACACCGGTGTTCTTTGCTCGAGGGGTGGGGTTAGAGCTAGAAATAGC	1	bc
GTGGCCGTCA	GAAACACCGGTGGTATTAGCGCTAGAAAAAGTAAGATTAGCAAAGTCTAG	1	bc
AAACGATATT	GAAACACCGGTGCCCGTGATGATACCGCTGGAATTAGCAAGAAAACTGGA	1	bc
GGTGGCGCAA	GAAACACCGGTGGGGTTAGAGCTATAAATGGCAAGTTAACCTAATACTAG	1	bc
TGTCCAGATA	GAAACACCGGTGTTCTTTGCACGTAGGGCGGGGTGAGAGATAGCTATAGC	1	bc
GAATTATTTC	GAAACACCGGTCGACATTGTGAGGGAGGGCTTTAGAGCGCGAATTAGCAT	1	bc
GCCTCTGCAA	GAAACACCTGTACTAGTTACTTACGTGTGGGGGTAAAGCTAAGAATAGCA	1	bc
CACCATGTTT	GAAACACCGGCACTAGTTACTTACGGGTGGGGTTAGAGCTAGAAATAGCA	1	bc
CAATCACTCC	GAAACACCGGTTTAGTTTGTGGGGGTAGAGTTAGCAATAGCAAGTTAACC	1	bc
TCTACCGATT	GAAACACCGGTCATGCTGGAGTTAGAGCTAGATATAGCTAGTAATACCAA	1	bc
TTCTTAGACT	GAAACACCGGTCCTAGAAGTAGCGAGTTGAGCTAGAGCTAGCAAGTTATC	1	bc
ACTGCAACCG	GCAACCCCGGTGCGGTTAGAGCTAGAAATAGCCAGTTAACCTAAGGCTAG	1	bc
ATAACAGATG	GAAACACCGGTCTTGATCCATAAGTGTTGAGTTAGAGCTAGACTTAGCAA	1	bc
ACATCAACAT	GAAACACCGGTTGGCTTCAATGCTTTGTGGGGTTAGAGCTATAAATAGCA	1	bc
TCAAGCCGCA	GAAACACCGGCTAGGAGTGGCAAGTTGATATAAGGATAGTCCGTTATCAA	1	bc
TAATCAAAAG	GAAACACCGGTGATGGTAGCGGAATAAATCTCAAGATAACCTGATACCAT	1	bc
GCCAATAGAA	GAAACACCGGTAGTAGTTACTAAAGAGAGGGGTTAAAGCTAGAAATAGCC	1	bc
TAAACAATCT	GAAACAACGGTGACGGGGGGGTTAGAGCTAGAAATAGCAAGTTAACCTAA	1	bc
CAAACCAATG	GAAACACCGGTGTAGGATGTTGGGTTAGAGGTAGAAATAGCAAGTTAACC	1	bc
TGGAGTTACG	GAAACACCGGTTCCCGTGGGGGAAGAGCTAGAATTAGCAAGGTAACCTCC	1	bc
GTGTAACCCG	GAAACACCGGTGTTCGTTGCTTATTTGTTGGGATAGAGCTATAACTAGCA	1	bc
CCCCCGCACC	GAAACACCGGCTAGAAATAGCAAGTTAACCTAAGGCTAGTCCGTTATCAA	1	bc
TAAATCAATC	GAGACACCGGTTTACTTAGTTAACTAGTGGGGTTAGAGCTAGAAATAGCA	1	bc
GAGAGTGCCG	GAAACACCGGTGCACTTTATGGGGCCGGGGTGGTGCAACTAATAGTAGCA	1	bc
CACTACGTAC	GAAACACCGGTACTAGTTACTTACGTGTGGGGTTAGAGCTAGAAATAGCA	1	bc
CAGTTAGCAA	GACACACCGGTTGCCTTTACTCATTTGTGGGGTTAGAGCTATAAATAGCA	1	bc
GAAATAATTA	GAAACACCGGTTTAGTATGTGGGGTTATAGCTAGAAGTAGCAAGTTAACC	1	bc
TCCATCTTCT	GAAACACCGGCTACGGGGGGGTTAGAGCTAGAAATAGCAAGTTAACCTAA	1	bc
CTCTGCTCTC	GAAACACCGGTCCTAGAAGCTGGGGTTAGAGCTAGAAATAGCAAGTTAAC	1	bc
CGATTAACCA	GAAACACCGGTGGGGACAGTAACCAGGTAGAGCTGGACATAGCAAGTTAA	1	bc
GCCAGCGTCC	GAAACACCGGTACTAGTTACTTACGGGTGGGGTTAGAGCTAGAAATAGCA	1	bc
TATTTATCAA	GAAACACCGGGTAGGGCGAGGACTAGCAAGGTAACCTAACGATTGACCGT	1	bc
AATACCGCAA	GAAACACCGGTTGTCGTAGCTTAGGTGTGGGGTAAAAATAACAATTAACT	1	bc
TGGTCAACCT	GAAACACCGGTTATCGTTACGTCTTTGTGGGGTTAGAGCTAGAAATAGCA	1	bc
CTCCCACCCT	GAAACACCGGTTGTCTGCGCTGGTTTGTGGGGCTAGAGCTAGAAATAGCA	1	bc
TTATTCTCAA	GAACCACCGGTCAGAAACACAGGGTTTAGAGCTAGCCAAAGCAAGTTAAC	1	bc
AAATTCCCTA	GAAACACCGGTTTAGTATGTGTGTTTAGGGGTATAAATATCAAGTTAACA	1	bc
GATTGAGAAA	GAAACACCGGTGGTAATAGTTAGCTCGTGGGGGTAGTGCTAGAAATAGCA	1	bc
GAAATATACC	GAAACACCGGTCGTCGTTCGAAGGGGGGGGGTTAGAGCTAGAAATAGCAA	1	bc
TAGATCGTCC	GAAACACCGGGCAGAGATAGAGATATCAAGTTAACCTAAGGCTAGGCAGT	1	bc
GTCTTTGTTA	GAAACACCGGTGCTCATTACTTCCTGGTGGGGTTAGAGCTAGAAATAGCA	1	bc
TTCTCCCCCT	GAAACACCGGTCCTAGAAGCTGGGGTTAGAGCTAGAAATAGCAAGTTAAC	1	bc
GGCTCATCCT	GAAACACCGGTTTCCGTGGATGTAGAGCTGGAAATAGCAAAGTAACCTCA	1	bc
TACAATCAAT	GAAACACCGGTATAATTAGTTAACGAGTGGGGTTAGAGCTAGAAATAGCA	1	bc
TGTTTCTCTC	GAAACACCGGTCTTACTAGCATGAGAAATAGCTAGATATAGCAAGGTAAG	1	bc
TTGTTCTACA	GAAACACCTGTCATAGAAGCTATGGTTAGAGCTAGAAATAGCAAGTTAAC	1	bc
AAATCACCGA	GAAACACCGGTGGGGGTAGAGCTTGAGATAGAAAGATAAAGTAACGCTAG	1	bc
AACACATCAC	GAAACACCGGTGACATAGGTATGTGAGTGGGGTTAGAGCTAGAAATAGCA	1	bc
TAGTGGAGCG	GAAACACCGGTTGTGGGGAAGTAGGTGTGGGGGTAGAAGTAGGAATAGCA	1	bc
TACCGCCACC	GAAACACCGGCTAGAAATAGCAAGTTAACCTAAGGCTAGTCCGTTATCAA	1	bc
AGACTACACC	GAAACACCGGTTTAGTTAGTCCGAGGGGGGGGTATAGAGCTAAATAGAGC	1	bc
GACAAGGAAC	GAAACACCGGTAGTCGAAAGATCGGCGTGGGGATAATAGCAGAATAACCA	1	bc
CCATCCCACC	GAAACACCGGTTCAGCGAGCGTGAGAGCAGGGCTAGGCATGTCAAGATAA	1	bc
AGAGTCAAGT	GAAACACCGGTTATCGTTACGTATTTGTGGGGTTAGGGCTAGAATTAGCA	1	bc
GGACACCACC	GAAACACCTGTGTTCTTTGCTCGCGGGGGGGGGTTAGAGCTAGAATTAGC	1	bc
ACACCCCTCC	GAAACACCGGTGATCTTTGCTCGAGAGCGGGAATAAGCATGTAAATCTAA	1	bc
GCCCGCTATC	GAAACACCGGTCGTCGTTCGCCGGGGGGGGGTTAGAGCTAGAAATAGCAA	1	bc
GGGCAGCACC	GAAACACCGGTGTTCTTTGCGCGAGAGGGGGGGATAGAGCTAGAAATAGC	1	bc
TAATTCACGC	GAAACACCGGTCCTAGAAGCGGGGGTTGAGGCTGGAATTAGCAGGTTAAC	1	bc
AGTCATGCAC	GTAGAGGACCAAACACCGGTGCCCTTTATGCGACGGTGGGGTTAGAGCTA	1	bc
GAAATCATCA	GAAACACCGGTGCTAATAGTTAGATAGAGGTGGTAGAGCTAAAAAAAGCA	1	bc
CAGCCAGGCG	GAAACACCGGTTATCGTTCCGGATTTGTGGGGTTAGAGCTAGAAATAGCA	1	bc
GTCTTATATC	GAAACACCGGTCCTAGTTGGTTGTTGTGTGGGTTGAGCTAGAAAAATAGA	1	bc
ACAACACAAA	GACACACCGGTTTAGTATGTGGGGTTAGAGCTAGAAATATCAAGTTAACC	1	bc
GCCTCTATAA	GAAACACCGGTACTGGTTGCTTTCGGGTTGGGATGGAGCTCTAAGTCTCA	1	bc
GAACAGCAAA	GAAACACCGGTGCTCTTTGCTCGCGGGTGGGGGTAGAACTTGGAATAACA	1	bc
TGCTCTGCAT	GAAACACCGGTTCTCGTGGGGTTAGAGCGGGAAATAGCAAGTTAACATAA	1	bc
TCGACAATCT	GAAACACCGGTTACGCGATGTCTATTGCTAGAAATAGCAAATTAACCGAA	1	bc
TATCCATCAC	GAAACACCGGTTACCATGGGGTTAGAGCTGGGAATAGCAAGGTAACCGCG	1	bc
GTAACAGACG	GAAACACCGGTGTTAGGGAATAGAGCTAGGGGTTGCAGCTTAAAATAGCA	1	bc
CGACCGCACC	GAAACACCGGTGCTACTTGCGCCAGGGGTGGGGTTAGAGCTAGAAATAGC	1	bc
CCGTCCATCC	GAAACACCGGTTGCCTGTGCTCCTTTGGTGGTAGAGCTATAATAAGCTAG	1	bc
ACGCTCACAC	GAAACACCGGTTGGCTTTACTGCTTTGTGGGGTTAGAGCTATAAATAGCA	1	bc
TCATTCCTCC	GAAACACCGGTGACGCGAGGACGTTAGAGCTAGAAATAGCAAATTAACCT	1	bc
TAATCCCACC	GAAACACCGGTTTACTTAGTTAACTAGTGGGGTTAGACCTAGAAATAGCA	1	bc
TGACCGCATT	GAAACACCGGTGTTCTTGGCTTCGTGGGGGGGAGCAAGGAATAACAAGGC	1	bc
AACCAATCAC	GAAACACCGGTGTTCTTTGCTCGAGGGGTGGGGTTAGAGCCAGAAATAAC	1	bc
AATCCACACC	GAAACACCGGTTGCAAGCGAATGTTAGGGGGGGTTGGGGCTGAAAATGGC	1	bc
ACATCAAACA	GAAACACCGGTGGGATTAGAACGAGAGAGAGGATAGAGACAGAAATCTAA	1	bc
AATGGAGCCG	GAAACACCGGTGCCGTTTGTGGTACCGAGGGGATGGAGCTAGAAAGATCA	1	bc
GATTCATCCA	GAAACACCGGTTTTAGCAGTGGGGAGTGGGGTTAGAGCTAGAAATAGCAA	1	bc
TGTCCAGATT	GAAACACCGGTCTTCCTGGAATCTACGTGGGGTAGAGCTAGAAATAGCAA	1	bc
GACAGAGATA	GAAACACCGGTGCTAGTGACTTAGGGGTGGGGTTAGAGCTAGAAATAGCA	1	bc
AGACCCCAGA	GAAACACCGGTTTAGCAGGTGGGGTTAGTGCTGTAAATAGTAGAAATACC	1	bc
TGAACTTAAT	GAAACACCGGTTCCCGTGGGGATAGAGCTGGAAATAGCAAGATAACCTAA	1	bc
ATAACATACA	GAAACACCGGTGGGAAGGGATGGAGTGAGGGGTTGCAGGTAGAAATAGGG	1	bc
CAACGATCAT	GAAACACCGGTGCCAAACGTTTCGCAGTGGGGTTAGAGCTAGAAATAGCA	1	bc
AGCATGGCCT	GAAACACCGGTTCCCGTGGGGATAGAGCGATAAATAGCAAGTGAACCTAA	1	bc
GAATTATATG	GAAACACCGGTGTTAGTAAATGGGGAGTGTGGGTATAGATATAAATATAG	1	bc
TGTCCAGATT	GAAACACCGGTCTTCCTGGAATGGGGGGGGAGAGCTAGCAATAGCAAGCT	1	bc
ATCACTGCCT	GAAACACCGGTTCTCGTGGGTGTAGAGCTAGAAGTAACAGGTTAACCTAA	1	bc
CCTTCAAACA	GAAACACCGGTGGCAATACGATCTGAGTGGGGTTAGAGCTAGAAATAGCA	1	bc
GTGTGAACAC	GAAACACCGGTTGGGTTCGCTCTTGAAATGGCAAATTGCCCTAAGGATCA	1	bc
TAACCAGATT	GAAACACCGGTTTTCTTGGAATATAAGTGGGGTAAGGGCAGAAAAAGTAA	1	bc
GTCAAATCTA	GAAACACCGGTCGTCGTTCGTAGGGGGGGGGTTAGAGCTAGAAATAGCAA	1	bc
ATCCCACCCC	GACACACCGGTTGTAAGCGATGGTTTGTGGGGCTAGAGCTAGAAATAGCA	1	bc
TGACTAGGTA	GAAACACCGGTACTCGTTACTTACGGGGGGGGTTAGAGCTAGAAATAGCA	1	bc
GCATTACCCG	GAAACACCGGTTTTAGTAAATGACGAGTGGGGTTAGAGCTATAAATAGCA	1	bc
CCCTTCCCCC	GAAACACCGGTCCAAGCTGCTGGGGTTAGGGCTAGAAATCGCAAGTTAAC	1	bc
TGACCACAAC	GAAACACCGGTGTTCTTTGCACGAGGGGTGGGAGTTGAGCTTGACATATC	1	bc
TTCCCTCCCT	GAAACACCGGTTGCCGGCGGTGTAGAGCTAGGATAAAGATATTAATCTCA	1	bc
GGGCAGCACC	GAAACACCGGTTATCTTTACGGGTTTGTGGGGTTAGAGCTAGAAATAGCA	1	bc
