CCCCTCCCCT	GAAACACCGGTAGAATGGATCCACGGGTGGGGTTAGAGCTAGAAATAGCA	2	bc
AGACTACGTA	GAAACACCTGTACTAGTTACTTACGGGTGGGGTTAGAGCTAGAAATAGCA	2	bc
TTCTTCTCCC	GAAACACCGGTTGTAAACAACTATTTGGTTAGCTTAAGCTTAAACCGGTA	1	bc
TGTCCCTCTT	GAAACACCGGTCTTCCTGGTATAGAGGGGGAGCGCTAGAAATAGCAAGTT	1	bc
TGCCCTTCAC	GAAACACAGGTTCCCGTTAGCTCGTAAGTGGGGTTAGAGCTAGAAATAGC	1	bc
GATACATAAA	GAAACACCGGTCGCAATTCGTACGGGTTGGGGTTAAGCTTGGGAATACCA	1	bc
ATATAGCCGC	GAAACACCGGTGTGCGGAGCTTATGCGTGGGAAATAGCAAGTAAACTAAG	1	bc
AATTGAACCA	GAAACACCGGTTGTGGGGACCTCGGTGTTGGAGTAGTAGCAAGTTAACCT	1	bc
AAAGAAAAAC	GAAACACCGGTGGGGTTAGAGCTAGAGATAGGATGTTACCCTAAGGCTCG	1	bc
ATTCGGGCCA	GAAACACCGGTTGTGGGGGACTCGTTGTGGGAGTAATAGCAAGTTAACCT	1	bc
GACTCTATCA	GAAACACCGGTAATAGTTACTGACTGGTGGGGTTAGAGCTAGAAATAGCA	1	bc
ACATTACCAC	GAAACACCGGTTGGCTGTACTCCTTTGTGGGGTTAGAGCTAAAAATAGCA	1	bc
GGATCATAAA	GAAACACCGGTGAGAACAGAAGGCTTTGGGGTTAGAAGTAGAAATAGAAA	1	bc
TAATCCGCCA	GAAACACCGGTTGTGGGGAACTCGGAGTGGGAGAAATAGCAAGTTAACCT	1	bc
GTGACCCAGA	GAAACACCGGTGAGCTTAGAGAAATAGCAAGTTAACCTAAGGCAAGTCCG	1	bc
GACATATATC	GAAACACCGGTAAGCTAAAGAAGACCGAGGGGAAAGAGGTAGAAATAGGA	1	bc
CCCCGGGCCA	GAAACACCGGTAGAGGGGAACCAGGTGTGGGGCTAAAACTAAGTTAACCA	1	bc
ATCCGCGCCA	GAAACACCGGTAGAGTGGAACCACGGGTGGGGGTAGAGCTAGGATTAGCT	1	bc
TAATCACACT	GAAACACCGGTTGAGATAATCAAAAAGTGGGGTAGAGCTAGAAAAAGGCA	1	bc
TAGACAATCT	GAAACACCGGTGATCGGTACGTAAGAGAGCTAGATAGAGCGATAAAACCT	1	bc
AACCGCCTCG	GAAACACCGGTAGAATGGATTCACGGGTGGGGTTAGAGCTAGAAATAGCA	1	bc
CACAACATAC	CTAAACACCGGTTATCTATACTCCCCTGTGGGGATAGAGCTATAAATAGC	1	bc
TCAACATACA	GAAACACCGGTGAGCATGATAACGTGGGGAGAGAGTTAGCAGAAGCATGG	1	bc
GAGGGAGAGT	GAAACACCGGTGAGATGCTAGAAATAGCAAGTTTACCTAAGGCTAGTCCG	1	bc
CTGACCTTCA	GAAACACCGGTGATAACAGAACGTTTTGGGGTTAGAGCTAGAAATAGCAA	1	bc
CTTTCAGTAA	GAAACACCGGTGAGAACAGAACGTTTTGGGGTTAGAGCTAGAAATAGCAA	1	bc
GCCGCCAACC	GAAACACCGGTGGTCTTAAACTAAGCGTGGGGATGGTGCTCGAAATAGAA	1	bc
AAGCAAACAC	GAAACACCGGTTGGCGTTAATCCTTTGTGGGATTAGATCTATAAATAGCA	1	bc
CACCGTGTTT	GAAACACCGGTGCTAGCGGTTTCGAAGTGGGGTTAGAGCTAGAAATAGCA	1	bc
GTGGTATAGA	GAAACACCGGTGAGATTCTTGACATAGCAGGGGTACCTAATGGAAGTCCG	1	bc
AAGTTAATCG	GAAACACCGGTTTTGTTACAGAGGTAGAGAGGTAAGTGCCAGAATTCGAA	1	bc
GAATCTGTCC	GAAACACCGGTGCTAGTTGCTTACGAGTGGGGTTAGAGCTAGAAATAGCA	1	bc
CCCTAGTAAC	GAAACACCGGTTCAAACGGCGTCTTTTGTGGGGTTAGCGCTAGAAATAGC	1	bc
ACCACACAAG	GAAACACCGGTGTTGGTAGATATGGAGAGAGCAAGGTAACCGAAGTAGAG	1	bc
AACACCCTCA	GAAACACCGGTACTGCGAGGACGGGGGTGGGGTTAGAGCTAGAAATAGCA	1	bc
TACCCAGAAT	GATACACCGGTTTTCCTGGAATCGTGGGGGAGTGCTAGAAAGAGCAAGTT	1	bc
CCCTTCACAA	GAAACACCGGTTGTCGTTACTCCTTTGTGGGGTTAGAGCTAGAAATAGCA	1	bc
CATTACCAAC	GAAACACCGGTAATCTAACGATCTCCGTGGGGATAGAGCTAGAAATAGCA	1	bc
AAGCCAGACG	GAAACACCGGTCCTAGAAGCTGAGGTGAGAGCTTGAAGTAGGAAGTAAAC	1	bc
TAACCAGAGT	GAAACACCGGTCTTCCTGGAATCGAGGGGGGGATCTAGAAAGAGCAAGTT	1	bc
AAGTGAACAC	GAAACACCGGTTGGGTTTAATTCTTTGTGGGGTTAATGGCATAATTAGCT	1	bc
CAATGTGAAA	GAAACACCGGTGCTAGCGGCTTCGAAGTGGGGTTAGAGCTAGAAATAGCA	1	bc
ACATCGTCAC	GAAACACCGGTTGTGGGGAACTCGGGGTGGGCGAAGAGGCAAGTTAACCT	1	bc
AATGAACGTC	GAAACACCGGTCCTAGAAGCTGAGGTTAGAGCTAGAAATAGCAAGTTAAC	1	bc
ATCTCACACA	GAAACACCGGTTGTAAGCGATGGTTTGTGGGGTTAGAGCTAGAAATAGCA	1	bc
AAGCGTCCCG	GAAACACCGGTAGCATTTATCGACTAGTGGGGGTAGAGCTAGAAATAGCA	1	bc
AAACCAAGCG	GAAACACCGGTTTTCGTTGCAGATTAGAGCGAGAGATAGAGAGATATCAT	1	bc
TAATCAATAA	GAAACACCGGTTGAGATAATATAAAAGTGGGGTAGAGCTAGAAATAGCAA	1	bc
AAAACCTACG	GAAACACCGGTGGCAAAAATCCATTAGTGGGGTTAAAGTTAGAAATGGAA	1	bc
CAATGGGCTC	GAAACACCGGTGCTCTCTGTTTCTAAGTGGGGTTAGAGCTAGAAATAGCA	1	bc
CATAGCCGCC	GAAACACCGGTAGCATGGATCTATGGGTGGGGTTAGAGATAGAAATAGCA	1	bc
ACGATCATCA	GAAACACCGGTGAGAACAGAACGTTTTGGGGTTAGAGCTAGAAATAGCAA	1	bc
GAGCGCGAGC	GAAACACCGGTGAGATGGTAGAAATAGCAAGTTAAACTAAGGCTAGCCCG	1	bc
AATCGAGCTT	GAAACACCGGTGCCCGCGGTTTCACCGTGGGGTTAGAGCTAGAAATAGCA	1	bc
AAGTTAACCC	GAAACACCGGTTGCCTTTACTCCTTTGTGGGGTTAGAGCTATAAATAGCA	1	bc
GCCAAAAGCT	GAAACACAGGTGGTCGCCGTGGGGTTGGAGCTAGAAATAGCAAGTTGACC	1	bc
AGAAAGCACT	GAAACACCGGTTCCCGTGCTCTCGTAAGGGGGTTGAGAGCTAAAAAAAGA	1	bc
ATAAGACGCC	GAAACACCGGTAGAAAGGATCGACGGGTGGGGCTAGAGCTAGAAATAGCA	1	bc
ATAATATCTC	GAAACACCGGTGAGTGGGTTAGAGCTAGCAATAGCAAGTTAACCTCAGGC	1	bc
TGAATAGATT	GAAACACCGGTCTTCCTGCAATCGTGGGGTAGTGCTAGAAATAGCAAGAT	1	bc
CCGATAAAAA	GAAACACCGGTGAGTGGGGTTAGAGCTAGAAATAGCAAGTTAACCTAAGG	1	bc
AATCGCGGCC	GAAACACCGGTAGCATGGGTCCACGGGTGGGGTTAGAGCTAGAAATAGCA	1	bc
AATTCGTCAG	GAAACACCGGTTTTCGTTCATATGTCGCGGGGTTAGAGCTAGAAATAGCA	1	bc
CCTTGGTCCA	GAAACACCGGTTGTGGGGGACTCGGTGTTGGAGCAATAGCAAGTTAACCT	1	bc
AATAGGGATA	GAAACACCGGTGGTTGGGAACTCGGCGTGGGAGTAATAGCAGGATAACCA	1	bc
GGACGGGATG	GAAACACCGGTCGTCGTTCGTAGGTCGTGGGGTTAGAGCTAGAAATAGCA	1	bc
TCAGCAGATT	GAAACACCGGTGTTGCTAGAACTAGAAGGTGCAGGTAGACATAAGGATAG	1	bc
GAATTTGTCA	GAAACACCGGTACTAGTTACTTACGGGTGGGGTTAGAGCTAGAAATAGCA	1	bc
AATTAATCAA	GAAACACCGGTGACAAACGTATGTCAGTGGGGTTAGAGCTAGAAATAGCA	1	bc
TATTTAGCAC	GAAACACCGGTTGAGGGAAACTAAGTGTGGGAGAGATAGCAAGATAACAT	1	bc
CGGCGTTTTT	GAAACACCGGTCGTCGTTCGTAGGGCGTGGGGTTAGAGCTAGAAATAGCA	1	bc
GCAACAAGCT	GAAACACCGGTGATCGTTACAGGTTAGAGCTAGAAATAGCAAGTTAACCT	1	bc
AACTGGGCCC	GAAACACCGGTTGTGGGGACCTCGGTGTGGGGGTAGTAGTAGGTTGACCT	1	bc
GTTTCACATA	GAAACACCGGTGGCCATTCTATATGTGTGGGGTTAGCGCTAGACTTAGCC	1	bc
ATTTCCGACA	GAAACACCGGTGGCAATTCGATCTGAGTGGGCTTAGAGTTATAAATAGCA	1	bc
AGTTAACCCA	GAAACACCGGTGCGCGGAGATTATGCGTGGGATATAGCAAGTAACCTAAG	1	bc
AATACGCCAT	GAAACACCGGTTGCGTTGGATCATTTGTGGGAGTAAAGCTAAGATAACCT	1	bc
GTGTTAGAGA	GAAACACCGGTGATATTATATAAATAGTGAGGTTAGCTAAGGCAATAGCG	1	bc
TTGTTAAGCG	GAAACACCGGTTATGGTTGCGGATTAGAGCTAGATATAGCAAGTTAACCT	1	bc
GCGTCAAGAA	GAAACACCGGTTATCGTAAAGGATTAGAGATATAGATAGCATGTTAACCT	1	bc
AGATGATAAA	GAAACACCGGTGCGAACAGAACGTTTTGGGGTTAAGACTAAGAATAAGAA	1	bc
ACATTCACAC	GAAACACCGGTGGCAATTCGATCTTAGTGGGGTTAGAGCTAGAAATAGCA	1	bc
TCAACACTAA	GAAACACAGGTGACACGAGGACGTTGGTGGGGTTAGAGCTAGAAATAGCA	1	bc
GAGTCGGAAG	GAAACACCGGTTATCGTTACGGATTAGAGCTAGAAATAGCAAGTTAACCT	1	bc
TTCTTACAGA	GAAACACCGGTGTGCGGAGATTATGCGTGAGAAATAGCAAGTAACCTAAT	1	bc
CAAAACCACC	GAAACACCGGTAATATAAAGATCCCCGTGGGGATAGAGCTAGAAATAGCA	1	bc
AGCGTTAACA	GAAACACCGGTTGGCTTTGCTACTTTGTGGGGTTAGAGCTATAAATAGCA	1	bc
GGCCACGACC	GAAACACCGGTAATCTAAAGATCCACGTGGGGATAGAGCTAGAAATAGAA	1	bc
AGCTACTTCG	GAAACACCGGTGGCAGCCAGCCACTTGTGGGGTTAGAGCTAGAAATAGCA	1	bc
ACCCCACCGC	GAAACACCGGTAGAATGGATCCACGGGTGGGGTTAGAGCTAGAAATAGCA	1	bc
CCCTTCTCAC	GAAACACCGGTTGCCTTTACTCCTTTGTGGGGTTAGAGCCATAAATAGCA	1	bc
GAAACCAACG	GAAACACCGGTTATCGTTACGAATTAGAGCTAGTAATAGCAAGTTAACCT	1	bc
CCCTTCAGCC	GAAACACCGGTAGTATTAATCCACGCGTGGGGTTAGAGCTAGAAATAGCA	1	bc
AGCCAACCAC	GAAACACCGGTGTTCTTTGCTCATGGGTGGGGTTAGAGCTAGAACCAGCA	1	bc
GGCTACACAG	GGAACACCGGTGGCAGTCAGCCACTTGTGGGGTTAGAGCTAGAAATAGCA	1	bc
CCGCTAGATC	GAAACACCGGTTTGCTTGGCTCCTTTGGGGAGTGCTAGATATAGCTAGCT	1	bc
GGGTCATCAG	GAAACACCGGTGAGAACAGAAGGTTTGGGGGGTAGAGCTAGAAATAGCAA	1	bc
GCGCGCCACC	GAAACACCGGTGTGCTTTGCTCGAGTATCGGGTTAGAGCTAGGAATAGCA	1	bc
GCCTGAAGCC	GAAACACCGGTAGAATGGATCCACGGGTGGGGTTAGAGCTAGAAATAGCA	1	bc
TCATTCCTCC	GAAACACCGGTGACGCGAGGACGGAGGTGGGGTTAAGGCTAGAGAAAGCA	1	bc
TACTCTTACT	GAAACACCGGTGGCAATTCGATCTGAGTGGGGTTAGAGCTAGGAATAGCA	1	bc
ATGACCCAAC	GAAACACCGGTGTTATTAGCTGGGGGTAGAGCTTGGAACAGGAAATTAAA	1	bc
TCGTTCAAAC	GAAACACCTGTTTGCTTTACTCCTTTGTGGGGTTAGAGCTATAAATAGCA	1	bc
TAGCCAGATG	GAAACACCGGTTATCGTTACGGATTATAGCTAGAAATAGCAAGTTAACCT	1	bc
CCGATATATA	GAAACACCGGTGGGTGGTGTTACTGCGAGAAATTACAGCTTAACCTAACG	1	bc
CCATTATATA	GAAACACCGGTGCAAGCGGCTAGTGCTAGGATTGGCCTGGTAACAGCAGG	1	bc
TCGTCAACAA	GAAACACCGGTGGGGTTAGAGCTAGAGATGGCATGTTACCCTAAGGCTAG	1	bc
GCATTATCAC	GAAACACCGGTTGGCTTAACTCCTTTGTGGGGTCAGAGCTATAAATAGCA	1	bc
ATTTAATCAC	GAAACACCGGTGACAGAAGTCTGTCAGTGGGGTTAGAGCTAGAAATAGTA	1	bc
TAAATCTATA	GAAACACCGGTTTACATAGTTACGTCGGGGGGTTAGAGCTAGAAATAGCA	1	bc
AGAAAGAAAA	GAAACACCGGTGTTCTTTGCTCGGGGGTGGGGTTAGAGCTAGAAATAGCA	1	bc
AAACGAGCAT	GAAACACCGGCGACAAACGTATGTCAGTGGGGTTAGAGCTAGAAATAGCA	1	bc
CCAGCAACAC	GAAACACCGGTGGGGTTAGAGCTAGAAATAGCAAGTTAACCTAATGCTAG	1	bc
TTAGCAACCA	GCCACCCCGGTGGGGTTAGAGCTAGAAATAGCAAGTTAACCTAAGGCTAG	1	bc
TCCGCCGAAA	GCAACACCGGTGGGGTTAGAGCTAGAAATAGCAAGTTAACCTAAGGCTAG	1	bc
CGCTCTTCCA	GAAACACCGGTTCCAGTTAGCTCGTAGGGGGGGTTAGAGCAAGAAAACGA	1	bc
GGCTAAACCG	GAAACACCGGTTGCAGTAAGTCAGTTGTGAGAGTAGAACTAAAAATAGCA	1	bc
GGTGAGCGAG	GAAACACCGGTGAGCTGATAGAAATAGCAAGTTAACCTAAGGCTAGACCG	1	bc
CAATTAAAGC	GAAACACCGGTAGAATGGATCAACGGGTGGGGTTAGAGCTAGAAATAGCA	1	bc
GTGGTATAGA	GAAACACCGGTGAGATGCTAGAAATAGCAAGTTAACCTAAGGGTAGTCCG	1	bc
GGGTGAGTTG	GAAACACCGGTCATCGCTCCGAGGTAGAGCTATTAGAAGTAAGAAAACCA	1	bc
TGACCAAATA	GAAACACCGGTCGTCCTGGAATCGTAGGGAGGAGCTAAACCTAGCAAGAT	1	bc
ATGTACGTAA	GAAACACCGGTACTAGAAGCTGAGGGTTGGGGTTAGAGTAGGAAGTAGAA	1	bc
GGGTATGTAG	GAAACACCGGTGGCAATTCGATCGGAGTGGGGTTAGAGCTAGAAATAGGA	1	bc
GACATACTAA	GAAACACAGGTGCTAATAGTTAGGTCGTGGGGTTAGAGCTAGAAATAGCA	1	bc
TCGACAGAAA	GAAACACCGGTCCTAGAAGCTGAGGTTATAGCTAGAAATAGCAAGTTAAC	1	bc
GAATCCCGAG	GAAACACCGGTTATCGTTACGAACTAGTGCTAGTAATAGCAAGTTAACCT	1	bc
GTAGTAAAGA	GAAGCACCGGTGAGATGCTAGAAATAGCAAGTTAACCTAAAGCTAGACCG	1	bc
GAAAAATAAA	GAAACACCGGTACTAGTTACTTACGGGGGGGGTTAGAGCTAGAAATAGCA	1	bc
AACATATAAG	GAAACACCGGTGAGCATGATAACGTCGTGGGGTTAGAGCTAGAAATAGCA	1	bc
ATTACATCAA	GAAACACCGTTGAGAACAGAACGTTTTGTGGTTAGAGCTAGAAATAGCAA	1	bc
CATCCCCACA	GAAGCACCTGTGGCAATTCGATCTGAGTGGGGTTAGAGCTAGAAATAGCA	1	bc
TCAGCAAGCC	GAAACACCGGTGGGGTGAGAGCTAGAAATGGCAAGTTAACCTAAGGCTAG	1	bc
CTCAACCTGC	GAAACACCGGTAATCTAAAGATCCCCGTGGGGATAGAGCTAGAAATAGCA	1	bc
CACATAACAC	GAAACACCGGTTGGCTTTACTCCTTTGTGGGGTAGAGCTATAAATAGCAA	1	bc
CCCTCCTACG	GAAACACCGGTGGCAGCCAGCCACTTGTGGGGTTAGAGCTAGAAATAGCA	1	bc
AATAAATCCT	GAAACACCGGTGGCCTTTGTGGTGCCGTGGGGTTAGAGCTAGAAATAGCA	1	bc
TGTCGGGAAA	GAAACACCGGTTGTCCTGGAATCGGGGGGGGGGAAAAGAAAAGGCAAGCT	1	bc
GGATTAACCC	GAAACACCGGTGGCGGTAATCCACTTGTGGGGTTAGAGCTAGAAATACCA	1	bc
GACAGCCCCA	GAAACACCGGTAGTCTGGAGCTACGCGTGGGGATAGAGCTAGAAATAGCA	1	bc
GATAAAATAC	GAAACACCGGTAATCTAAAGATCCCCGTGGGGATAGAGCTAGAAATAGCA	1	bc
TCCTTCATCC	GAACCACCGGTTGCGGTTATCTCGTAGGGGGGGTTAGATCGAGATAGAGA	1	bc
CACCCGCTCC	GAAACACCGGTTTAGCCGGCGGCTTTTGAGCTAGTAGTGCTAGGGAGAGC	1	bc
ACATAAACAC	GAAACACCGGTTGGCTTTACTCCTTTGTGGGGTTAGAGCTATAAATAGCA	1	bc
AAACCAAGAG	GAGACACCGGTTTTCGTTGCGGGTTAGAGGTTGAAAAAGGAAGATAACCC	1	bc
TAATTATCTA	GAAACAACGGTGAGCATAATTAATGAGTGAGATATAGCAAGTAACCTCAG	1	bc
GTATCCATAA	GAAACACCGGTGCTAGTAGTTAGCTTGGGGGGTGAGAGCGAGAAATAGCA	1	bc
TGTTCCGACT	GAAACACCGGTCTTCCTGGAATCGTGGGGTAGAGCTAGAAATAGCAAGTT	1	bc
AGCTCTCCCT	GAAACACCGGTTCCCGTTGGCTAGGCGTGGGATAGCGCGAGAACCCAAGG	1	bc
ATCCTGCACT	GAAACACCGGTTTTCGATGATGGTTTGTGGGGTTAGAGCTAGAAATAGCA	1	bc
AATACGTACC	GAAACACCGGTGACCAACGTATGTCAGTGGGGTTAGAGCTAGCACTAGCA	1	bc
CAAAGACACA	GAAACACCGGTGAGAAGTAGTAGAGTTAGAAATGGCAAGTTAACCTAAGA	1	bc
GACCGAGACT	GAAACACCGGTGCTAGCGGTTTAGAGGTGGGGTTAGAGCTAGAAATAGCA	1	bc
TACTGGGACA	GAAACACAGGTTCGATCCGAGACATAGCTAGGGATCGAGATAGAAATAGC	1	bc
CAAAAAATAT	GAAACACCTGTGCGGCGAGTTTAGTGGTGGTTTTAGAGCTAGAAAGAGCA	1	bc
CCACGTGACT	GAAACACCTGTGCTCTCGGTTTCGAAGTGGGGTTAGAGCTAGAAATCGCA	1	bc
GAAATAGTCG	GAAACACCGGTTTTAGAACATAGGTAGCGGGGTTAGAGCTAGAAATAGCA	1	bc
GATAGATAAA	GAAACACCGGTGAGTGGGGTTAGAGCTATAAATAGCAAGTTAACTAAAGG	1	bc
GGATAACAAA	GAAACACCGGTGCTATTAGCTAGCGCGTGGGGTTAGAGCTATAAATAGCA	1	bc
GTAAGGGCTA	GAAACACCGGTGGGGGGGGTTAGAGCTAGGAAGATCAAGTAAACCAAAGG	1	bc
CCACCCCGCA	GAAACACCGGTAGAGTGGATCCACGGGTGGGGATAGAGCTAGAAAGAGCA	1	bc
CACTCTGAAA	GAAACACCGGTGCTAATTACTTAAGGGTGGGGTTAGAGCTAGAAATAGCA	1	bc
TGAACTACGA	GAAACACCGGTTTAGGATGGCTCGTAAGGGGGGTTAGAGCTAGAAAAGGC	1	bc
AGACACCTCT	GAAACACCGGTGTTGTTTGCTCGAGGGTGGGGCTAGAGCTAGAAAGAGCA	1	bc
CGCAATTACT	GAAACACCGGTGGCAGTTAGCCACTAGTGGGGTTAGAGCTAGAAATAGCA	1	bc
ATTTGGGACT	GAAACACCGGTTGTGGGGAACTCGGTGTGGGAGAAATAGCAAGTTAACCT	1	bc
CTGGCCGCGA	GAAACACCGGTGAGATCATAGAGATATCGGGTTAGCCTAAGAATTGGCCG	1	bc
GGCCATGAAA	GAAACACCGGTACTCGTTACTTGCGGGTGGGGTTAGAGCCAGAAATAGCA	1	bc
TGATCAACCC	GAAACACCGGTGAGGACAGAACGTTTTGGGGTTAGAGCTAGAAAAGGCAA	1	bc
TGCTTATCCT	GAAACACCGGTTCCCGTTGGTTCGTAATGGGGGTTAGAGCTAGAAATAGC	1	bc
AGAACACAAT	GAAACACCGGTTGTAAGCGATGGGTTGTGGGGTTAGAGCTATAAATAGCA	1	bc
ATGTTCGACG	GAAACACCGGTCCTAGAAGCTGAGGTTAGAGCTTGAAATAGCAAGTTAAC	1	bc
GCGATAAAAA	GAAACACCGGTTGGCTTTACTCCTTTGTGGGGTTAGAGCTATAAACAGCA	1	bc
AGCGCCTGCA	GAAACACCGGTTATCGTTACGGATTTGATGTAGTAATAGCAAGTTTACCT	1	bc
TCCACTCCCC	GAAACACCGGTTCCCGTTATCTCGTAAGTGGGGTTAGAGCTAGAAATAGC	1	bc
TTCTCAGCTT	GAAACACCGGTCTTCCTAGAATCGCGGGGGGGATCGAGCAAGAGCAAGTT	1	bc
GTCATAGCTA	GAAACACCGGTGAGTGGTGTTAGAGCTAGAAATAGCAAGTTAACCTAAGG	1	bc
AAACGCGTTT	GAAACACCGGTGCTAGCGGTTTCGAAGTGGGGTTAGAGCTCGAAATAGCC	1	bc
AATACAGCCC	GAAACACCGGTGACAAACGTATGTCAGTGGGGTTAGAGCTAGAAATAGCA	1	bc
TCCTCTCAAA	GAAACACCGGTTCAACCGGCGTCTTTTGTGGGGTTAGAGCTAGAAATAGC	1	bc
TTTTTTTCCG	GAAACACCGGTCGCGAATATGGGACGGTGGGGTTAGAGCTAGAAATAGCA	1	bc
ACACAATTAC	GAAACACCGGTGACAAACGAATGACAGTGGGGATAGAGCTAGAAATAGCA	1	bc
GTCAAACTGC	GAAACACCGGTAATCTGAGGATATGCGTGGGAATTAACCTGGAACTAACA	1	bc
TTCGAACCAA	GAAACACCGGTGGGCGGAGATCAAGCGTGAGCAAGAGCAAGTAACCTAAG	1	bc
AACCCCCTGC	GAAACACCGGTTTACTATGGAGGGACGTGGGGTTAGAGCTAGAAATAGCA	1	bc
AAATAAGAAG	GAAACACCGGTTTTCGTTGCTGGGGGGTGGGGTTAGAGCTAGAAATAGCA	1	bc
ATTTGGCCCC	GAAACACCGGTTGTGGGGAACTCGGTGTGGGAGAAATAGCAAGTTAACCT	1	bc
GCAACATACA	GAAACACCGGTGAGACCAGTTCGAGCTGGAGATAGAGCTAGAAATCGCAA	1	bc
CCTTCACTCA	GAAACACCGGTGGCGATTGGGTTTGAGTTGGGTTAGAGCTAGTAATAGCA	1	bc
GACTCATCAA	GAAACACCGGTGATAACTGAACAGTTTTGGGGTTAAACTAGGAATAAGCA	1	bc
GACCGAAGCG	GAAACACCGGTAGTAGGGATGCACTAGAGGGAGTAAAGCTAGGAAAAGCA	1	bc
ACGATAACCC	GAAACACCGGTCCGCTTTACTCATTTGTGGGGTTAGAGCTAGAAATAGCA	1	bc
TGTACAGACG	GAAACACCGGTCTTACTGGAATCGTGGGGGAGAGAGAGATATAGCAAGTT	1	bc
AGCAAATAAG	GAAACACCGGTGGAAGACAGCCACTTGTGGGGTTAGAGCTAGAAATAGCA	1	bc
TCCGAAATAA	GAAACACCGGTACTGTTAGAGCACGCGCTTGCACGTTAACATAAGGATCA	1	bc
CAACGCCGAC	GAAACACCGGTAGAATGGCTCCACGGGTGGGGTTAGAGCTAGAAATAGCA	1	bc
GTTATATCTT	GAAACACCGGTGGGCATGATAACGTCGTGGGGTTAGAGCTAGAAATCGCA	1	bc
CGGTGAGCAA	GAAACACCGGTTAGAACAGAACGGATGGGGGGTAGAGCTAGGAAAAGCAA	1	bc
AGGACCTCAG	GAAACACCGTTGATAGAAGAACGTTTTGGGGTTAGAGCTAGAAATAGCAA	1	bc
ACACCATAAA	GAAACACCGGTGGCATTAGAACTACAGATAGCAAATTAACCTAAATCTCG	1	bc
TCCCTCGCAA	GAAACACCGGTTCAACCGGCGTGTTTTGGGGGGTTAGAGCTAGAAATAGC	1	bc
GGTGCGGAAA	GAAACACCGGTGAGAACAGAAAGGTTCTAGGATAAGGCTGGAAACATAAA	1	bc
TAGTTCATGA	GAAACACCGGTGAGATGCTAGAAATAGCGGGTTAGACCTAGGATTGTCAG	1	bc
ACATCACCCT	GAAACACCGGTTGTATTCGATCGTTTGTGGGGTTAGAGCTATAAATCGCA	1	bc
ATTAGCGCCG	GAAACACCGGTCCTATAGGCTGAGGTTTGGGCTAGAAATCGCAAGTTAAC	1	bc
GCGCCAGATT	GAAACACCGGTCTTCCTGGAATCGTGGGGTAGAGCTAGAAATAGCAAGTT	1	bc
TCCCCGACGC	GAAACACCGGTAGAATGGATACACGGGTGGGGTTAGAGCTAGAAATAGCA	1	bc
TAACGAGCCT	GAAACACCGGTTCTAGCGGTTTCGAAGTGGGGTTAGAGCTAGAAATAGCA	1	bc
ATATTATAGA	GAAACACCGGTGTGAGGAGTATCTGCTTGAGAAGTATGAGGTAAACTAAG	1	bc
TACTAAAAAA	GAAACACCGGTGTGGTTAGAGTTTGAATTAGCAAGTTAACCTAAGGCTCG	1	bc
CAATCGCACA	GAAACACCGGTTTAACCGGCGTCTTTTGTGGGGTTAGAGCTAGAAATAGC	1	bc
ACGAGCCGCC	CTAAACACCGGTAGTATAAGACCTCGGGATAGGATAGTGATCGAAGTCGC	1	bc
GGACAACAAA	GAAACACCGGTGCTCATAGCTAGGTCGTGGGGTTAGAGCTAGAAATAGCA	1	bc
TAGAGAGCCG	GAAACACCGGTTATCGTTACGGAGTAGTGGGAGGAATAGCAAGTTAACCT	1	bc
GAACTATCTC	GAAACACCGGTGACAGAGGTTAGAGATAGGGATAGCAAGTTAACCTAAGG	1	bc
GACACACGAG	GAAACACCGGTTATCGTTACGGATTCGAGCTATAAATAGCAGGTTAACCT	1	bc
AATCCGCAAC	GAAACACCGGTGACAACCGCATGTCAGTGGGGTTAAAGCTAGAAATAGCA	1	bc
CGGTCATGAG	GAAACACCGGTGAGCACTAATGATTTGGGGTAGGAATAGCAAGTAAACCT	1	bc
CCACCGGTTT	GAAACACCGGTCGTGGGAGGAAGGGCGTGGGGTTAGAGCTAGAAATAGCA	1	bc
GTAACCTACA	GAAACACCGGTCCTCAAGGCAGCGTTGTGGGGTTAGAGCTAGAAATAGCA	1	bc
GAGATATGTG	GAAACACCGGTTATCGTTACGGATTAGAGCTAGATATAGCAAGTTAACCC	1	bc
GACCAAGTCC	GAAACACCGGTAATCTAAGGATCTACGTGGGGAAAAGCCTGGAAATAGAA	1	bc
AAAACCCCAC	GAAACACCGGTGTACTTAGTTTACTAGTGGGGTTAGAGCTAGAAATAGCA	1	bc
CCCACACACA	GAAACACCGGTTCTACCTGGGTGGTGTGGGGGGATAGCGATAAAAATCAA	1	bc
GTGATCGAAA	GAAACACCGGTGATATTCTAGAAATAGCGGGTTAACCTAAGGCTATTCCG	1	bc
ACGCCCCGCC	GAAACACCGGTAGAAGAGGTTGAGGTGTGGGGTTAGAGCTAGAAATAGCA	1	bc
CCTTTAATCC	GAAACACCGGTGGCGATACTCTAAGAGTGGGGTAGAGCTATAAATAGCAA	1	bc
ATCTAACAAC	GAAACACCGGTGTGCGGTGATTATGCGTGGGAAATAGCAAGGAAACTAAG	1	bc
GTTTTATCAA	GAAACACCGGTTGGTGGGGATACAGCTTGGAATAGCAAGCTAATCTACCG	1	bc
TTAATACAAA	GAAACACCGGTGTGCGTAGTTAATTCGTGGGAAATAACAAGTAATTAACG	1	bc
CAACACGTTT	GAAACACCGGTGCTCTCAGTTTCGACGTGGGGTTAGAGCTAGAAATAGAA	1	bc
AGTAAGGACC	GAAACACCGGTGTTCTTTGCTCGAGGAGGGGGTTAGATATCGAAATAGCC	1	bc
ATCGAATAGA	GAAACACCGGTGTGAGGAGATTATGCGTGAGAAATATCAAGTAACCTAAG	1	bc
TCATGCATCC	GAAACACCGGTTGAGATAATCAAAAAGTGGGGCAGAGCTAGAAATAGCAA	1	bc
AATTGTGCCC	GAAACACCGGTTGTAGGGAATTCGTTGTGGGGGTAATAGCAGGTTTACCT	1	bc
TGATTACAAA	GAAACACCGGTGCTAATAGTTAGCTCGTGGGGTTAGAGCTAGAAATAGCA	1	bc
TAAGGAAATT	GAAACACCGGTGCTATTGGTTTTGAAGTTGGGTTAGTGCTATAAATATCG	1	bc
CAACGCCGAT	GAAACACCGGTAGACTGGATCCACGGGTGGGGTTAGAGCTAGAAATAGCA	1	bc
ATGGTAGCGA	GAAACACCGGTGAGATGCTAGAAATAGCAAGTTAACATAAGGCTAGTGCG	1	bc
CCCCGAGACT	GACACACCGGTAGTCAGGAACTACGGGTGGGAGTAGAGGAAAGAGCAGGT	1	bc
GGACCGCCCA	GAAACACCGGTGTTATTTGCTCGAGGGTGGGGTTAGAGCTAGAAATAGCA	1	bc
TGCCCACTCT	GAAACACCGGTCTTCTTGGAATCGTGGGGAGAGCTAGAAATAGCAAGTCA	1	bc
CCAATAACTC	GAAACACCGGTTGGCTTTACACCTTTGGGGGGGTAGAGCTTTGAATAGCC	1	bc
CGTCCCCCAA	GAAACACCGGTGAGAACAGAACGCTTTGGGGTTAGAGCTAGAAATAGCAA	1	bc
CCTACCCACA	GAAACACCGGTGGCGATAGGACCTGAGAGGGGGAAGTGCTAGGATAAGCT	1	bc
ATTCCAGAGG	GAAACACCGGTCTTCCTGGAATCGTGGGGTAGAGCTAGAAATAACAAGTT	1	bc
GAATTATTTA	GAAACACCGGTTGGGGTGGTTAGAGCTAGGGATAGCAAGGTAACCGAAGG	1	bc
TGCACCGACT	GAAACACCGGTATTCCTGGAATCGTGGGGGAGAGATAGCTAGAAAAAGCA	1	bc
AGGCTGCTAG	GAAACACCGGTCTTCGATCGTAGTGCGTGGGGTTAGAGCTAGAAATAGCA	1	bc
CACTAGGAAA	GAAACACCGGTACTATTTACTTGCGGGTGGGGCTAGAGCTAGAAATAGCA	1	bc
AAATCCGTAA	GAAACACCGGTTTTGTGTAACTCGGTGTGGGAGAAATAGCAAGTTAACCT	1	bc
ATGGCCCTCC	GAAACACCGGTCCTATAAGCTGAGGGTAGAGCTAGAAATAGCAAGTTAAC	1	bc
TGATCATTCT	GAAACACCGGTTGCCATTAGCTCGTAGGGGGGGTAAGAGCTAAAAATAGC	1	bc
AACCCACCCA	GAAACACCGGTGACAAATGGATCTCAGTGGGGTTAGAGCTAGAAATAGCA	1	bc
CCCCCAGATT	GAAACACCGGTCTTCCTGGGATCGTGGGGTAGAGCTAGAAATAGCAAGTT	1	bc
CCACCACCCC	GAAACACCGGTAGAATGGAACCACGGGTGGGGTTAGAGCTAGAAATGGCA	1	bc
ATCTAGCAAA	GAAACACCGGTGTGCGGAGATTATGCGTGAGAAATAGCAAGTAACCTAAG	1	bc
TCCATCTCCC	GAAACACCGGTCACGCGAGTACGCCGGTGGGGTTAGAGCTAGAAATAGCA	1	bc
GGAATGTAAA	GAAACACCGGTGATCATTATAACAGCGTGGGGTTAGAGCTAGAAATATCA	1	bc
CATCCCCCAA	GAAACACCGGTGGAAATTAGATCTGAGTGGGGTTAGAGCTAGAAATAGCA	1	bc
GTGCGCGCGC	GAAACACCGGTGAGATGCTAGAAATAGCAGGTTAACCTAAGGATAGACCG	1	bc
GCCAGACACC	GAAACACCGGTCGTCGGTCTTCACGGGGGGGTTTAGACTTGAAATTGCCA	1	bc
AAGGGCTCGA	GAAACACCGGTGAGATGCTAGAAATAGCAAGTTAACCTAAGGCTAGTCCG	1	bc
AACAGCCTAC	GAAACACCGGTAGTCGGGAACTCCGCGTGGGAGTAATAGTAAGATAACCA	1	bc
CTCAGCGGCC	GAAACACCGGTAGAATGGACCCACGGGTGGGGTGAGAGCGAGAAATAGCA	1	bc
CAATGACAGA	GAAACCCCGGTGCTAGCGGTTTCTAAGTGGGGTTAGGGCAAGAAATAGCA	1	bc
CAATCACATT	GAAACACCGGTGCTAGCGGCTTCGAAGTTGGGTTAGAGCTTGAAATTAGA	1	bc
CACAGGGATT	GAAACACCGGTGCTCGCGGTTTCGAAGTGGGGTTAGAGCTAGAAATAGCA	1	bc
ACCACGCAAA	GAAACACCGGTTTTCGTTCATCGGTCGTGGGGATAGAGCTAGAAATAGCA	1	bc
GTGCGCGACT	GAAACACCGGTTAGATGCTATGAATAGCAAGTTAACCTCAGGCTAGTCCG	1	bc
ACGGCTAGCT	GAAACACCGGTCGTCTTTAGTAGGGCGTGGGGTTAGAGCTAGAAATAGCA	1	bc
ACCACGCTCC	GAAACACCGGTTCAACCAGCGTCTTTTGTGGGGTTAAAGCTAGAAATAGC	1	bc
CCACGCCACA	GAAACACCGGTCGAAGGGAGCCAGGGGTGGGGTTAAGGCAGGAAATGGAA	1	bc
ATTCGGCCCA	GACACACCGGTTGTGTGCGATGCGGTGTGGGATTAGAGGTAGATATAGCA	1	bc
TGTTCAGAAC	GAAACACCGGTCTTCCTGGAATCGTGGGGTAGAGCTAGAAATAGCAAGTT	1	bc
ATGCCCGATT	GAAACACCGGTCTTCCTGGAAGCGTGGGGTGGAGCTAGAAGTAGCAAGTT	1	bc
ACACGATCAC	GAAACACCGGTTACAAACGGCAATCTGTGGGGTTACAGCTCGAAATAGCA	1	bc
GACTGCGGAA	GAAACACCGGTACTAGTTACTTACGGGTGGGATTAGAGCTAGAAATAGCA	1	bc
TAAGAAAACC	GAAACACCGGTGGTGTTAGAGCTAGAAATAGCATGGTAACCTAAGGCTAA	1	bc
TAATCATACA	GAAACACCGGTTGGGGTAGAGCGAGAAATAGCAAGTTAACCTAAGGCTAG	1	bc
TAATACCTCC	GAAACACCGGTAGTGTTAATCAAAACGTGGGGAAGAGCTAGAAAAAGCAA	1	bc
GATTGAGCCA	GAAACACCGGTTGTGGGGAACTCGGTGTGGGAGTAATAGCAAGTTAACCT	1	bc
ATCAACGCCG	GAAACACCGGTCCTAGAAGCTGGGGCTAGAGCTAGAAATAGCAAGTTAAC	1	bc
CTACCACAAA	GAAACACCGGTTGTAAGCGGTGGTTAGTGGGGTTAGAGCTAGAAATAGCA	1	bc
GTGGGATACA	GAAACACCGGTGAGCTTCTTGAAGTAGTGGGTTTAGAGCTAGCAATAGCA	1	bc
CACTGCCCCA	GAAACACCGGTAGAAGGGATCTACGGGTGGGGGTAAAGCTAGAAATAGCA	1	bc
GGATAAGACT	GAAACACCGGTCTTCTTGGATTGGGGGGGTAGGGCTAGAAATAGCAAGTA	1	bc
AATCGAGCAG	GAAACACCGGTCGTCGTTGTTAGGGCGTGGGGTTAGAGCTAGAAATAGTA	1	bc
AACAGAGAAG	GAAACACCGGTGCTAGCGGTTTCGAAGGGGGGTTAGAGCTAGAAATAGCA	1	bc
CGCTCCTCCA	GAAACACCGGTGGGAACAGAAAGTTTTGGGTTTAGAACGATAACTAGCAA	1	bc
TACTCAATCA	GAAACACCGGTTGCGATTATCTATAAGTGGGGTTGGGGCTGGAAATGCAA	1	bc
AAAACTCAAA	GAAACACCGGTATTCTTAGTTTACTAGTGGGGTTAGAGCTAGAAATAGCA	1	bc
ATGACAGTAA	GAAACACCGGTGGTGGTAGAGGTATAAGAAGTAAGATAACCACATACGAG	1	bc
CGTCAGCCAC	GAAACACCGGTGAGCACAGCTCGTTTTGGGGTTAGGGCTAGAAATAGCAA	1	bc
CATTCCCACC	GAAACACCGGTGGAAATTCGCTATGAGTGGGGTTAGAACTAGAAATAGCA	1	bc
GACAACGCCG	GAAACACCGGTTGTAGCCAGTCACTTGTGGGGGTAGAGCTATAAATATCA	1	bc
GGCACAGACG	GAAACACCGGTGGCAGCCGACCACTTGTGGGGTTAGGGCTGGAAAAGGCA	1	bc
ACCTAACACA	GAAACACCGGTGCGCCGAGATTATGCGTGGGGAATAGAAAGAAACATAGT	1	bc
AACCTTAAAG	GAAACACCGGTGTAAGAGACTTATGGGGGGGGTAAAGCCAGTAACCGCCA	1	bc
TTGACCTCCC	GAAACACCGGTCCTAGAAGCTGAGGTTAGAGCTAGAAATATCAAGTTAAC	1	bc
CAACCAAGTT	GAAACACCGGTGCTCGCGGTTTCGTAGTGGGGTTAGAGCTAGAAATAGCA	1	bc
CCCTTCCCCC	GAAACACCGGTAATATAAGGACGCTGTGGGGGTAAGAGTAAAAAATACCA	1	bc
AATCCAGAAT	GAAACACCGGTGACAAACGTATGTCAGTGGGGTTAGAGCTGGAAATAGCA	1	bc
CAACGACGCT	GAAACACCGGTGCTAGCGGTTTCGTAGTGGGGTTAGAGCTAGAAATAGCA	1	bc
TCCCCTTCCC	GAAACACCGGTTCCAGTGATGTTAGAGCTAGGATTAACAAAGTAAACTAA	1	bc
AACAGGCCAA	GAAACACCGGTTTTCGGGCACAGGGCGTGGGAGTAGAGGTAAGTTAACCA	1	bc
ATACCCCGCC	GAAACACCGGCTGTAAACGGTGGGTTGTGGGGTTAGAGCTAGAAATTGCA	1	bc
CTTTGATCAG	GAAACACCGGTGGGAACAGAACGGTTTGGGGTTTGAACCAAGAATAACCA	1	bc
GCGTTAGCAT	GAAACACCGGTTTTAGTAAATGGTGAGTGGGGTTAGAGCTAGAAATAGCA	1	bc
AAGACCAGCG	GAAACACCGGTTATCGTTACGGATTAGAGCTAGAAATAGCAAGTTAACCT	1	bc
CCTCATAAAC	GAAACACCGGTGTGCACAGAACGTTTTTGGGTTAGAGTTAGAAATAGCCA	1	bc
TATACATCAT	GAAACACCGGTTTAAAAAGTTAACTAGTGGGGTTAGAGCTAGAAATAGCA	1	bc
CAGATCACAA	GAAACACCGGTTGACTTTGTTAATTTGTGGGGTTAGAGCTATAAATAGCA	1	bc
ACCATCGCAT	GAAACACCGGTTCAACCGGCGTCTTTTGTGGGGGTAGAGCTAGAAATAGC	1	bc
GTACAACACG	GAAACACCGTTTGTAAGCGATGGTTTGTGGGGTTAGAGCTAGAAATAGCA	1	bc
TGCTCAGCTT	GAAACACCGGTCTTCATGGAATCGTGGGGTAGTGCTAGAGATAGAAAGTT	1	bc
ACGGCGGGGT	GAAACACCGGTCGTCGTTCGTAGGGCGTGGGGTTAGAGCTAGAAATAGCA	1	bc
GTGGTCGGGC	GAAACACCGGTGAGATGCTAGAAATAGCAAGGTTACATAAGGCTATTCCG	1	bc
GTCTTAACAA	GAAACACCGGTGCTAATAGATAGCTCGTGGGGTTAGAGCTGGAAATAGCA	1	bc
ACGTCATAAA	GAAACACCGGTTCAAACGGCGGCTTTGGCGGGGAAAGGGCAGATAACAGA	1	bc
ATCACCCCGA	GAAACACCGGTGTGCGGAGATTATGCGTGGGAAATAGCACGTAACCTAAG	1	bc
GTCTTCAACA	GAAACACCGGTGCTAGTAGTCAGCTCGTGGGGTTGGTACTAGAAGTAGCA	1	bc
TGTGGGAGAG	GAAACACCGGTGAGATGCGAGAAATAGCAGGTTAACATAAGGCTAGTCCG	1	bc
ATGGGAGAGT	CCAAACACCGGTGCTAGTGGTCTCCGGGTGTGGATAGAGCTAGAAATAGC	1	bc
AATATATCTA	GAAACACCGGTGAGAGAGGTTAGTGCTTGGGGTTGGAGCTTGAAATAGGA	1	bc
AGGTAAAGCG	GAAACACCGGTTATCGTTACTGATTAGAGCGATAAATGGCAAGATAACCA	1	bc
TCAGCAACCT	GAAACACCGGTGGGGTTTGAGCTAGAGATGGCTAGTTACCCTAAGTCTCG	1	bc
TTCCCCGCTT	GAAACACCTGTCTTCCTGATGTCGTGGGGTGGTGATAGAAATAACTAGTT	1	bc
AAAAGGGTAA	GAAACACCGGTTACGGGGAAATGGGAGAGGGAGAAATAGCAAGTTAACCT	1	bc
CGCCAGGTAA	GAAACACCGGTCCTCGTTACTTACGGGTGGGGTTAGAGCTAGAAATAGCA	1	bc
AAACGAGCAT	GAAACACCGGTGATAAGCGTTTGTCAGTGGGGGTAAGGATAGAAATTGGA	1	bc
AACCCGCCGC	GAAACACCTGTAGAATGGATCCACGGGTGGGGTTAGAGCTAGAAATAGCA	1	bc
TTCGCACAAA	GAAACACCGGTGGGGTTAGAGCTAGAAACAGCAAGTTAACATAAGGCTAG	1	bc
GCAGGAGAGA	GAAACACCGGTGGGGTTATAGCAAAAGCTAGCAAGTTAACGTCAGGCTCG	1	bc
AACCCGTAAC	GAAACACCGGTTCAACAGGCGTCTTATGTGGGGTTAGAGCTAGAAATAGC	1	bc
TAAACTTTCT	GAAACACCGGTTCCCGTTAGCTCGTAAGTGGGGTTAGAGCTAGACATCGC	1	bc
GTCTACGAGA	GAAACACCTGTACTAGTTACTTACGGGTGGGGATAGAGATAGAAATAGCA	1	bc
TGCCCTGCTT	GAAACACCGGTTCCCGTTGGTTCGTAGGGGGGGTTGGAGCTGAAATTGCA	1	bc
TGTCCATCTA	GAAACACCGGTCTTCCTGAGATCGAGGGGTAGAGCTAGAAATAAAGGCTT	1	bc
AAGTTAGCAC	GAAACACCGGTTCCCTTTACTCGTTTGTGGGGTTAGAGCTATAAATAGCA	1	bc
TTATTATATC	GAAACACCGGTTGAGATAATCAAAACGTTGGGTAGAGCTAGAAATAGCAC	1	bc
AATTTATCAA	GAAACACCGGTGAGAATGAAATCGTCATGGGGGATATAGCAAGAAAAAAT	1	bc
CTGAGCCGCC	GAAACACCGGTAGAATGAGTCCACGGGGTTGGTTAGAGCTAGGGCAAGCA	1	bc
CCGTGAGCTT	GAAACACCGGTTGTAGCGACTCCGTTGTGGGGTCAGAGCTAGAAATAGCA	1	bc
GCGTTAAGGG	GAAACACCGGCTATCGTTACGGCTTAGAGGGAGTAATATTAAGTTAACCT	1	bc
GGCTTCTCCC	GAAACACCGGTCGCGACCAGCCACTTGTGGGGTTAGAGCTAGAAATAGCA	1	bc
GAGTGCGTAA	GAAACACCGGTAAGATGCTAGAACTAGCAGGTTAACCTAAAGCTAGACCG	1	bc
GAGTACTACG	GAAACACCGGTTATCGCCACGGACTAGTGCTAGTAATAGTAGGTTTACCT	1	bc
GAATTTACCA	GAAACACCGGTGCTAATAAGTAGCTCGTGGCGAGAGAGCTAGAGATAACA	1	bc
TCACCGAATA	GAAACACCGGTGGGGTTAGAGCTAGAAATAGCAAGTTTACCTAAGGCTAG	1	bc
TGAACGTCGC	GAAACACCGGTCATAGAAGCTGAGGTTAGAGCTAGAAATAGCAAGTTAAC	1	bc
GACTTATACA	GAAACACCGGTGCTAATAGATAGCTCGTGGGGCTAAGGCTGGAAAGAGGA	1	bc
AGCTAGCAAA	GAAACACCGGTGTTCTTTGCTCGAGGGTGGGGTTAGAGATAGAAATAGCA	1	bc
CGAACACAAA	GAAACACCGGTGAGAACAGAAAGCTTTGGGGTTAGAGCTAGAAATAGCAA	1	bc
CGTAGTGTTT	GAAACACCGGTCGTCGTTCGTAGGGCGTGGGGTTAGAGCTAGAAATAGCA	1	bc
GGCACCTCAA	GAAACACCGGTGACAGCCAGCCACTTGTGGGGTTAGAGCTAGAAATAGCA	1	bc
CCGCCAATTC	GAAACACCTGTTGTCTTTCCTCCTTTGTGGGGTTAGAGCTCTAAATCGCA	1	bc
TAAGTAAAGC	GAAACAACGGCTGGGATAGACCTAGAAATCTCAAGTTAATCTAATGCTAG	1	bc
CAGTCATCAC	GAAACACCGGTGGGAATTAACCGTTTGTGGGGTTAGAGCAAAAATTAGAA	1	bc
CATCGGGATG	GAAACACCGGTGGCAATTCGTTTTGAGTGGGGTTAGAGCTAGAAATAGCA	1	bc
CCACCCCACC	GAAACACCGGTTGAATGGGTCGACTTGTGGGGTTAGAGCTAGAAATAGCA	1	bc
CAGACCCAAG	GAAACACCGGTGGCAGTAGGTCAGGAAAGAGCTAGTAACCCTAAGTCTAG	1	bc
GCCTTCATCC	GAAACACCGGTAATCTAAAGATCCTCGTGGGGATAGAGCTAGAAATAGCA	1	bc
AATAGGGTCA	GAAACACCGGTTGTGCGGGGCCCGGGGTGGGAGTAGTACCAAGTTAAGCT	1	bc
CGTTGACATA	GAAACACCGGTGGCCATTCGATCTGCGTGGGGTTAGAGCTAGAAATAGCA	1	bc
AATAAAGCAA	GAAACACCGGTGCCCTTTATGGGACCGTGGGGTTAGAGCTAGAATTAGCA	1	bc
GACATATACC	GAAACACCGGTAAGTGAAGGTAGAGCGAGGGATTGCAGGTTAGCCTAAGA	1	bc
GGCATTTATA	GAAACACCGGTGAGTGGGGTTAGAGCTAGACATAGCAAGTTAGCCTAAGG	1	bc
GCCGCCTACG	GAAACACCGGTGGCGGCAGAGCTATTGATGGCATGTTACTATAAAGATCA	1	bc
GATGGCGCAA	GAAACACCGGTTGTGGGGAACTCGGTGTGGGAGAAATAGCAAGTTAACCT	1	bc
GAGGGGGCGA	GAAACACCGGTGGGGTTGGAGTTGGAGAGATAGAGATAGCAAGTTGACCT	1	bc
TGAACAGATA	GAAACACCGGTCTTCTTAGAATCGGGGGGTGGAGCTAGACCTAGCAAGTT	1	bc
ACGTTGGCAA	GAAACACCGGTTGGCGTTACTACGTTGTGGGGTTAGAGCTATAAATAGCA	1	bc
AATTGGCCCC	GAAACACCGGTTGTGGGGGCCTCGGTGTGGGAGGAATAACATGTTAACCT	1	bc
TGATCCTAAT	GAAACACCGGTGTACTTAGTTAACTAGTGGGGTTAGAGCTAGAAATAGCA	1	bc
AATATGTCAA	GAAACACCGGTTGTGGGGAACTCGGTGTGGGAGAAATAGCAAGTTAACCT	1	bc
GAATCATAAC	GAAACACCGGTGCTAATAGTTAGCTCGTGGGGTTAGAGCTAGAAATAGCA	1	bc
GAACGGCAAC	GAAACACCGGTGGTGTGGGCTTGGGGGTGGGGGTAAAGCTAAGATAAGCT	1	bc
AACCTCCGCG	GAAACACCGGTTTTCAATCGTAAGTTAACCGATTAGTGCTACGTTTTCAA	1	bc
CCACGCCATA	GAAACACCGGTGGAATGGATCAAAGCTAGGGATTAGAACTTGACCTAGCA	1	bc
TCCTTCATCC	GAAACACAGGTTGAGGTCATCAACAAGTGGGGTAGAGCTAGAAATAGCCA	1	bc
AATCGCGGAA	GAAACACCGGTTGAGTGGATCCCGGGGTGGGAGTAATAGCAAGTTAACCT	1	bc
AATTAGACAC	GAAACACCGGTTGTCTTTAACTCGGTGTGGGGTTAGTAGTAAGATTAGCA	1	bc
GACAAACAAC	GAAACACCGGTAATCTAAAGATCCCCGTGGGGATAGAGCTAGAAATAGCA	1	bc
TACTTTGTCC	GAAACACCGGTACTGGTTACTTGCGGGTGGGGTTAGAGCTAGACATAGCA	1	bc
CCTCCATACC	GAAACACCGGTGAAAAAGTCGAAATATGAGGTTATACTACGACTAGTACG	1	bc
AATTGAGATA	GAAACACCGGTTGTGAGGAACACGGTGTGGGGGAATTGGCAGGTTACCAT	1	bc
TTAAACCCTC	GAAACACCGGTGACGCGAGGACGGTGGTGGGGTTAGAGCTAGAAATAGCA	1	bc
ACCGGCCGAC	GAAACACCGGTGGGGTTGTACCTGGGGTGGGGGTAGTGCTCGATATAGCA	1	bc
CATACGCTAA	GAAACACCGGTGGCAATTCGTACTGCGTGGGGTTAGAGCTAGAAATAGCA	1	bc
GAAGCATATA	GAAACACCGGTGAGCATGATAACGTCGTGGGGTTAGAGCTAGAAATAGCA	1	bc
GACGGGGAGA	GAAACACCGGTGTGATGCTAGAAATAGTGGGTTAACTTAAGGATAGACCG	1	bc
AGACAACCAA	GAAACACCGGTGTTCTTTGCTCGTGGGTGGGGTTAGAGATAGAAATAGAA	1	bc
TGTCCATAAC	GAAACACCGGTGACACACGTATGTCCGTGTGGTTAGGGCTGGAAATAGCA	1	bc
TATTCACATT	GAAACACCGGTGTCAATTCGATCTGAGTGGGGTTGGACTTGGAAAAACAA	1	bc
GAAAATTACA	AGGGCCGAACCACGGGTCACTGTGGTTAGACCTGGAGATAGCAATATAAC	1	bc
CTGAGAGTGT	GAAACACCTGTGCTAGCAGCTTCGATTTGGGGGTAGGGCTTGAAAAAAGC	1	bc
AATTCAAGAG	GAAACACCGGTTATAAACGAGTGTTAGTGGGGGTAATACTAGAAATAGCA	1	bc
CTCTCCCAGA	GAAACACCGGTGTGCGGAGATTATGCGTGAGAAATAGCAAGTAACCTAAG	1	bc
GGTTTGCCTG	GAAACACCGGTCGCCGTTCGTCGGGCGTGGGGTTAGAGCTAGAAATAGCA	1	bc
TGTTCAAATA	GAAACACCGGTCTTAATGGAATCGTGGGGGGGTGATAGAAATAGCAAGTT	1	bc
GAGATAAATA	GAAACACCGGTTATCATGATGGATTAGGGGGAGAAAGAGCAAGAAAACGT	1	bc
ATGCCACCAT	GAAACACCGGTTGTAAGCGATGGTTTGTGGGGTTAGAGCTAGAAATAGCA	1	bc
GCGGGCGACC	GAAACACCGGTGAGATGCTAGAAATAGCGAGATAACCTAAGGCTCTTCCG	1	bc
GTGCCCGATA	GAAACACCGGTGATATTCTAGAGATAGCGAGTTAACCTAAGGCTAGTCCG	1	bc
TGTACAGCCT	GAAACACCGGTCCTCCTGGAATCGTGGGGTAGAGCTAGAAATAGCAAGTT	1	bc
TTCTAAGCCA	GAAACACCGGTCTCGGTGATGTACGGGTGGGGTTAGCGCTGGAAATAAAA	1	bc
TGCACTGACA	GAAACACCGGTTCCCGTTAGCTCGTAAGTGGGGTTAGAGCTAGAAATAGC	1	bc
AAGTCATAAA	GAAACACCGGTGCGAATTCTAACTGTGGGGGTTTAGAGCTCAAAATAACA	1	bc
TATTCCCTAT	GAAACACCGGTGGCGCGGGACCCTGAGGGGGAGAAATAGCAAGTTAACCT	1	bc
CGGGCCGCGA	GAAACACCGGTGAGAACAGAACGTTTTGTGGTTAGTGCTAGTAATAGCTA	1	bc
ATGCAGCAGC	GAAACACCGGTGTTCTTTGCTCGAGGGTGGGGTTAGAGCTAGAAATAGCA	1	bc
GATTCATCAG	GAAACACCGGTGAGAACAGAACGTTTTGGGGTTATAGCTAGAAATAGCAA	1	bc
AAATTGGCCA	GAAACCCAGGTTGTGGTGAACTCGGTGTTGGAGAAATAGCAAGTTACCCT	1	bc
ATGTACGAGA	GAAACACCGGTGAGGTGCTATAAATAGCAAGGTAACCTAAGTCTAGTCCG	1	bc
GAGTCGGAGC	GAAACACCGGTTCAACCGGTCTCTTTTGCGGGGTTAGATCTAGAAAGAGC	1	bc
TGATTAACAC	GAAACACCGGTGGTCTTTGCTCGGGTGAGGGGTTGGAGCTATAAATAGAA	1	bc
GAAACGAGAT	GAAACACCGGTGCTAGCGGTATCTAAGTGGGGTTAGAGCTAGAAATAGCA	1	bc
ACAACGAGCT	GAAACCACGGTGCTAGCGGTTTCGAAGTGGGGTTAGAGCTAGAAATAGCA	1	bc
GACAATTCCA	GAAACACCGGTTCTAGTTACTTAAGGGCGGGGATAAAGAAAGTAATAGCG	1	bc
TCAAGCGATT	GAAACACCGGTGGGGTTAGAGCTAGAAATAGCAAGTTAACCTAAGGCTAG	1	bc
AAACCGCTTA	GAAACACCGGTGAGTTGGGTTAGAGCTAGAAATAGCAAGGTAACCTAAGG	1	bc
ATTCATCCAC	GAAACACCGGTGCTCTTTGTTCGAGGGTGGGGTTAGAGCTAGAAATAGCA	1	bc
AAATAATGTC	GAAACACCGGTGCCCTTTATGGGACCGTGGGGTTAGAGCTAGAAATAGCA	1	bc
CTGGGGGGAG	GAAACACCGGTGAGATGCTAGAAATAGCAAGTTAACCTAAGGCTAGTCCG	1	bc
GAGTTATCAA	GAAACACCGGCGCCAATCGTTTGTTCGTGGGGTTAGAGCTAGAAATAGCA	1	bc
AGACAGTATA	GAAACACCGGTGATCTTTGCACCATTAGGGGTTGAGAGCTAAGAGTAACA	1	bc
GTGATCGATA	GAAACACCGGTGAGAGGGGTTAAAGGTAGGAACAACAAGGTAAACTAAGG	1	bc
GGGCCATATT	GAAACACCGGTCTTTCTGGAAACGAGGGGTAGAGCTAGAAATAGCAAGAT	1	bc
CTACTAACGA	GCAACACCGGAAGGCTTTAGTCCTTTTTGGGGTTAGACGTTTAAAAAACG	1	bc
TATACATAAA	GAAACACCGGTTAGAACAGTTCGCTTGGGGGGTTAGACTAAAAAAAAGAA	1	bc
ATGACAGACA	GAAACACCGGTCCTAGAAGCTGAGGTTAGAGCTAGAAATAGCAAGTTAAC	1	bc
AGATAGCCGA	GAAACACCGGTGTGGTGTGATTATTCGTGGGAAATAGCGAGTAAACTAAG	1	bc
GCCCGAAGCG	GAAACACCGGTTATCGTTACGGATTAGAGCTAGAAATAGCAAGTTAACCT	1	bc
ATCACCGCCC	GAAACACCGGTCCTAGAAGCTGAGGTTAGAGCTAGAAATAGCAAGTTAAC	1	bc
CGACAACCAC	GAAACACCGGTGAGCTTTGCTCGAGGGGGGGGTTAGAGCTAGAAATAGCA	1	bc
AACCGGCGAC	GAAACACCGGTAGAATGGAACAACGGGTGGGGTTAGAGCTAGAAATAGCA	1	bc
GGATTATCTA	GACACACCGGTGAGTGGTGTTAGAGCTAGAAATAGCAAGCTAACCTGAGG	1	bc
CCGTTCGTCC	GAAACACCGGTCGTATTTACTCCTTTGTGGGGTTAGAGCTATAAATAGCA	1	bc
TGACCAAAAT	GAAACACCGGTCGGCCTGGAATCGGGGAGTGCAGCTAGAACTAGCAAGTT	1	bc
AATTTAACAC	GAAACACCGGTGACAAAAGTATGTCAGTGGGGTTAGAGCTAGAAATAGCA	1	bc
GACAAACATA	GAAACACCGTTGAGTGGGGTTAGAGCTAGAAAGAGCAAGATAAACTAAGG	1	bc
CGACTATCTC	GAAACACCGGTGACCGTGGTTAGAGCTAGGGGTAGCAGCTAGAACTAAGA	1	bc
AATTTAATAC	GAAACACCGGTTGAGATAATCAAAAAGTGGGGTAGAGCTAGAAATAGCAA	1	bc
ATCCCAGATT	GAAACACCGGTCTTACGGGATTCGTGGTGGGGAGATAGAAACAACTAGTT	1	bc
ACTTCGGCCA	GCAACACCGGTTGTGGGGAACTCGGTGTGGGAGTAGTAGCATAATCACCT	1	bc
TACACCCTAC	GAAACACCGGTAATCTAAAGATCCCCGTGGGGATCGAGCTCGAAATAGCA	1	bc
TGGATAACCT	GAAACACCGGTTGTGGTTATCTATTAGTGGGGTTGAGATCGAAAAAGACC	1	bc
GAGATAAGCA	GAAACACCGGTGAGTGGTGTGAGAGTTAGGGATTGCAAGTAAACCTAAGG	1	bc
GGGTGAGAGA	GAAACACCGGTGAGAAGCTAAAAGTAGCAAGTTAGACTAAGGCTAAGCAG	1	bc
GAAATACACA	GAAACACCGGTGCTAATAGTTAGCTCGTGGGAATAGAGATAGAAATAGCA	1	bc
GGCATTTCCA	GAAACACCGGTTCCCGTGATATCGTTAGAGGTGGTAGTGCTAGGAATAGC	1	bc
CACTTATCAA	GAAACACCGGTGAGAACAGAAAGTTTTGGGGTTAGAGCTAGAAATAACAA	1	bc
CCAACAGTCT	GAAACACCGGTGACAGGAGGACGGAGGGGGGGTTAGAGCTCAAAATAGCA	1	bc
GGTGGCGAAA	GAAACACCGGTGAGAACAGAACGTTTTGGGGTTAGAGCTAGAAAAAGCAA	1	bc
CCAGCGGAAA	GAAACACCGGTGTTGTTAGAACGAGGGAGGGATAGATAGAAAAATAACAA	1	bc
GAGTCACAGA	GAAACACCGGTGGCAATTCGATCTGAGGGGGGTGCGAGCTAGAGATAGTA	1	bc
AGATCACCCA	GAAACACCGGTTGTAAGCGAAGGTTTGTGGGGTAAAAGCTAAAATTACCA	1	bc
CGCTCCTACA	GAAACACCGGTGAGAACAGAACGTTTTGGGGTTAGAGCTAGAACTAGCAA	1	bc
TAAACAATCT	GAAACACCGGTGACGCGAGGAGGGTGGTGGGGATAGAGATAGAAATAGCA	1	bc
AGGTTGCCAC	GAAACACCGGTGTTCTTTGCTCGATGGTGGGGGTAAAGGCTAGAAAAAGC	1	bc
GATTCAAACA	GAAACACCGGTTATCGTTACGGATTAGAGCTAGAAATAGCAAGTTAACCT	1	bc
CGGCTATAAA	GAAACACCGGTGAGGATAGAACGATATGGGGGATGAGCAAAAAAAAGTAA	1	bc
AATAGGCAAA	GAAACACCGGTTGAGGGGGACTAGGTGTGGGAGTAATAGTAAGTAAACCT	1	bc
GCATCACACC	GAAACACCGGTTCAACCGGAGTCTTTTGTGGGGTTAGAGCTAGAAATAGC	1	bc
GACTTCTTCC	GAAACACCGGTACTAGAGAAATACCCGGTTAGCTTGAGCTAAAACTATTA	1	bc
CCGTCGAAAC	GAAACACCGGTTGGCTTTACTCCTTTGTGGGGTTAGAGCTATAAATAGCA	1	bc
ACACACCTAC	GAAACACCGGTGACGTGTGGACGGGGGTGGGGTTAGAGCTAGAAATAGCA	1	bc
GCGGCCAAGA	GAAACACCGGTGAGATGCTAGAAATAGCAAGTTAACCTAAGGCTAGTCCG	1	bc
AGACCAAGAG	GAAACACCGGTGTTCGTTGCTCGAGGTGGGGGGTAGAGCTTAGAATAACC	1	bc
TCGACCACAT	GAAACACCGGTTTACTTAGTTACCTTGTGGGGTTAGAGCTAGAAATAGAA	1	bc
CATTCACGCG	GAAACACCGGTTGAAATGCGCTTTGAGTGGGGTTTAAGCTGGAAATAGCA	1	bc
GAGATAAACA	GAAACACCGTTTATCGTTACGGATTAGAGCTAGAAATAGCGAGTTAACCT	1	bc
TTCTTCTCCA	GAAACACCGGTCGCGAAAATGAGACGGAGGGGTTAGAGCTAGAAATAGCA	1	bc
GGATCAGACT	GAAACACCGGTTTTAGTAAATTCGGGGTGGGGATATAGATATAAAAAGCT	1	bc
TGCCCATACT	GAAACACCGGTCTTCCTGGAATCGTGGGGTAGATCTAGAAATAGCAAGTT	1	bc
AACTAAACAC	GAAACACCGGTACGCCTTACTTACTTGTGGGGTTAGAGCTAGAAATAGCA	1	bc
TATCCAGAAA	GAAACACCGGTTGTGGGGGACTCGGAGCGGGAGAAATAGCAAGAGAATCT	1	bc
CAACAGCAAT	GAAACACCGGTGTTCTTTGCTCGGGAGGGGTGTTAAAGCTAGAAATAGCA	1	bc
ATCTTCTCCC	GAAACACCGGTCGCGAAAACGTGACGGTGGGGTTAGAGCTAGAAATAGCA	1	bc
CCGTGAAAAA	GAAACACCGGTGGGATTGACTCCTTTGTGGGGTTAGAGCTATAAATAGCA	1	bc
GCCAAAAAAG	GAAACACCGGTGGCAGCCAGGCAATTATGGGGTTAGAGCTAGAAATAGCA	1	bc
TAAATACACT	GAAACACCGGTGACAATAGGAAGGTGGTGGGGTTAGAGCTAGAAATATCA	1	bc
CATAGCGGCG	GAAACACCGGTGCGCTGGATTAGAGCGTGGGGTTAGAGCTAGAAATAGCA	1	bc
TATTTAGCAA	GAAACACCGGTTGTGGGGAACTCGGTGTGGGAGAAATAGCAAGTTAACCT	1	bc
TGTCCACACC	GAAACACCGGTCTTCTTGGGATCGCCGGGGGGAGAGAGCTATAGCAAGCT	1	bc
AACTTACTAA	GAAACACCGGTTTTCGATCATAGGTCGTGGGGTTAGAGCTAGAAATAGCA	1	bc
ACACTACACA	GAAACACCGGTGCTAATAGTTAGCTCGTGGGGTTAGAGCTAGAAATAGCA	1	bc
GCGTATGCAA	GAAACACCGGTACGAGTTACTTCCTGGTGGGGTTAGAGCTATAAATAGCA	1	bc
CAATGAAGAC	GAAACACCGGTTGGATTGGCTCCGAAGTGGGGTTAGAGCTAGAAATAGCA	1	bc
GAAACATTGA	GAAACACCGGTGTGGGGGGGTAGAGCTAGAAATAGCAAGTTAACCTAAGA	1	bc
TCAAAACTGT	GAAATACCTGTGACGCGAGGACGGTGGTGGTGTTAGAGCTAGAAATAGCA	1	bc
CATTTTACAA	GAAACACCGGTTGGCTTTACTCCTTTGTGGGGTTAGAGCTATAAATAGCA	1	bc
AGACCTTCCT	GAAACACCGGTTCCCGTTAGCTCGTAAGTGGGGTTAGAGCTAGAAATAGA	1	bc
AAACAATTAC	GAAACACCTGTGACAAACGTATGAAAGTGGGGTTAGAGCTGGAAATAGCA	1	bc
TCTTCAAAAT	GAAACACCGGTGTCCTTAGTAGGTTCGTGGGGTTAAAGCTAGAAAAAGCA	1	bc
CATTTACCAC	GACACACCGGTGGCCATTCGATCTTAGTGGGGTTAGAGCTAGAAATAGCA	1	bc
TAGTCATGCA	GAAACACCGGTTAGCATTATGGATTAGAGCGAGAGATAGCAAGGTAACAT	1	bc
GTGAGCGCGG	GAAACACCGGTGCGCTTCTTGAAATAGCAGGTTTACCTATGGCTAGTCCG	1	bc
TCGACAATCT	GAAACACCGGTTGTGATTATCAAAATGGGGGGTAGAGCTCGAGATAGCAC	1	bc
AGTCACTCAC	GAAACACCGGTAACAAACGGATGTCAGTGGGGATAGAGCTAGAAATAGCA	1	bc
GACCCAGTCC	GAAACACCGGTCATCTACGGATCTCCGTGGGGATAGAGCTAGAAATCGCA	1	bc
TAGGCCCTAT	GAAACACCGGTTACGTTAAGACCTTTGTGGGGTTAGAGCTATAAATAGCA	1	bc
GTGTTCTGCC	GAAACACCGGTTATCGTTACGGATTAGAGCTAGCAATAGCAAGTTAACCT	1	bc
AAATCAATCG	GAAACACCGGTTATCGCTGCAGGTTATAGGTATAGATATAGAATTAGCCT	1	bc
TAAGATAAAA	GAAACACCGGTGGGGGTAACGCTAGAGCTAGCAAGTTAACCTAAAGCTAG	1	bc
CCGTGATCAA	GAAACACCGGTGGTCGTTACTCGTGGGTGGGGTTAGAGCTAGAAATAGCA	1	bc
ATGTTCGTAC	GAAACACCGGTGCTAGAGAAATAAGAAGTTGAATTAAGGCATAACGGTTA	1	bc
ATACAATCTA	GAAACCCCGGTGAGAGGCGTTAGAGCTAGAAACAGCAAATTAACCTAAGG	1	bc
TAACTATATC	GAAACACCGGTCGAGAAGATGTGAAGGTGGGGTTAGAGCTAAAAATAGCA	1	bc
AATTAACAAC	GAAACACCGGTGGTCTTTGCTCGAGGGTGGGGTTAGAGCTAGAAATAGCA	1	bc
GTGTTCGTGA	GAAACACCGGTGAGGTTCTAGAAATAGCGGGGTAGCCTAAGGCTAGGCAG	1	bc
GGACTATATC	GAAACACCGGTGAGCATTCTAACGTCGTGTGGTTAGAGCTAGAAATAGCA	1	bc
AATCGACGCC	GAAACACCGGTGGAAAAGGTCTATCAGTGGGGTTAGAGCTAGAAATAGCA	1	bc
AACACACAAT	GAAACACCGGTGACATACGTATATCAGTGGGTTTAGAGTTAGAAATGGCA	1	bc
ACTGCTGCAG	GAAACACCGGTGCCCTTAGTGGTACCGTGGGGTTAGTGCTATAAAGATCA	1	bc
AACCGCCTCC	GAAACACCGGTAGAATGGATCCACGTTTGGGGTTGAAGCTAGAAATAGCA	1	bc
CCCCATCGCA	GAAACACCGGTACAATGGATCCACGGGTGGGGTTAGAGCTAGAAATAGCA	1	bc
CACCGCGCTT	GGAACACCGGTGCGCAAGATTTCGCCGTGGGGTTAGAGCTAGAAATAGCA	1	bc
GACTCCAACC	GAAACACCGGTGGTCTTAATTACCCCGTGGGGTTAGAGCTAGAAATAGCA	1	bc
CCATCGAACA	GATACACCGGTGGGGCCAGAGTTAGAATTAGCATGTTAACCGCACGTTAG	1	bc
GAAATCCAAC	GAAACACCGGTAAGCTGAGTTAGCGCGTGGGGTTACAGCTTGAAATAGCA	1	bc
GCCCGCGGAC	GACACACGGGAAGGATCCACGGGGGGGGGGAGAGATAGAGATAGCAAGCT	1	bc
GAACGCGGCC	GGAACAACGGTAGAATGGATCCACGGGTGGGGTTAGAGCTAGAAATAGCA	1	bc
AGTTAACCAA	GAAACACCGGTGAGCACAGAACATTTTGGGGTTAGAGCTAGAAATAGCAA	1	bc
TGAACTTACA	GAAACACCGGTTGCGGTTAGCTCGTAAGTGGGGATAGAGCTAGAAATAGG	1	bc
CATCGGGCCA	GAAACACCGGTAATCTAAAGATCCCCGTGGGGGTAGAGCTAGAAATAGCA	1	bc
CATTAAGCAA	GAAACACCGGTGGTGGGGGAGTCGGAGTGGGGGTAGTGCCAGGTTAAGCT	1	bc
AATGGGACGA	GAAACACCGGTTGGGGTAGAGTCAGAGATGGAGAGATAACAAGTGAACAG	1	bc
GGTGGCGCTA	GAAACACCGGTCATAGGCAAGACATAGTAAGTTAACCTTAGGCTGATCCT	1	bc
GTGAGCGTGT	GAAACACCGGTGAGATGCTAGAAATAGCAAGTTAACCTAAGGCTAGTCCG	1	bc
AAACCAGCCC	GAAACACCGGTGACAAACGTATGTCAGTGGGGTTAGAGCTAGAAATAGCA	1	bc
CGACTAAATT	GAAACACCGGTGCTAGCGGTTTCGAAGTGGGGTTAGAGCTAGGAATAGCA	1	bc
GGGTGGGCTG	GAAACACCGGTCTTCGTTCGTAGGGCGTGGGGTTAGAGCTAGAAATAGCA	1	bc
GTAACATCAA	CTAAACACCTGTGAGCACAGAAACTTTTGGTGTTAGAACTACAAATAGCA	1	bc
GTGTCAGTCG	GAAACACCGGTATTAGTAGCTGAGGATAGGGGTTAAAATAACAAGTTAAA	1	bc
GTCTAACCCG	GAAACACCGGTTTGAGGAGATGATGGTCGTGAAATAGCAAGTAACCTAAT	1	bc
AAATTACAAG	GAAACACCGGTGCTAATAGTTAGCTCGTGGGGTTAGAGCTAGAAATAGCA	1	bc
ACGTTCACCC	GAAACACCGGTTGTATTTACTCCTTTTGGGGGTTAGAGCTAAAAATAGCC	1	bc
AATCCCGTTT	GAAACACCGGTCTTCCTGGAATCGTGGGGTCGAGCTAGAAATAACAAGTT	1	bc
AGGCACGTCG	GAAACACCGGTCCTAGAAGCTGAGGTTAGAGCTAGCAATAGCAAGTTAAC	1	bc
GAGCCATACG	GAAACACCGGTTATCGTTACGGATTAGAGCGAGAAATAGCAGGATAACCA	1	bc
ATTTGACCAA	GAAACACCGGTTGGCGGGGACTATGCGTGGGAGATAGCACGAAACCTACT	1	bc
TAATTAGTTA	GAAACACCGGTTCTGGTAATTAACGGGTGGGGTTAGAGCTAGAAATAGCA	1	bc
AAGCCCTCCC	GAAACACCGGTGCCAAGCGTATGTCAGTGGGCTTAGAGCTGGAAATTGCA	1	bc
GAAACAAATG	GAAACACCGGTTAGCGGGGCTAGATTTAGAAATAGCAAGCTAACCATAGC	1	bc
GAGAAAAGCC	GAAACACCGGTAATCTAAACGGACTCGAGGTGGAAATAGCAAGTTAACCT	1	bc
CCATCAACAA	GAAACACCGGTGGGGTTAAAGCTTGAATTGGCAAATTAATATAAGGATCA	1	bc
GCCTTCCAAA	GAAACACCGGTGCTAATAGTTAGCTCGTGGGGTTAGAGCTAGAAATAGCA	1	bc
GGTATAGATA	GAAACACCGGTGAGTGGGGATCGTGGTAGAGATAGCAAGTTAAAGTAAGG	1	bc
GTCTAAAGCA	GAAACACCGGTGAGCGGTGCGTATGAGTGAGAGAAAGCACATAACAACCT	1	bc
AGCCAATATG	GAAACACCGGTGGCAGCCAGCCACTTGTGGGGTTAAACCAAGAACCAGCA	1	bc
TGCCCGTCAT	GAAACACCGGTTGCCGTTAGCTCGTAAGTGGGGAGAGAGATAGAAATAGC	1	bc
TGCAACAACA	GAAACACCGGTGGCGAGAGAGCGCGAGATAACATGAGAATCGACCGCTAG	1	bc
CAGCTAGTTG	GAAACACCGGTCGTCCTTGTTATGTCGTGGGGTTAGAGCTAGAAATAGCA	1	bc
CAGCCAGTAA	GAAACACCGGTCGTCGTTAAGTAAGAGAGAGCTAGATAACAGAAGTTGAG	1	bc
ATACAACAAA	GAAACACCGGTGTTCGTTGCTCGAGCGTGGGGTTAGAGCTAGAAATAGCA	1	bc
GTAAGGTATG	GAAACACCGGTCAGCGTGGGTAGAGCTAGAGATAGCAAGTTAACCTAAGG	1	bc
TTTCCCGACT	GCAACACCGGTCCTCCAGGATGCGTTGTGTGGATCTAGATAGAACTAGTT	1	bc
TCAGCCACAC	GAAACACCGGTGGGGTTAGAGCTAGAAATCGCAAGTTAACCTCCGGCTAT	1	bc
CGGTAAGCGA	GAAACACCGGTCGGCGGAGATGATGCGAGAGAAAGAGCAAGCAAGCTAAC	1	bc
GACTAAGTCC	GAAACACCGGTAATCTAAGGATCCCCGTGGGGATAGAGCTAGAAATAGCG	1	bc
AACTTCACTC	GAAACACCGGTCCTAGAAGCTGGGGTCTGGGCTTGACATAGCAAGCTAAC	1	bc
ATACTACCAC	GAAACACCGGTTGTCAGCGATGGTTTGTGGGGTTAGAGCTAGAAATAGCA	1	bc
TAAGGAATCA	GAAACACCGGTTGAGGTAGTCAAAAAGTGGGGTAGAGCTAGAAATAGCAA	1	bc
GACCCACTCC	GAAACACCGGTAGTATAAGGTGCCCTGTGGGGATAGAGCTAGAAATAGCA	1	bc
CACAGTGATT	GCAACACCGGCGCTCGCGGTTTCGAAGTGTGGTTAGAGCTAGAAATAGCA	1	bc
CCGTCGAAAC	GAAACACCGGTTCAACCGGCGTCTTTTGTGGGGTTAGAGTTTGAAATAGA	1	bc
ATCTTATCGC	GAAACACCTGTGACGAAAGTGTGTCAGTGGGTTAAGACTAGGAAATGGAA	1	bc
CGACCAATTG	GAAACACCGGTCGTAGTTCGTAGGCCGTGGGGTTAGAGCTCGAAATAGCC	1	bc
CGGCCCGTGA	GAAACGCCGGTTTAGGATGGTGGGGCGTGGGGTTAGAGCTAGAAATAGCA	1	bc
CCGACAAAAC	GAAACACCGGTTGGCTTTACTACTTAGTGGGGTTAGAGCTATAAATAGCA	1	bc
GATAATGAAG	GAAACACCGGTGAGCTTTATGGGAACGTGGGGTTAGAGCTAGAAATAGCA	1	bc
GACAATGGAT	GAAACACCGGTACTAGGGACTTACGTGTGGGTTTCGAGCTAGAAATAGCA	1	bc
AGTTCCTCCG	GAAACACCGGTGCGAAAAGCACGTTTTGGGGTTAGAGCTAGAGAAAGAAC	1	bc
GACCAAGTCC	GAAACACCGGTAATCTAAAGATCCCCGAGGGGTTAGAGCAAGAAATAGCA	1	bc
TAATAGGTAA	GAAACACCGGTACTAGTTACTTGCGGGTGGGGTTAAAGCTAGAAATAGCA	1	bc
TGTCCATCAT	GAAACACCGGTCTTCATGGTATGGCGGGGGAGCGCTAGAAATAGATAGTT	1	bc
ATGACAGACA	GAAACACCGGTGGGAGTAGATGAAGAGAGGGGATGGTGATCGAAAGAGAG	1	bc
GAGTAACCCG	GAAACACCGGTTATCGGTACGGATTAGAGCTAGAAATAGCAAGTTAACCT	1	bc
TAATCCGTCC	GAAACACCGGTTGAGATAGTCAGAAAGTGGGCTAGAGCTAGCAATATCAC	1	bc
GAGACCGGCG	GAAACACCGGTTATCGTTACGGATTAGAGCTAGAAATAGCAAGTTAACGT	1	bc
GATTAGGAAA	GAAACACCGGTACTAGTGACTTATGGGGGGGGTTAGAGCTAGATATAGGA	1	bc
ACCTTCACAC	GAAACACCGGTTTGCTTTACTCGTTTGTGGGGTTAGAGCTATAAATAGCA	1	bc
CCGCAACCAC	GAAACACCGGTTTGCTTTACTCCTTTGTGGGGTTAGAGCTATAAATAGCA	1	bc
CCGCTAACTG	GAAACACCGGTCGGCTTTAGTCCTTTGTGGGGTTAGAGCTATAAATAGCA	1	bc
TGTTAATAAA	GAAACACCGGTTAGATCAGAAAGTTTTGGGGTTAGAGCTAGAAATAGCGA	1	bc
CACAAGCACC	GAAACACCGGTTAAATAGACATCTTTTGGGGGGTTAGAGCTGGAAAAAGC	1	bc
AAATACGTAA	GAAACACCTGTACTGGATACTTAGGGGAGAGGTTAGAGCAAGAAATAGAA	1	bc
AAACGACCGT	GAAACACCGGTGCTAGCGGATTAGAAGTGGGGAATAACATGTAAATAGAG	1	bc
AATACAACCC	GAAACACCGGTGACAAACGTGGGGCAAGGGGGTGAAAGAGAGAAAGGGGA	1	bc
TGAGCATCAA	GAAACACCGGTGAGAACAGAACGTTTTGGGGTTAGAGCTAGAAATAGCAA	1	bc
GATTCAAACA	GAAACACCGGTGCTAATAGTTAGCTCGTGGGGTTAGAGCTAGAAATAGCA	1	bc
CATTCATACG	GAAACACCGGTGGCAATTCGATCTGTGTGGGGTTAGAGCTAGAAATAGCA	1	bc
CAACCACACG	GAAACACCGGTTGTAAGCGATGGTTTGTGGGGTTAGAGCTAGAAATAGCA	1	bc
ACAATGCTCG	GAAACACCGGTTTTCGATCATAGGTCGTGGGGTTAGAGCTAGAAATAGCA	1	bc
TGGATACCTG	GAAACACCGGTGAGTGGGGTTAGAGCTAGAAATAGCAAGATAACCTAAGG	1	bc
GGTTAATACG	GAAACACCGGTGGCAGCCAGCCACTTGTGGGGTTAGAGCTAGAAATAGCA	1	bc
TACAACTCCC	GAAACACCGGTAATCTAAAGATCCCCGTGGGGCTAGAGCTAGTAATAGCA	1	bc
TCAACTGCCA	GGAACACCGGTGGCGTTAGAGCTAGAAATGGCATGTTAACCTAAGGCTCG	1	bc
TACTTCGTAC	GAAACACCGGTCCTGGATACTTACGGGTGGGGTTAGAGCTAGAAATAGCA	1	bc
GAGTAACGGG	GAAACACCGGTTATCGGTGCGGATGAGAGCGAGAAAGAGCAAAATAACCG	1	bc
CCCCGGCTTG	GAAACACCGGTCGTCGGTCGAAGGGCTTGGGGTTAAGGCTAGAAATAGCC	1	bc
CTCTACCCGC	GAAACACCGGTGGAAGGCATCCACGTGTGGGTTTAGAGATAGAAATAGCA	1	bc
TATCCAGCAT	GAAACACCGGTCTTGCTGGACTCTAGGGGTGAGAATGACAAATTAACCTA	1	bc
AGACTCTGTC	GAAACACCGGTACTAGTTGCTTACGGGCTGGGATTAGGCAGGTAATCTCA	1	bc
GACTAAAACA	GAAACACCTGTGCTCTTAGGTAGCTCGTGGGGTTAGAGCTAGAAATAGCA	1	bc
CGCTCGTCCA	GAAACACCGGTGAGAGCTGGACGGTTTGGGGGTTAAGCTAGGAATAGCCA	1	bc
AAAACATCAA	GAAACACCGGTGACAAACGTATGTCAGTGGGGTTAGAGCTAGAAATAGTA	1	bc
TAATCAACAA	GAAACACCGGTGGTGGTAGAGCCAGAGAGAGCGAGTTAGCATAATACTAG	1	bc
AATTGCCCCC	GCAACACCGGTTGTGTGGAACTCGGGGTGGGAGTAATAGCAGGAAAACCT	1	bc
GGATTATCAA	GAAACACCGGTGAGAACAGAACGTTTTGGGGATAGAGCTAGAAATAGCAA	1	bc
CATCGTGACT	GAAACACCGGTTCTAGCTGTTTCGAAGTGGGGTTAGAGCTAGAAATAGCA	1	bc
AGACTTAAAA	GAAACACCGGTGCTAATAGTTAGCTCGTGGGGTTAGAGCTAGAAATAGCA	1	bc
CCCGGGCATC	GAAACACCGGTTGTGGTGGCGTGGGTGGGGGGGTTGAAGCTAGAAAAAAA	1	bc
GACGACGCGC	GAACCACCGGTAATCTAAAGATCCCCGTGGGGTTAGAGCTATAAATAGCA	1	bc
AATCCAGTGG	GAAACACCGGTGAGATTAGAGTGCCAGTGGGGTTAGAGCTAGAAATAGCA	1	bc
GAGGCAGGGG	GAAACACCGGTTATCGGGGCGGATTAGAGCTAGAAATAGCAAACTAACCT	1	bc
GCAATGTATC	GAAACACCGGTGAGTGGGGTTAGAGCTAGAAATAGCAAGTTAACATTAGG	1	bc
TTTTCACACA	GAAACACCGGTGGCAGTAGGTTCTGAGGGGGTTTGGGCCTGGAAATAGAA	1	bc
GTCTGCGAGC	GAAACACCGGTGCGATGCTCGTAATAGCAGGTTAAACTACGGCTAGTCCG	1	bc
TGCTTCTACC	GAAACACCGGTTGCAGCCATCCACTTGTGGGGATAGCTCTAGATATCACG	1	bc
CAACGCCTTC	GAAACACCGGTGATAGCGGTTTCGAAGCTGGGTTAGAGATAGTAATAGCA	1	bc
CGAAGGCATT	CTAAACACCGGTCGTCTTTCTTAGTTCGTGGGGTTAGAGCTAGAAATAGC	1	bc
AAAACGAAAA	GAAACACCGGTGGTGGTAGATAGAGAGAGGGCATAGAAACCGAAATCGAA	1	bc
AAACCAACAA	GAAACACCGGTGATAAAAGTATGCCCGTGGGGTTATAGCTAGAAATAGCA	1	bc
ATCCAAGAGA	GAAACACCGGTGTGCGGAGAATCTGCGTGAGAAATAGCTAGTAACATAAG	1	bc
AAACCAATCC	GAAACACCGGTGACGAAAGTAAATAAGTGGGGTTAGGGTAAGAAATGGAA	1	bc
TAAATCTATA	GAAACACCGGTGTGCGTAGTTAGAGATAGAAATTGCAACTTGAAATAAGG	1	bc
AAGCTAACAC	GAAACACCGGTTGGCTTTACTCCTTTGTGGGGTTAGAGCTATAAATAGCA	1	bc
TCGTTAAAAA	GAAACACCGGTGCTAATAGTTAGCTCGTGGGGTTAGAGCTATAAATAGCA	1	bc
AATTCGTTCC	GAAACACCGGTGAAAAACGTATGAAAGTGGGGTTAGAGCTAGAAATAGCA	1	bc
GGTATATCTA	GAAACACCGGTGAGCATGATACCGTCGTGGGGTTAGAGCTAGAAATAGCA	1	bc
TGCAATGCAT	GAAACACCGGTTCCAGTTAGCTCGTAAGGGGGGTTAGAGCTAGAAATAGC	1	bc
TCGGCCGTGT	GAAACACCGGTGAGACGCGATAAATAGCAAGATATCCTAAGGTAAGTCCG	1	bc
GGCTCACACG	GAAACACCGGTGGCAACCAGCCACTTGTGGGGTTAGAGCTAGAAATAGCA	1	bc
CGTTGGGTTA	GAAACACCGGTCGTCGCTGGAAGTTTTGGGGGTTAGACCTAGAATAAGCA	1	bc
CTCTACTCCT	GAAACACAGGTTCCCGGTAGTTCGTGGGGATGGAGATAGAAGTAGCTAAA	1	bc
TTTTCCTCAA	GTAACACCGGTGAGGACAGAACGTTTTGGGGTTAGAGCTAGAAATAACAA	1	bc
CAACCTAACC	GAAACACCGGTGGGCTGGGTCTATGCGTGGGGTTAGAGCTAGAAATAGCA	1	bc
CCGTTTAAAA	GAAACACCGGTACTCGTTACTTCTTGGTGGGGTTAGAGCTAGAAATAGCA	1	bc
AACTAATCAA	GAAACACCGGTGACAAACGTTTGTGCGTGGGGTTAGAGCTAGAACTGGCA	1	bc
GGGTCTGGCG	GAAACACCGGTTATAGTTACGGATTAGTGGTGGAAATAGCAAGTTAACCT	1	bc
AACTTCGCAC	GAAACACCGGTTCAACCGGCGTCTTTTGTGGGGTTAGAGCTAGAAATAGC	1	bc
GAGATAAGTG	GAAACACCGGTCATCGTTACGGATGAGAGCTATAAATATCAAGATAGCCT	1	bc
CTCTACCCGC	GAAACACCGGTAGGAGGGGATTACGGGTGGGGATTGGGCTGTAAATTACA	1	bc
ATGACATCAA	GAAACACCGGTGAGAAAAGAACGTTTTGGGGTTAGGGATAGAAATAGCAA	1	bc
GCCATCTATA	GAAACACCGGTGAGCATGATAACGTCGTGGGGTTCGAGCTAGAAATAGCC	1	bc
GGCTTCTCCC	GAAACACCGGTGGCGAAAATGTGCCTGTGGGGTTAGAGCTAGAAATAGCA	1	bc
TTACTCTATT	GAAACACCGGTGAGCCCTGTACGGGGGTGGGGTTAGAGCTAGAAATAGCA	1	bc
AACAATCTAA	GAAACACCGGTTTTCGATCTTAACGCGGGGGGTTAGAGCTAGAAATAGCA	1	bc
TCAGTAATAC	GAAACACCGGTGGGGTTAGAGCTAGAAATAGCAAGTTAACCTAAGGCTAG	1	bc
TCAACAATCC	GAAACACCGGTGATGCGAGGACGGTGGTGGGGTTAGAGCTAGAAATAGCA	1	bc
GTGCCACGCG	GAAACACCGGTTGTCAGCGCGGGTTTGTGGTGGTAATAGCAGAATTAGCT	1	bc
ATGACGGCCA	GAAACACGGGGTGTTGGAGATTCGGATAGGAAGTTAAACTAAGGCAACTC	1	bc
TGCTTCTCCC	GACACACCGGTTGCGAATATGTCCCGTAGGGATAGCACGTTAAACTATGA	1	bc
GGATCAGCAA	GAAACACCGGTGAGAACAGAAGGTGTTGGGGTTAGAACTAGAAATAGGAA	1	bc
GCGGCAAACT	GAAACACCGGTTAGCGTAAAGGATTAGAGCGAGAAATAGCAAATTACCCT	1	bc
GACTCCCAAC	GAAACACAGGTAATCTATCGATCTGAGTGGGGTTAGAGCTAGAAATAGCA	1	bc
GACAAATTCA	GAAACACCGGTGAGCATGATAACGTCGTGGGGTTAGAGCTAGAAATAGCA	1	bc
CTGTTCACCC	GAAACACCGGTTGGCTTTACTCCTTTGTGGGGTTAGAGCTATAAATAGCA	1	bc
AAACCAACAA	GAAACACCGGTGACAAACGTATGTTAGTGGGGTTAGAGCTAGAAATAGCA	1	bc
CGTTCACACC	GAAACACCGGTGGCCTTCGCTCCTTTGTGGGGTTAGAGCTATAAATAGCA	1	bc
ACAGCACACA	GAAACACCGGTGGGGTGAGAGGGATTGAGGGGATAGAGCTAGAAAGAGCA	1	bc
TGATCAGCTT	GAAACACCGGTCTTCCTGGAATCGAAGTGTAGAGATAGAAATAGCAAGTT	1	bc
CCTTCACGAC	GAAACACCGGTGGCAAGTCGATATGGGTGGGGTTAGAGCTAGAAATAGCA	1	bc
AGCAACTCGG	GAAACACCGGTGTCCGCAGATCACGTGTGGGAATTAGCAAGGAACCTAAG	1	bc
TCTCCAGACG	GAAACACCGGTGCTCTTTAAGGGAGGGGGGGGAGCTAGAAATAACTAGCT	1	bc
GGGACTTCGT	GAAACACCGGTTGGCGTTAGCTCGTAAGGTGAGAGATAGCAAAAGCAAGG	1	bc
CCAGCCAACA	GAAACACCGGTGAGGTTAGAGCTAGAATTAGCAAGTTAACCTAAGGCTAG	1	bc
TAAACAATAT	GAAACACCGGTGACGCGTGGACGGTGGTGGGGTTAGAGCTAGAAATAGCA	1	bc
ACCCACCGAC	GAAACACCGGTAGCCTTGATCCACGGGTGGGGTTATAGCTAGAAATCGCA	1	bc
AGAAAGCCCT	GAAACACCGGTGTTCTTTGCTTGAGGGTGGGGTTAGAGCTAGAAATAGCA	1	bc
GCACCACGCG	GAAACACCGGTTATCGGTACGGATTAGAGGGAGTAAAACTAAGAAAACCA	1	bc
ACCGCACCAA	GAAACACCGGTGTGGTTAGAGCTAGCAATAGCAAGTTAACCTAAGGCTAG	1	bc
TTATTCTCCC	GACACACCGGTGAGCATGATAACGTCCGTGGGGTTAGAGCTAGAAATAGC	1	bc
GAAATATACG	GAAACACCGGTGAGCTTTATAACGTCGTGGGGTTAGAGCTAGAAATAGCA	1	bc
AAGACCGCAG	GAAACACCGGTCCTAGAAGCTGAGGTTAGAGCTAGAAATAGCAAGAGAAC	1	bc
GGATTCCACA	GAAACACCGGTGCTAATAGTTAGCTCGTGGGGTTAGAGCTAGAAATATCA	1	bc
TGCCACCCAC	GAAACACCGGTTCAACCGGCGTCTTTTGTGGGGTTAGAGCTAGAAATAGC	1	bc
CTTGCACCTC	GAAACACCGGTTCCCGTTAGCTCGTAAGTGGGGTTAGAGCTAGAAATAGC	1	bc
ACAGCCGAAA	GAAACACCGGTGTGGTTAGATCTAGAGATGGCATAGTGATCGAAATCGAA	1	bc
AATTCCCCAA	GAAACACCGGTTGTCGGCGATTAGGAGTGGGGGTAGAGCTAAAATTACCA	1	bc
CCCACCGTCC	GAAACACCGGTCGTATGAGATCAGGGGAGGGTTAGAGGTAGAAATAAGAA	1	bc
TCAATAAATA	GAAACACTGGTGCTAATAGTTATATCATGAGCTTGTAGCTATAAGTCGAG	1	bc
GCCTCGAACG	GAAACACCGGTTAAACCGGCGTATTTTGTGGGGTTAGAGCTAGATATAGC	1	bc
GAATCTGAAA	GAAACACCGGTATACTTAATTAACGGGTGGGGTTAGAGCTAGAAATAGCA	1	bc
AACTCACCCG	GAGACACCGGTTTTCGGAGATTATGAGTGGGGTTTAGCATAGAAACTGCG	1	bc
TTTCCAGACG	GAAACACCGGTCCTGCAGGAATCGGGGGGGAGAGGTAGAAGTAGCAAAAT	1	bc
GCATAACCGA	GAAACACCGGTGTGCGGTGATTATGCGTGGGGAAAAAGAAGGAAACTGAG	1	bc
GAACACCTCA	GAAACACCGGTAATCTAAAGATCCCCGTGGGGATAGAGCTAGAAATAGCA	1	bc
GAAAAATACG	GAAACACCGGTGTCAGTAAGCCACTTGGGGGGAGAGAGCAAGAAATAGAA	1	bc
AACAGGGCCA	GAAACACCGGTTGCGTGGAACTCGGTGTGGGAGAAATAGCAAGTTAACCT	1	bc
CCCAGATGCC	GAAACACCGGTAGAATGGATACACGGGTGGGGTTAGAGCTAGAAATAGCA	1	bc
TGTGAGCGAG	GAAACACCGGTGACATGCAAGAAATAGCGGGTTAACAGATAGATAGTCCG	1	bc
GCAATAAACA	GAAACACCGGTGAGCGGGGCTAGAGCGAGGGATTGCAAGTTAACATAGCG	1	bc
ATAAAAGACT	GAAACACAGGTGGCCATTATGGGGCCGTGGGGTTAGAGCTAGAAATAACA	1	bc
TCCCCAGGCG	GAAACACCGGTAGACGTTGCAAATTTCCCGAAATATAGCTCGAAATCAAC	1	bc
AACCGGGTTG	CTAAACACCGGTTTTCGATCGTAGGTCGTGGGCTTAGAGCTAGAAGTTAC	1	bc
AATCCAGAAT	GAAACACCGGTCTTCCTGGAATCGTGGGGTGGAGCTAGAAATAGCAAGTT	1	bc
GAACTATCAA	GAAACACCGGTGACAAACGTAAGAGCGTGGGGTTGCAGATAGAAATAGGG	1	bc
GAATCCGTAA	GAAACACCGGTACTGGTTACTTACTGTAGGGCTTAGAGCTACAAATTGCA	1	bc
CTCTAACATT	GAAACACCGGTGTGCGGAGAATCTGCGTGGGAAATAGCAAGTAACCTAAG	1	bc
CTGCGGGATT	GAAACACCGGTCGTCGTTCGTAGGGCGTCGGGTTAGAGCTAGAAATAGCA	1	bc
CATCCCTCCC	GAAACACCGGCGACAAACGTCTGTCAGTGGGGTTAGAGGTAGGAATAGCA	1	bc
ATCCCATCCC	GAAACACCGGTCCCAGACGTGTGGTTGGGGGGATAAATCGCGAAATAACA	1	bc
TATTCAACAC	GAAACACCGGTGACAATTCGCTCTGAGTGGGGTTATAGCTAGAAATAGCA	1	bc
GGACAAGAAG	GAAACACCGGTGTTATTTGCTCGAGGGGGGTGGTTAGGGCTAGAAAAAGA	1	bc
GATACCCGCC	GAAACACCGGTCATATAAAGATCCGAGTGGGGATAGAGCTAGAAATTGCA	1	bc
ATGAACGACC	GAAACACCGGTCCTATAAGCTGAGGTTGGGGTTGGAAATAGCAGGTTAAC	1	bc
TTATAACTCT	GAAACACCGGTGACGCGAGGATGGGGGTGGGGTTTGAGCAAGAAACTGCA	1	bc
AAGATCGACA	GAAACACCTGTACTAGAAGCTAGCTCGTGGTATAGAGCGAGAAATAGCAT	1	bc
AAGTGAGCAC	GAAACACCGGTTGTGTGGAACTCGGTGTGGGAGAAATAGCAAGTTAACCT	1	bc
AACACCTTCC	GAAACACCGGTAATATACAGATCCCATTGGGGTTAGAGCTAGAAATAGCA	1	bc
AAAATATAAA	GAAACACCGGTGAGTGGGGTTAGAGCTAGAAATAGAAAGCTAACCTAAGG	1	bc
CATTAACCAC	GAAACACCGGTAATCTAACGATCCCCGTGGGGATAGAGCTAGAAATAGCA	1	bc
CGACAGGGAC	GAAACACCGGTGTTCTCGGCTCGAGGGTGGGGTTAGAGCTAGAAATAGCA	1	bc
GAGTTTGCAA	GAAACACCGGTAGTATTTACTTATTTGTGGGGTTAGAGCTAGAAATAGCA	1	bc
CCATAGGAAC	GGAACACCGGTTCAACCGGCGTCTTTTGGGGGGTTAGAGCTAGAAATAGA	1	bc
TAAATCCTCC	GAAACACCGGTTGCGATAGTCAAAAAGTGGGGCAGAGCTAGAAATAGCAA	1	bc
GAGTTATGTG	GAAACACCGGTTATCGTTACGGATTTTAGGGGTTGGAGGTTAAAATAGGA	1	bc
CCTTCCCACA	GAAACACCGGTGACAATTCGATCTGAGAGGTAGTAGAGGTAGGAATAGCA	1	bc
AAAACACTAG	GAAACACCGGTTTTAGATCATAGTGCGTGGGGTTAGAGCTAGAAATAGCA	1	bc
ATCTATGTCA	GAAACACCGGTACTAGTTACTTACGGGTGGGGTTAGAGCTAGAAATAGCA	1	bc
GCCTCTCTCC	GAAACACCGGTACTAGTTACTTACGGGTGGGGTTAGAGCTAGAAATAGCA	1	bc
AAAAAAAAAA	GAAACACCGGTGCCAATAGTTAGCTCGTGGGGTTAGAGCTAGAAATATCA	1	bc
GAGATCCCCC	GAAACACAGGTAATCTAAAGATCTCCGCGGGGATAGAGCTATAAATAGCA	1	bc
CGTTAAGAAA	GAAACACCGGTGAGAACAGAACGTTTTGGGGTTAGAGCTAGAAATAGCGA	1	bc
ATGTAGGCTG	GAAACACCGGTGGGCGGTGGTTGTGCGTGGGAATTAGCAAGGAACCTACG	1	bc
ACTTAGGAAC	GAAACACCGGTTGTCTGTGCCTCGGGGTGGGAGTAATAGCAAATTTACCT	1	bc
ATCAACCACG	GAAACACCGGTGTCAGCCAGCCACTTGTGGGGTTAAAGCTATAAATTGCA	1	bc
AATTATCAAA	GAAACACCGGTGGCAATTAGATCTGAGTGGGGTTAGAGCTAGAAATAGCA	1	bc
AAACGGGAAA	GAAACACCGGTGGTGGGGGATTCGGAGTGGGAGTAGTACTAGGAAAAGCA	1	bc
TCACCAGAAT	GAAACACCGGTGGTGGTAGAGCTAGAAATAGCAAGGTAACCTAAAGCTAG	1	bc
TCAACATATA	GAAACACCGGTGAGGGGGGTTATAGCTCTAGATAGCTAGTTATCCTCTAG	1	bc
GCGTGACGCG	GACACACCGGTTAGCAATGCGAAGTAAAGCTAAAACTAGCCAGTTATCAA	1	bc
TTGTTAGTCC	GAAACACCGGTTGAGATAATTAGAGATTGGGATAGATCTAGAAATATCAA	1	bc
CCTTCCCTCT	GAAACACCGGTGGCAATTCGATCTGAGTGGGGTTAGAGCTAGAAATAGCA	1	bc
GAGTCACAAG	GAAACACCGGTTATCGTTACGGATTAGAGCTAGTAAAAGCAAGATAACCT	1	bc
AGACAAGATT	GAAACACCGGTGCTCGTTTCTTGAGGGTGGGGGTAGAGGTAGAAATAGTA	1	bc
AAATTGACAA	GAAACACCGGTTGTGGGGAACTCGGTGTGGGAGAAATAGCAAGTTAACCT	1	bc
GAGTCCCTCG	GAAACACCGGTTATCGTTACGGATTAGAGCTAGAAATAGCAAGTTAACCT	1	bc
GAGTCGAGAA	GAAACACCGGTTATCGTTACGGATTAGAGCGAGAAATACCAAGTTAACCT	1	bc
GTCAATCACG	GAAACACCGGTGGCAGCCAGCCACTTGTGGGGTTAGAGCTAGAAATAGCA	1	bc
AGCTTGGCAA	GAAACACCGGTTGTGGGGAATTCGGTGTGGGAGAAATAGAATAATAACCT	1	bc
TACTGCCTAA	GAAACACCGGTTATGAGAAGCAAGTAGTGGGAAAAAGAGTAATTAAACAA	1	bc
CATCCGTCAA	GAAACACCGGTGCCAAACGTATGTCAGTGGGGTTAGAGCTAGAAATAGCA	1	bc
GACAACACAC	GAACCACCGGTAATCTAACGATCCCCGTGGGGTTAGAGCTAGAAATAGCA	1	bc
GTGTTAAACG	GAAACACCGGTTATCGTTATGGATTAGAGGGAGAAATAGCAAGATAACCT	1	bc
GAGACCCGCC	GAAACACCGGTAATCTAAAGATCCCCGTGGGAGTAATACTAAGAATAGCT	1	bc
TCAACCGATT	GAAACACCGGTCTTCCTGGTATCGTGGGGTAGAGCTAGAAATAGCAAGTT	1	bc
AGCAATTCCG	GAAACACCGGTTCCCTTTATCTCGTAGGGGGGGTTAGAGCTAGAATTAGC	1	bc
TAACCAACCT	GAAACACCGGTTGGGTTAGTGTTAGAGGGAGCAAGCTAACATAAGCCTAA	1	bc
ATGATAATCC	GAAACACCGGTCGTCTAAACTGCTTTTTGGGCTTAGAGTTACAAGTTACA	1	bc
ACGTCGCTCA	GAAACACCGGTCCTAGAAGCTGAGGTGAGGGCTTGAAACAAGAAGTACAC	1	bc
GACTTACTAA	GAAACACCGGTAATCTAAAGATCCCCGTGGGGATATAGCTAGAAATAGCA	1	bc
CTCCGATCTT	GAAACACCGGTGCTCGCGATTTCGCAGTGGGGTTAGAGCTAGAAATAGCA	1	bc
GTGATAAGCA	GAAACACCGGTCGTCGTTAGTAGGGGTGGGGTTAGAGCTAGAAATAGCAA	1	bc
GTACCCGAGA	GAAACACCGGTGAGATGCTAGAAATAGCAGGTTTACCTAAGGCTAGACCG	1	bc
AACTGCGCAT	GAAACACCGGTTGTGGGGAACTCCGTGTGGGAGAAATAGCCAGTTAACCT	1	bc
AACTGGCCGA	GAAACACCGGTTGTGGGGGATTCGGCGCGGGAGATAGAGAGAGATCTCAT	1	bc
CGACGCCACC	GAAACACCGGTGTAATGGATCCACGGGTGGGGTTAGAGCTAGAAATAGCA	1	bc
AGTCAATAAT	GAAACACCGGTCTGAATGGAATCGTGAGGGAGATCTGGAAATAACAAGTT	1	bc
CATCGGGCTT	GAAACACCGGTGCTAGCGGTTTCGAAGTGGGGTTAGAGCTAGATATAGCA	1	bc
GTGTTAGAGA	GAAACACCGGTTGGGTGCTAGACATAGCGGGGTAACCTAAGAAAAGACCG	1	bc
CACTCTGTCA	GAAACACCGGTACTATTTACTTACGGGTGGGGTTAGAGCTAGAAATAGCA	1	bc
TCAGCACCAC	GAAACACCGGTGGGGTTAGAGCTAGAGATGGCAAGTTAACATAAAGATAG	1	bc
CCACCCCGCG	GAAACACCGGTTGAATGGATCCACGGGTGGGGTTAGAGCTCGAAATAGCA	1	bc
AATCCCCTAT	GAAACACCGGTGACAAGCGGACGTCTGTGGGGTTAGAGCTAGAAATAGCA	1	bc
GTATTCTCTA	GAAACACCGGTGAGTGGGGTTAGAGTTAGAATTAACATAGTAACCTAAGG	1	bc
AAATGAGTAA	GAAACACCGGTTGGGGGGAACTAGGTGTGGGAGAAATATAGAGATATCCG	1	bc
CGGCGGTCTT	GAAACACCGGTCGTCGTTCGTAGGGCGTGGGGTTACAACTTGACCTAGGG	1	bc
CATAAACATA	GAAACACCGGTGGCAATTCGATCTGAGTGGGGTTAGAGCTAGAAATAGCA	1	bc
GTGACAGGCG	GAAACACCGGTTAGCGTAAAGGATTAAAGCTAGAAATAGCCAGTTAACCT	1	bc
GAGCCCAACG	GAAACACCGGTGGCCGCCAGGCACTTGTGGGGTTAGAGCTAGAAATAGCA	1	bc
GCATCTAAAA	GAAACACCGGTGCTGATAGTGAGCTGGTGGGGTTAGAGCTAGAAATAGAA	1	bc
AGAACTATAT	GAAACACCGGTGCGTGGGCTAGAGCTCGAGATAGCAAGGTAACCTCAGGC	1	bc
GGAGGCGAGG	GAAACACCGGTGTGATGCTAGAAATAGCAGGTTAACATATAGCAAGACCA	1	bc
AACTAAAAGA	GAAACACCGGTGCGCAGAGATTGTGCGTGAGAAATAGCAAATAACCTAAG	1	bc
CCACGGCTTT	GAAACACCGGTCATCGTTCGTCGGGGGTGGGGTTAGAGCTAGAAATAGCA	1	bc
CCCTTACCCC	GAAACACCGGTTGGCTTTACTCCTTTGTGGGGTTTGAGCTATAAATAGCC	1	bc
AGCCGGCGAC	GAAACACCGGTGGTATTGGCCCGCGGGTGGTGTTAGAGCTAGAAATAGCA	1	bc
AATTCGCCCA	GAAACACCGGTGACGCGAGGACGTTAGAGCTAGAAATAGCAAGTTAACCT	1	bc
ATGAAAGCGA	GAAACACCGGTGTGCGGAGATGAGGTGTGAGAAATAGCAAGAAACCTAAG	1	bc
CAAATCCTTT	GAAACACCGGTGCTCTAGGGTTCGAAGTGGGGATAGAGCTAGAAATAGCA	1	bc
GGCTCTTCAT	GAAACACAGGTGCTAATAGTTAGCTCGTGGGGTTAGAGCTAGAAATAGCA	1	bc
AGTTGAGCTA	GAAACACCGGTTGTGGCGGTCTCGGTGTGGGGTCAATAGCAGGTTAACCT	1	bc
ATTTCCTCCA	GAAACACCGGTGGGGAGAGACACGGGTTGGAAGTAAAAATAAGTTGATAT	1	bc
GACTTAAGCA	GAAACACCGGGGCTTATAGCTAGCTCGTGGGGGTAGACCTAGGGCTAGCC	1	bc
AGGACCGCCT	GAAACACCGGTCCTAGAAGCTGAGTTTAGAGCTAGAGATAGCAAGATAAC	1	bc
GATTCTGCAA	GAAACACCGGTACTAGTTACTTACGGGTGGGGTTAGAGCTAGAAATAGCA	1	bc
TGGGGCAAGA	GAAACACCGGTGGGGTGCTAGAAATAGCAAGTTAACCAAATGATAGTCAG	1	bc
AAATTAACAC	GAAACACCGGTGCTAATAGTTAGCTCGTGGGGTTAGAGCTAGAAATAGCA	1	bc
TATACCGCAT	GAAACACCGGTTTAGTTAGATAACTAGTGGGGGTAAAACTAGAAAAAGCA	1	bc
TTCACTACCG	GAAACACCGGTTCTCGTTACGGCGTTGTGGGGTTAAGGGCTGAAATAGCC	1	bc
GGAATCTACA	GAAACACCGGTGAGTGGGGATAGAGCCAGAAATAGCAAGTTAACCGAAGG	1	bc
AATCACTCCG	GAAACACCGGTGACAGACGGATGTCAGTGGGGTTAGAGCTAGAAATAGCA	1	bc
GAGTAAATCA	GAAACACCGGTTATCGTTACGGATGAGAGCTAGGAATAGCAAGATAACCT	1	bc
AATACTCACT	GAAACACCGGTTGCCTTTGTTGGACCGTGGGGTTAGAGCTAGAAATAGCA	1	bc
AGGTAGCAAG	GAAACACCGGTTATCGTTGCGGATTAGAGCTAGTAATAGCAAGTTAACCT	1	bc
TATCCTGCTT	GAAACACCGGCCTCCTTGGTGTCGTCGCGGGGATCTAGAAATAGCAAGTT	1	bc
CTCTGACGCC	GAAACACCGGTAGCAAGGAGCTACGGGTGGGGTTAGAGCTAGAAATAGCA	1	bc
AATCACTCGA	GAAACACCGGTGACCAACGTATGTCGGTGGGGAAAGAGCTGGAAATAAAA	1	bc
CGTACGTTAA	GAAACACCGGTGAGAACAGAACGTTTTGGGGTTAGAGATAGAAATAGCAA	1	bc
AAACTAATGC	GAAACACCGGTTGAGTTAATCAAAATGGGGGGAGGAGTTAGAAATTAAAC	1	bc
GGGCAGCAGC	GAAACACCGGTGATATGATAGAAATAGCAGGGTAACAGAAGGCGATAGCG	1	bc
ATACTCTACT	GAAACACCGGTTGTAAGAGATGGATTGTGGGTTTAGAGTTAGAAATAGAA	1	bc
GGGAGCGATG	GAAACACCGGTCGTCGTTCGTAGGGCGTGGGGTTAGAGCTATAAATAGCA	1	bc
CGCCGCGGTC	GAAACACCGGTAGAATGGATCCACTGGTGGGGTTAGAGCTAGAAATAGCA	1	bc
GAATCTGTAC	GAAACACCGGTACTAGTTACTTGCGGGTGGGGTTAGAGCTAGAAATAGCA	1	bc
GGCTCTGCAT	GAAACACCGGTTCCCGTTAGCTCGGAGGTGGGGTTAGAGCTGGAAATAGC	1	bc
GTAATCCCCA	GAAACACCGGTGACCCTGGTAACATCGCGGGGTTAGGGCTGGAAACCGCA	1	bc
AAACTAACAA	GAAACACCGGTGCTAATAGTTAGCTCGTGGGGTTAGAGCTAGAAATAGCA	1	bc
CCCCACCATC	GAAACACCGGTAGAAGGGGTCTACGAGTGGGGTTAGAGCTATAAATAGCA	1	bc
AGACAACATT	GAAACACCGGTTGTAAGCGATGGGTTGTGGGGTTAGAGCTAGAAATAGCA	1	bc
AATCATGTAA	GAAACACCGGTACTAGTCACTTACGGGTGGGGTTAGAGCTAGAAATAGCA	1	bc
GACTCATCCA	GAAACACCGGTAATAAATAGATACCCGTGGGGATAGAGCTAGAAATAGCA	1	bc
CGCAGTCGCC	GAAACACCGGTAGAATGGATCCACGGGTGGGGTTAGAGCTAGAAATAGCA	1	bc
CATCCCCGCC	GAAACACCGGTAGAATGGATCCACGGGTGGGGCTAGAGCTAGAAATAGCA	1	bc
TGAAAGCCAC	GAAACACCGGTGCCCTTTACTCGATAGTGGGGTTAGAGCTAGAAATAGCA	1	bc
GTGTGAGAGC	GAAACACCGGTGAGCTGTTAGAAATAGCACGTTAACTAAAGGCTAGACCG	1	bc
ATGCCACCCC	GAAACACCTGTTGGCTTCACTGGTTTGTGGGGTTAGAGCTATAAATAGCA	1	bc
TCATCAATCA	GAAACACCGGTGGGGTTAGCGCTAGAAATAGCAAGTTAACCTAAGGCTAG	1	bc
TCAGCCAACG	GAAACACCGGTGGGAGTAGAGCTATAGATGGCAAGTTAACCTAAGGATAG	1	bc
AATTGGCCGC	GAAACACCGGTTGATGGTTACTCTGCGTGGGAGCAAGAGCAAGTTAACCT	1	bc
ATGCCACTCG	GAAACACCGGTCCTAAGCGCTGGGGTGCGGGCTTGAAGTAGCAAGTTGAA	1	bc
CTTTCGCACA	GAAACACCGGTGGCAATTCGATCTGAGGTGGGTTAGAGCTAGAAATAGCA	1	bc
AACTCTTTAC	GAAACACCGGTGACAAACGTATGCCAGTGGGGTTAGAGCTAGAAATAGCA	1	bc
CGTTCAGAAC	GAAACACCGGTCGTCATTGGATCGGGGTGGGGATCTAGAAAGAAATAGCT	1	bc
TACCTAAGCC	AAGAGGTAACAACAGCAGGATAACTCCACGCTTGGCCGTTGTCATCTAAA	1	bc
GAGCCAGGCT	GAAACACCGGTTATCGTTACGGATTAGAGCTAGAAATAGCAAGTTAACCT	1	bc
AACAACCTGA	GAAACACCGGTGTAGAATGTAGGGAAGTGGGGTTAGAGCTAGAAATAGAA	1	bc
TCAACAACCT	GAAACACCGGTGGGGGTAGAGCCAGGAATAGCGAGCTAACCTAAGCCTAT	1	bc
TAATATATGC	GAAACACCGGTTTAGTTTGTTAGAGCTGGGAATAGAAAGTCAAGCTAACC	1	bc
CAGTGAAAAA	GAAACACAGGTGGCAGTTAGATCTGAGTGGGGTTAGAGCTAGAAATAGCA	1	bc
ATGTTCGAAA	GAAACACCGGTGCTAGAAGTTAAGTCGGGGGGAGAAAGATAAAGATAACA	1	bc
CATACTGACG	GAAACACCGGTGGCATTTCGATCTGCGTGGGGTTAGAGCTAGAAATAGCA	1	bc
AATTGGTCCC	GAAACACCGGTTGTGGGGATCTCGGTGTGGGAGTAATAGCAGGTTCACCT	1	bc
GAGTCGACAA	GAAACACCGGTTATCGTTACGTAGTAGAGCTAGAAATAGCAAGTTAACCT	1	bc
CGGCTAAAAC	GAAACACCGGTTGTCTTTACTCCTTTGTGGGGTTAGAGCTATAAAAAGCA	1	bc
GTACAACATC	GAAACACCGGTGAGTGGGGTTAGAGCTAGAAATAGCAAGTTAAACTAATG	1	bc
ATTTAATCAA	GACACACCGGTGTGCGGAGATTGTGCGTGGGATATAGCAAGTAACCTAAG	1	bc
GTGTAAGGCG	GAAACACCGGTTATCGTTGCGGATTAGAGCTAGAAATAGCAAGTCAACCT	1	bc
CGGTAGACAC	GAAACACCGGTGTTCTTTGCTCGAGGGTGGGGTTAGAGCTAGAAATAGCA	1	bc
CACTAGCTCC	GAAACACCGGTCATATAAAGATCCCCGTGGGGATAGAGATAGAAATAGAA	1	bc
GAATCATGTA	GAAACACCGGTTAGCGTTACGGCTTAGAGGGGGTAATAGCAAGATAACCT	1	bc
GACTTAATCA	GAAACACCGGTAATCTAAAGATCCCCGTGGGGTTAGAGATAGAAATAGCA	1	bc
ATTTACTCAA	GAAACACCGGTGAGAACAGAACGTTTTGGGGTTAGAGCTAGAAATAGCAA	1	bc
GAAATAGACA	GAAACACCGGTGAGCGGGGGTAGAGCTAGAAATAGCAAGTTAACCTAAGG	1	bc
ATGTCAGTCA	GAAACACCGGTCCTAGGAGCTGATGTGAGAGCTAGAGATAGCAAGTTAAC	1	bc
AATACTTCCC	GAAACACCGGTGACCAACATCTCTCAGGGGGATTAGAGGTAATAGTAGCA	1	bc
TCCGCCGAAA	GAAACACCGGTGGGGTTAGAGCTCGAAGTGGGAAGTTAACATAAGGCGCG	1	bc
GACAACGACA	GAAACACCGGTGGCAGCCAGCCACTTGTGGGGTTAGAGCTAGAAATAGCA	1	bc
CCTAGCACCC	GAAACACCGGTTCAACCGGCGTCTTTTGTGGGGTTAGAGCTAGAAATAGC	1	bc
TAAATAATAG	GAAACACCGGTCGAGATAATCAAAAAGTGGGGTAGAGCTAGAAATAGCAA	1	bc
GTGTTCATCA	GAAACACCGGTGAGAACAGAACGTTTTGGGGTTAGAGCTAGGAATAGCAA	1	bc
CGACCGTAAC	GAAACACCGGTGGGCTTAGCTCGAGTGGGGGTTTGAGCCAGGAAATACCA	1	bc
ATACTACATA	GAACCCCGGGGAGCATGATAAGGTCTTTGGGTTAGAGCTTAAAATAGCAA	1	bc
ATACTATACC	GAAACACCGGTTGTGAGCGATGGTTTGTGGGGTTAGAGCTAGAAATAGCA	1	bc
CAACCAGTAT	GAAACACCGGTGACACCAGAGTTAAAGCTGGAATTAACCCGAAAACTTCA	1	bc
AAATAAGAAA	GAAACACCGGTACTAAGCGATTATGGGTGGGGTTAGAGCTAGAAATAGAA	1	bc
GGAAAATACT	GAAACACCGGTGTCAGTCAGCCACTTGGGGGGTTAGAGCTAGAAATAGCA	1	bc
GCATTAAACC	GAAACACCGGTGCTAATAGTTAGCTCGTGGGGTTAGAGCTAGAAATAGCA	1	bc
AAGACCTCAC	GAAACACCGGCGACAGAAGTAGGGCAGTGGGGTTAGAGCTAGAAATAGCA	1	bc
CAACCATATA	GAAACACCGGTGCGAACAGAACGGTTTGGGGTTAGAGCTAGAAATAGCAA	1	bc
CATACCCCAC	GAAACACCGGTGTAACACGTCTATCAGTGGGTTTAGAGCTTGAAATAGCA	1	bc
GATTGAGCCC	GAAACACCGGTTGTGGGGAACTCGGTGTGGGAGTAATATCAAGTTAACCT	1	bc
CAGCGAACTC	GAAACACCGGTGCTCGTGGCTTCTTTGTGGGGTTAGAGCTAGAAATAGCA	1	bc
ATAACAGTGG	GAAACACCGGTCCTAGAAGCTTAGGTTAGAGCTAGAGCTAGCAAGTTAAC	1	bc
TACACACTCC	GAAACACCGGTTATCTTAAGCTCACCGTGGGGTTAAGCTAGGAATAGCCA	1	bc
CCACGGAGCC	GAAACACCGGTCATCGTTCGAAATAGGTGGGTTTCTAGCTGGACGTCGGA	1	bc
CCCTGTGGCC	GAAACACCGGTAGAAGGTATCCACGGGTGGGGTTAGAGCTAGAAATAGCA	1	bc
AGTTCCTCCA	GAAACACCGGTGAGAACAGAACGTTTTGGGGTTAGAGCTAGAAATAGCAA	1	bc
CGGACACACG	GAAACACCGGTGGCAGCCCGTTCGTTGTGGGGTTAGAGCTGGTAATAGCA	1	bc
GAGCCAGATG	GAAACACCGGTCTTCCTTGAAGCGTGGGGTAGAGCTAGAAATAGCAAGGT	1	bc
TGCTTCGCCC	GAAGGAAGGAAGCAACAGCCTTCCTGGAGAGAAAAGATGTTAATCGAAAG	1	bc
AGTAATATCT	GAAACACCGGTGAGTGGGGTTAGAGCTAGAGATAGCAAGTTAACCTAAGG	1	bc
TGCTCTACAT	GAAACACCGGTTCCCGTTAGCTCGGAGGTGGGGTTAGAGCAGAAAATAGC	1	bc
AATTCCCTAA	GAAACACCGGTGGCAATTCGATCTGAGTGGGGTTAGAGCTAGAAATAGCA	1	bc
TCACGCCAAT	GAAACACCGGTAGAATGGATCCACGGGTGGGGTTAGAGCTAGAAATAGCA	1	bc
ATCTACGCCC	GAAACACCGGTGCCCTTTATGTGACCGTGGGGTTAGAGCTAGAAATAGCA	1	bc
AATTGATCCC	GAAACACCGGTTGCGAGGAACTCGGTGTGGGGGAAATAGCAAGATAACCT	1	bc
AAACAGATAC	GAAACACCGGTGTTCTTTGCTCGAGGGTGGGGTTAGAGCTAGAAATAGCA	1	bc
ATGAAAGCGA	GAAACACCGGTGTGCGGAGATTATGCGTGAGAAACAACAAATAACCAGAG	1	bc
ATCTCCGCCG	GAAACACCGGTCCTAGAAGCTGAGGTTAGAGCTATAGATAGCAAGCTAAC	1	bc
CCCCCAGTCC	GAAACACAGGTAGAATGGATCCACGGGTGGGGTTAGAGCTAGAAATAGCA	1	bc
