AAACCCACGA	GAAACACCGGTTTTGTTTGTGTCGATGTGGGTTGAAATTGCAAGTTAACC	1
AAACCCATGA	GAAACACCGGTTTAGTATGGAGGGGTTAGAGCTAGAAATAGCAAGTTAAC	1
AAACCGAACC	GAAACACCGGTTCAACCGGCGTCTTTTGTGGGGTTAGAGCTAGAAATAGC	1
AACATGTATA	GAAACACCGGTTTTCGTGCTTACGTCGGGGGGGTTGAGGCTGAAATTGGA	1
AAGACCGCCG	GAAACACCGGTGCCATTAGTGGGGCCGAGGGGTTAGAGCTAGAAATAGCA	1
AATAATGCCG	GAAACACCGGTGACAAACATATGTCAGTGGGGTTAGAGCTAGAAATAGCA	1
AATCATCCCG	GAAACACCGGTGCCCTTTGTGCGACGGTGGGGTTAGAGCTAGAAATAGCA	1
AATCCAGTGG	GAAACACCGGTTTAGTATGTGGGGTTGGGGGGAGAAATATAGAGATAGCC	1
ACGCCACCCC	GAAACACCGGTTGGCTTTACTGCTTTGTGGGGTTAGAGCTATAAATAGCA	1
AGAGAGCAAC	GAAACACCGGTGCTGTTAGATCGAGAGTTGGGCTAGAGATAGAAGTAGAA	1
AGATAACAAC	GAAACACCGGTGTTCTTTGCTCGAGGGTGAGGTTAGAGCTAGAAATAGCA	1
ATACCACACT	GAAACACCGGTTGTAAGCGATGGTTTGTGGGGTTAGAGCTAGAAATAGCA	1
ATATCACACT	GAAACACCGGTTGAGAGCGTCGGTTTGTGGGGTTAGAGCTAGAATAACCA	1
ATCTAACCGA	GAAACACCGGTGTGCGGAGATTATGCGTGAGAAATAGCAAGTAACCTACG	1
ATCTAACCGC	GAAACACCGGTTTTCGGTGATTATTCGTGGGGTATGGCCTGTAACCTACG	1
ATGACCGTCG	GAAACACCGGTCCTAGAAGCTGAGTGGGGTTAGGGCTAGAAATAGCAAGT	1
ATGCAGCACG	GAAACACCGGTCCTCTAGGCTTAGCAGGTTAACCTAAGGCTAGACCGTCA	1
ATGCCGGAAC	GAAACACCGGTGCTATTAGCTGGGGTGGGGGTTGATATCGAGAATTAGCA	1
ATTCCATCCC	GAAACACCGGTTGCAAACGTTTGCCTGTGGGGTTAGAGCTAGAAATAGCA	1
CAAATCAAAT	GAAACACCGGTGCTCGCGGTTTCTAAGTGGGGTTATAGCTAGAAATAGCA	1
CAACGAGATT	GAAACACCGGTGCTAGCGGTTTAGAATGGGGGTTAGAGCTAGAAATAGCA	1
CACTAACACC	GAAACACCGGTGGCAATTCGATCTGAGTGGGGCTAGAGCTAGAAATAGCA	1
CAGCGAGTTC	GAAACACCGGTCGAGGTTCTCAAAAAGAGGGCTAGAAATAGAAAGATAAA	1
CATTCACAAA	GAAACACCGGTGGCAATTCGATATGATTGGGGTTAGAGCTAGAAATAGCA	1
CATTCACAAA	GAAACACCGGTGGCAATTCGATCTGAGTGGGGTTAGAGCTAGAAATAGCA	1
CATTCACAAA	GAAACACCGGTGGCAATTCGATCTGCGTGGGGTTAGGGCTAGAATTAGCA	1
CATTCACCCA	GAAACACCGGTTGCAGTTCATGGTGAGTGGGGTTAGAGCTAGAAATAGCA	1
CATTCTCAAA	GAAACACCGGTGGCAATTCGATCTGAGTGGGGTTAGAGCTAGAAATAGCA	1
CCATTAACAA	GAAACACCGGTGGGCTTAATTACATTGTGGGGTTAGAGCTATAAATAGCA	1
CCGTTAACAC	GAAACACCCGTTGGCTTTACTCCTTTGTGGGGTTAGAGCTATAAATAGCA	1
CCGTTAACAC	GAAACACCGGTTGGCTTTACTCCTTTGTGGGGTTAGAGCTATAAATAGCA	1
CTGATATCTC	GAAACACCGGTGAGCATGATACCGTCTAGAAATAGCAAGTTAACCTAAGG	1
CTTTCACACC	GAAACACCGGTCGCGAAAATGTGCCGGTGGGGTTAGAGCTAGAAATAGCA	1
GAATCAGCCG	GAAACACCGGTTTTAGTAAATGGTGAGTGGGGTTAGAGCTAGAAATAGCA	1
GAATCATCGA	GAAACACCGGTGTGCGGAGATTGTGCGTGAGAGATAGCAAGGAAACTAAG	1
GAATTAAAAT	GAAACACCGGTTCCAATAGTCAACTCGTGTGGTGATAGCCAGAAGTAGGT	1
GAATTAGCAA	GAAACACCGGTTTTAGTAACTTACGAGTGGGGTTAGAGCTAGAAATAGCA	1
GACAACCTCC	GAAACACCGGTAATCTAAAGATCCCCGTGGGGATAGAGCTAGAAATAGCA	3
GACAACCTCC	GAAACACCGGTAATCTATAGATCCCCGTGGGGATAGAGCTAGAAATAGCA	1
GACACGCTCC	GAAACACCGGTAAACTCGGGATCTCCGAGGGGCGAGAGCTAAGAATGACA	1
GACTATGTAA	GAAACACCGGTACTAGTTACTTACGGGTGGGGTTAGAGCTAGAAATAGCA	1
GACTATGTAA	GAAACACCGGTACTAGTTACTTACGGGTGGGGTTAGAGCTAGAAATAGCG	1
GACTATGTAA	GAAACACCGGTTGAGATAATCAAAAAGTGGGGTAGAGCTAGAAATAGCAA	1
GAGTCAATCG	GAAACACCGGTTAGCGATACGGATTTGAGGGGTTAGAGCTAGAAAAAGCA	1
GAGTTAAGCG	GAAACACCGGTTATCGTTACGGATTTTGTGGGTTTAGAGCTGGAAATAGC	1
GAGTTAGCAA	GAAACACCGGTACTATTTACTTATGTGTGGGGTTAGAGCTAGAAATAGCA	1
GCAATAGATG	GAAACACCGGTTTTAGTAACTGTGTAGTGGGGTTAGAGCTAGAAATAGCA	1
GCCTATGTAA	GAAACACCGGTACTAGTTACTTACGGGTGGGGTTAGAGCTAGAAATAGCA	1
GGCAACTACG	GAAACACCGGTGGCTAGAAATAGCAAGTTAACCTAAGGCTGGTCCGTTAT	1
GTAATATATA	GAAACACCGGTGAGCATGATAAAGTCGGTGGGGTTAGAGCTAGAAATAGC	1
GTGTGCGAGA	GAAACACTGGTGAGATGCAGAGGTGTTAGGGCTAGAAATAGCAAGAGAAC	1
TAACGATAAT	GAAACACCGGTGCAAACAGTCTAATAGTGGGGTAAAAGTAGGAAATAGAA	1
TATGCACAAA	GAAACACCGGTGGCGATACAATCAGAGAGGGGATAGAGATAGAAATATCA	1
TCAACAAAAA	GAAACACCGGTGGGGTTAGAGCTAGAAATAGCAAGTTAACCTAAGGCTAG	1
TCAACCCTCT	GAAACACCGGTGACGCGATGGCGGGGTTAGAGCTAGAAATAGCAAGTTAA	1
TCAACCTCCC	ATTAGAGCTAGAAATAGCAAGTTAACCTAAGGGTTGTCCGTTATCAACTT	1
TCAGCAAAAA	GAAACACCGGTAGGGTTAGAGCTAGAAATAGCAAGTTAACCTAAGGCTAG	2
TGCACATCCT	GAAACACCGGTTAGCGTTAGATCGTTCGAGCTGGTAATAGCAGGTAAACC	1
TGCACTTCCT	GAAACACCGGTTCCCGTTAGCTCGTAGTGGGGTTAGAGCTAGAAATAGCA	1
TGTCCAGCTT	GAAACACCGGTCTTCCTGGAATCTACGTGGGGTAGAGCTAGAAATAGCAA	1
TTACCCCACT	GAAACCCCGGTTTACTTCGTTAACTAGTGGGGTTAGAGCTAGAAATAGCA	1
TTCTAACCGA	GAAACACCGGTGTGCGGAGATTATGCGTGAGAAATAGCAAGTAACCTACG	1
