ATCTAACCGA	GAAACACCGGTGTGCGGAGATTATGCGTGAGAAATAGCAAGTAACCTAAG	2	bc
ACAGCGAGAT	GAAACACCGGTGCTAGCGGTTTCGAAGTGGGGTTAGAGCTAGAAATAGCA	2	bc
CCTTCCCACA	GAAACACCGGTGGCAATTCGATCTGAGTGGGGTTAGAGCTAGAAATAGCA	2	bc
ACGACCGTAA	GAAACACCGGTGCGAGAAGCTCTAGTGAGAGGTAGGAGCTCTAAATAGCG	1	bc
TCTGCCACAA	GAAACACCGGTGGGGTTAGAGCTAGAAATAGCAAGTTAACCTAAGGCTAG	1	bc
ATATAAACGA	GAAACACCGGTGGGGTTAGATCAAGAAAGAGCAAGATAACGTAAGGCTAG	1	bc
AACCGGGTTG	GAAACACCGGTCGTCGTTCGCAGGGCGTGGGGTTAGAGCTAGAAATAGCA	1	bc
AAACCCGCCA	GAAACACCGGTTTCGTAATAGCAAGTTAGGGTATGGCTATACCGATATCA	1	bc
CAATGGGTTG	GAAACACCGGTTTTCGTTCGTAGGGCGCGGGGTTAGAGCTAGAAATAGCA	1	bc
AATCAACAAT	GAAACACCGGTGACAAACGTATGTCAGTGGGGTTAGAGCTAGAAATAGCA	1	bc
TCATAACAGA	GAAACACCGGTGGGCTTAGAGCTAGCGAGAGAAAGTTAACCTAAGGCTAG	1	bc
CGCTCACATA	GAAACACCGGTGGCCATTCAATCTACGTGGGATTGGAGCTAGAAGCAGGT	1	bc
TCTCCAACAC	GAAACACCGGTGGCGTTAGAGCTAGAAATAGCAAGATAACCTGAGGCTAG	1	bc
AAAAACCATG	GAAACACCGGTTTAGAAATAGCAAGTTAACCTAAGGCTAGTCCGTTATCA	1	bc
ACTACCCCCC	GAAACACCGGTTGCGCGGGAATCGGAGTGGGAGAAATAGCAAGTTAACCT	1	bc
AATCTATAAA	GAAACACCGGTGACCAACGTATGTCAGTGGGGTTAGAGCTAGAAATAGAA	1	bc
AGTCCGGTTT	GAAACACCGGTCTTCCTGGAATCTACGTGGGGTAGAGCTAGAAATAGCAA	1	bc
AATACTCAAT	GAAACACCGGTGTACTTAGTGGGACCGTGGGGTTAGAGCTAGAAATAGCA	1	bc
AAACAAGACG	GAAACACCGGTGCCATTTGAGGGATCGTGGGGTTAGAGCTAGAAATAGCA	1	bc
CGCCCCTCCC	GAAACACCGGTGGAATCGATCCACTTTTGGGGTAGAAAGTTAAAATAGGA	1	bc
GGAAACAAAG	GAAACACCGGTGGTAGTCGTTCGCTCGTGGGGTTAGAGCTAGAAATAGCA	1	bc
TGGCAACAAC	GAAACACCGGTCTTCTTGGACCCTAGGTGGGGTAAGACTTGAAATAGGCA	1	bc
CCACCCAGCC	GAGACACCGGTAGAATGGGGATAGAGCTAGACATGGCAAGTTAACCTAAG	1	bc
TAGTTAGCCA	GAAACACCGGTCGTGATACTTAGCTGGTGGGGTTAGAGCTAGAAAAAGCA	1	bc
CGTAAATACA	GAAACACCGGTGCGCTCAGTACGTTTTGGGGTTTGGGCTTGGAATTGCAA	1	bc
AAACATACCG	GAAACACCGGTTTAGTTTATGCAGGTTTGGGGTTGGCTATTCAAATAGCA	1	bc
AGACGGGAAA	GAAACACCGGTGATATTCGCTAGAGGGGGGGGATAGCGCTAAAAGTCGCA	1	bc
AAACACCCCG	GAAACACCGGTTTAGATATAGCAAGTTAGCCTATGGCTAGACCGTTATCA	1	bc
TACACTTAAT	GAAACACCGGTTCCCGTTAGTTAGTAGTGGGGTTAGAGCTAGAAATAGCA	1	bc
CCGCGAAGAC	GAAACACCGGTAGAATGGGGTTAGAGCTAGAAATAGCAAGTTAACCTAAG	1	bc
TCTCGCGATC	GAAACACCGGTATAATTGGGATAGAGCGAAAAATCGCATGTTAATCTAGG	1	bc
CGCGCACAAA	GAAACACCGGTGGCAGCCAGCCACTTGTGGGGTTAGAGCTAGAAATAGCA	1	bc
CCCACCTACC	GAAACACCGGTAGACGGTGGTTAGAGCGGGAAAAGACAGAGAAACCGAAG	1	bc
CGGCAGAAAC	GAAACACCTGTGTTCTTTGCTCGTGGGTGTGGTTAGAGCTAGAAATAGCA	1	bc
GACTACTCAA	GAAACACCGGTGGCAGCCAGCCCCTTGTGGGGTTAGAGCTAGGATTACCA	1	bc
GTACGCCGTC	GAAACACAGGTAGAATGGATCCACGGGTGGGGTTAGAGCTAGACATGGCA	1	bc
TGTTCTCAAT	GAAACACCGGTTCCCGTTCGCTCGTAGTGGGGTTAGAGCTAGAAATAGCA	1	bc
AAACCATTGC	CCAAAGCCCGGTTTAGAGATCGCAAGTTGACCTGAGACTAGTACATTTTG	1	bc
CTCGCGCACA	AGACGAGACACCGGGTCAACCGGCTTGGTAGTAGAGCTAGGAATAGCAAG	1	bc
AATCCAGCCA	GAAACACCGGTTTCCTTTGGGGGTCAGTGGGAGTAATAGTAAGATAACCA	1	bc
TAAGAGAAAA	GAAACACCGGTGTTGTTTGATCGAGGGTGGGGTAAGTACCAGAAATAGCA	1	bc
TCCTACCTCT	GAAACACCGGTGACGCGAGATCATGCGTGGGGTTTGACCTAGAACTTAAA	1	bc
AACCCGGTGA	GAAACACCGGTTTAAGAATCGTACGTTGGGGTATGGATAGTCTAATATCA	1	bc
CCCTGACAAA	GAAACACCGGTGGCAAGTCGATCTGCGTGGGGTTAGCGCGAGAAACAGAA	1	bc
TGCTCATCCA	GAAACACCGGTGCGCGTAGACTCGTCGTGGGGTTAGACCTAGAACCAACA	1	bc
TTAATAAAAA	GAAACACCGGTGGGGTTGGAGCTAGAAATAGAAAGTTAACCTAAGGCTAG	1	bc
CGACTACAAA	GAAACACCTGTGTTCATTGCTCGAGTGTGGGGTTAGAGCTAGAAATAGCA	1	bc
CATTTGCTAA	GCAACACCGGTGGCCATTCGATCTGCGTGGGGTTAGAGCTAGAAATAGCA	1	bc
TAACCCGATC	GAAACACCGGTTTACTTAGCTAACTAGTGGGGTTAGAGCTATAAATAGCA	1	bc
GATAACGACG	GAAACACCGGTGGCCTCCATCCGCCTGTGGGGTTAGAGCTAGAAATAGCA	1	bc
TAAATCTAAA	AGGGAGGAAACACCGGTGTAGTTAGTTAACTAGGTGGTAGAGAGTTAGAT	1	bc
ATAATACCGA	GAAACACCGGTGTGCGGGGAATCTTCGTGGGGGATAGCGATAAACATAGC	1	bc
TTCATGTTAC	GAAACACCGGTTTTCGAGCATAAGTCGGGTGATTTAAGGCTGAAACAGCA	1	bc
CCCTCTGGCC	GAAACACCGGTTCACTCGGCATGGGGTTAGAGCTAGAAATAGCAAGATCA	1	bc
TAATCACTCT	GAAACACCGGTGTTACGAGATGTAGGGGTTGGAGTAGGAAGTTGCACTAT	1	bc
CGCCCCTGCA	GAAACACCGGTAGAATGGGGTTAGTGCTAGGAATAGCAAGGTAACCTAAG	1	bc
ATGCTAACAC	GAAACACCGGTTGGCTTTGCTCGTTTGTGGGGTTAGAGCTAGAAATAGCA	1	bc
CCGACCGTAG	GAAACACCGGTCCTAGAAGCTGAGTTGTGGGGTTAGAGCTAGAAATAGCA	1	bc
ATCACGGTAG	GAAACACCGGCTCTAGATGCTAGGTTGTGGGGTTAGAGCTAGAAATAGCA	1	bc
AATAAGGACC	GAAACACCGGTGTTCTTTGCGCGAGGGTGGGGTTAGAGCTAGAAATAGCA	1	bc
ACTACTGACG	GAAACACCGGTGCCGTTTATGGTACCGAGGGGAAAGAGCTCGAAATCGCA	1	bc
CAACGGATGA	GAAACACCGGTCTAGAATCGGAAAGTTAGGCTATGGCTAGAGAGATAGCA	1	bc
AAGCCGCCAC	GAAACACCGGTGTTCTTTGCTCGAGGGTGGGGTTAGAGCTAGAAATAGCA	1	bc
AACGCGATAG	GAAACACCGGTTTTCGTTCATAGAGCGTGGGGATAGAGATAGAAATAGCA	1	bc
CAGTAAGTAA	GAAACACCGGTACTAGTTACTTATGGGTGGGGTTAGAGCTAGAAATAGCA	1	bc
AACTAACAGA	GAAACACCGGTGGCAATTGGATCTGAGTGGGGTTAAAGCTAGAAATAGCA	1	bc
GACATACATC	GAAACACCGGTAGACTGGGGTAAGAGGTAGGATTAGCAAGTTAACCTAAG	1	bc
TGACCACAAT	GAAACACCGGTGGTCTTTGATCGAGAGAGGGGGTTGAAACATAAAGTTAA	1	bc
TCTCCACCTT	GAAACACCGGTGGCAAACGTATGTCAGTGGGGTTAGAGCTAGAATTAGCA	1	bc
GAGTCCAATG	GACACACCGGTTATCGTTACGGATTTGTGGGTTTAGAGCTAGAAATAGCA	1	bc
GAGTCAAAGA	GAAACACCGGTTAGCGTTGCGGTTTTGTTGGGTTAGAGCTAGAAATAGCA	1	bc
TCAAACCACG	GAAACACCGGTGACGCGCGGACGGTGGTGGGGTTAGAGCTAGAAATAGCA	1	bc
TGGTCAAGTT	GAAACACCGGTCTTCCTGGAATCTACGTGGGGTAAAGCTAAAAATAGCAA	1	bc
CCATGCGGCG	GAAACACCGGTAGAATGGGGTTAGAGCTAGGAATAGAAAGTTAAACTAAG	1	bc
GATTCTGCAA	GAAACACCGGTGCTAGTTGCTCACGTGTGGGGTTAAACCTAGAATTACAA	1	bc
TATTTACAAC	GAAACACCGGTGGCAATTCGATCTGAGTGGGGTTAGAGCTAGAAATAGCA	1	bc
GCGGGCGCGG	GAAACACCGGTGAGGTGCCTCAAAGTGGTGGTAGAGCTAGAAATAGCAAG	1	bc
TGTTCAATCT	GAAACACCGGTTCTCGTTGCGTGTTTGAGGGGTAAAAGTTCGAATTAGCA	1	bc
GTGATATGTG	GAAACACCGGTGATCATGACAACGTCCGGGGGGTTAAAGCTGGAAATAGC	1	bc
GAATCACTCC	GAAACACCGGTTTTATTAAATGGCCAGTGGGGATCGAGCAATAACAAGCA	1	bc
GCAGCTATAA	GAAACACCGGTGGGGTTAGAGCTAGAAATAGCAAGTTAACCTAAGGCTAG	1	bc
AAACGCCTCC	GAAACACCGGTATAATGGGGTTAGGGCTAGGAGTAGCAAGTTAAACTAAG	1	bc
ATGCCGGAAC	GAAACACCGGTGTTCTTTGCTCGGGTGTGGGGTTAGAGCTAGAAATAGCA	1	bc
CAAAGACGCC	GAAACACCGGTAGACTGGGGATCGAGCTAGATATAGCAAGTAAACCTAAG	1	bc
AGACCAGAAT	GAAACACCGGTCTTCCTGGATTCTACGTGGGGTAGAGCTAGAAATAACAA	1	bc
GAGTCCCGCC	GAAACACCGGTTATCGTTACGTCTTTGTTGGGTTAGAGCTAGAAATAGCA	1	bc
TCTAATTACC	GAAACACCGGTCGCGAAAATGTGCAGGTGGGGTAAAAGTAAGAAACAGCA	1	bc
CACATTCACA	GAAACACCGGTGGCAATTCGATCTGAGTGGGGTTAGAGCTAGAAATAGCA	1	bc
CCAGCAACAC	GAAACACCGGTGGGGTTAGCGCTAGAAATAGCATGTTAACCTAAGGCTAG	1	bc
CCTCTCACAC	GAAACACCGGTAGACTGGGGTTAGAGCTAGGAATAGCAAGTTAACCTAAG	1	bc
TTCTTCTAAA	GAAACACCGTTCGGGTTAGAGCTACAAATAGCAAGTTAACCTAAGGCTAG	1	bc
ATCTGGGCGA	GAAACACCGGTTGTGGGGAACTCGGTGTGGGAGAAATAGCAAGTTAACAT	1	bc
CAACCGCTTG	GAAACACCGGTCTTCTTAGGTAACTCGTGGGGTTAGAGCTAGAAATAGAA	1	bc
CCCATGGCCC	GAAACACCGGTTCAACCGGCGTGGTGTTAGGGCTAGAAATAGCAAGTTAA	1	bc
GACTTCAAAC	GAAACACCGGTGCTAATAGTTAGCTCGTGGGGTTAGAGCTAGAAATAGCA	1	bc
TCAGCCATCA	GAAACACCGGTGGGGTTAGAGCTAGAAATAGCAAGTTAACCTAAGGCTAG	1	bc
CTACCATCAA	GAAACACCGGTGATAACAGATCGTTTTGGGGTTAGAGCTAGAAATAGCAA	1	bc
CAGTTGCAAA	GAAACACCGGAGGGAATTCGATCTGAGTGGGGTTAGAGCTAGAAATAGCA	1	bc
ACACGCCTCC	GAAACACCGGTAGAATAGGGTTAGAGCTAGAAATAGCAATAGAACCTAAG	1	bc
AAAACCTCAC	GAAACACCGGTTTACTTAGTTAACTAGTGGGGTTAGAGCTAGAAATAGCA	1	bc
CCACGCCTCA	GCAACACCGGTTTAGTAATAGCAAGTAAGCCTTAGGATAGTCAGTTATCA	1	bc
GTAAAATCGA	GAAACACCGGTGAGCATAGTATCGGCGTGGGGGTTAGAGTGGAAAATAGC	1	bc
TAGCGCGAGA	GAAACACCGGTGAGATTACTCAAAGTGGGGTTAGAGCTACTAATAGCAAG	1	bc
GATTCCCCAA	GAAACACCCGTAGCCATTCGATCTGCGTGGGGTTAGAGCTAGAAATAGCA	1	bc
GATAATGAAA	GAAACACCGGTGCCATTTATGGGACCGTGGGGTTAGAGCTAGAAATAGCA	1	bc
AACCGCCCAC	GAGACACCGGTTGAGTGGGGCTAGAGGTGGGAATAGTAAGATAATAACAG	1	bc
GCGTCAAACA	GAAACACCGGTTAGCTTAGCGCTATAGATCTAGAGTTAGCCAAATGCTAT	1	bc
GACCGCCGCA	GAGACACCGGTAGAATGGGGTTAGAGCTAGAAATAGCAAGTTAACCTAAG	1	bc
GTCTTCTATA	GAAACACCGGTGCGCATGATAACGTCCGTGGGGTTAGAGCTAGAACTAGC	1	bc
ACAGCGAGAT	GAAACACCGGTGCTAGCGGTTTCGCAGTGGGGTTAGAGCTAGAAATAGCA	1	bc
ACCCAGCGAC	GAAACACCGGTAGTCTTTGCTCGAGGGTTGGGTTAGAGCTAGAAATAGCA	1	bc
TACACTTTCC	GAAACACCGGTTCCGTTAATTCGTAGTGGGGTTAGAGCTAGAAATAGCAA	1	bc
TTCTACTAAC	GAAACACCTGTCGCGAATGTGTGCCGGTGGGGTTAGAGCTAGAAATAGCA	1	bc
ACTGGAGCAA	GAAACACCGGTGGGGGGGGACTCGGGGTGGGAGTAGTACCATAATAATCT	1	bc
ACTCCCTCCC	GAAACACCGGTGACAAACGTATGTCAGTGGGGTTAGAGCTAGAAATAGCA	1	bc
AAACCCTCAA	GAAACACCGGTGTAAACATAACACGTTTACCTCTGGCTATACCAAGATCA	1	bc
CCCTCAGATT	CAAAACACCGGTTCAACTGGAGTGGGGTTAGAAATAGAAATAGCAAGTTA	1	bc
AATATATCAA	GAAACACCGGTGAGCATGATATCGTAGTGGGGGTAAGAGCAAGAAAACCT	1	bc
ATAATCGACG	GAAACACCGGTGCTAGTAGTTGAGTTGGGGGGTTAAAACTAAAAATAGCA	1	bc
CCTCGGCCAC	GAAACACCGGTAGAGGGGGACTAGAGGTGGGAGTAGCAGGATAACATAAG	1	bc
GAGCGAGCAC	GAAACACCGGTGAGATACGTCAAAGTGGGGGTAGAGCTAGAAAAAGAACC	1	bc
ATTAACCAAC	GAAACACCGGTCCTAGAAGCTGAGTTGTGGGGTTAGAGCTAGAAATAGCA	1	bc
TAAACCCGCC	GAAACACCGGTTTACTTAGTTAACTAGTGGGGTTAGAGCTAGAAATAGCA	1	bc
AATTCTCCAA	GAAACACCGGTGGCAATTCGGTCTCCGTGGGGTTAGAGCTAGAAATAGCA	1	bc
GATTATGCCA	GAAACACCGGTGCTCTTTACTTGCGCGTGGGGTTAGAGCTAGAAATAGCA	1	bc
GAGTCTGGAA	GAAACACCGGTACTAGTTACTTACGGGTGGGGTTAGAGCTAGAAATAGCA	1	bc
GACGGTGTGA	GAAACACCGGTACTAGTTACTTACGGGTGGGGTTAGCGCGTGAAATTGCA	1	bc
TGTTCAGAAA	GAAACACCGGTGTTAATGGGATCTACGTGGGGTTAGAGTTAGAAATAGCA	1	bc
AAAACAGTCG	GAAACACCGGTTTTAGTAGATGAAGAGTGGGGTTAGAGCTAGAAATAGAA	1	bc
CAAAACGTTT	GCAACACCGGTGCTCGCGGGTTCGAAGTGGGATTAGAGCTAGAAATAGCA	1	bc
CGCCTGCCAC	GAAACACCGGTGTTCTTTGCTCGAGGGTGGGGTTAGAGCTAGAAATAGCA	1	bc
CATAAACCCA	GAAACACCGGTTTACTTAGTTAACTAGTGGGGTTAGAGCTAGAAATAGCA	1	bc
GTACCAGATA	GAAACACCGGTGTTCATGGTATCGAAGTGTGGGGGTGAAAGTAGTAGCAG	1	bc
TACTTTATAC	GAAACACCGGTACTAGTTACTTACGGGTGGGGTTAGAGCTAGAAATAGCA	1	bc
GACTCCCACC	GAAACACCGGTAATATAAGCATGGGGTTAGAGCTAGAAATAGCAATATAA	1	bc
GATTTATATA	GAAACACCGGTGAGCATGATCTCGTCCGGGGGGATAGAGCTAGAAATAGC	1	bc
AAAACATAAT	GAAACACCGGTGTACAAAGTTTGCCAGTGGGGTTAGAGCTAGAAATAGCA	1	bc
TATGAACGTC	GAAACACCGGTCCTAGAAGCTGAGTTGTGGGGTTAGAGCTAGAAATAGCA	1	bc
TAAATATTCA	GACACACCGGTTGAGATAATCACGTAGTTGGGTAGAGCTAGAAATAGCAA	1	bc
ACCACGCAAG	GAAACACCGGTTTTACATCATAGGTCGTGGGGTTAAAGCCAAAAAAAACA	1	bc
TCCAACCACG	GAAACACCGGTGGCAGCCAGACACTTGTGGGGTTAGAGCTAGAAATAGCA	1	bc
GAATCCGAAT	GAAACACCGGTTTACTTAGTTAACTAGTGGGGTTAGAGCTAGAAATAGCA	1	bc
TCCACGCCCT	GAAACACCGGTTCAACCGGCGTCGTTTGGGGGGTTAGAGATAGAAATAGC	1	bc
TTAATCTACT	GAAACACCGGTCGCCATAATTAGCTGGTGGGGTTAGAGCTAGAAATAGCA	1	bc
AACCAGCACC	GAAACACCGGTATTCTTTGCACGCGGGTGGGGTTAGAGCTAGAAATAGCA	1	bc
TAAACTTCTC	GAAACACCTGTGACCGTTACCACGTCCTGGGGGTAAAGGCTAAAATTGCC	1	bc
CCAGTAACAA	GAAACACCGGTGGGGTTTGCGCTTTTATGGGCTTATTAATCTAAATATAG	1	bc
CCTTCCCCCC	GAAACACCGGTGGCAATTCGATCTGAGTGGGGTTAGAGCTCGAAATAGCA	1	bc
AATACACTAT	GAAACACCGGTCTTCCAGCATACGTCGTGGGGTTGAGGTAGGAATAGCAA	1	bc
TAAAGGCAAG	GCAACACCGGTTTACTTAGGTAAGTAGTGGGGTTAGAGCTAGAAATAGCA	1	bc
AGGCGGGCAG	GAAACACCGGTCGTCGTTCGTAGTGCGTGGGGTTAGAGCTAGAAATAGCA	1	bc
GAAACCTATA	GAAACACCGGTGAGCATGATAACGTCCGTGGGGTTAGAGCTAGAAATAGC	1	bc
AACTTACCAA	GAAACACCGGTGCTCATAGTTAGCTCGTGGGATTAGAGCTAGAACTAACA	1	bc
TACTCCCTAT	GAAACACCGGTTTTCTTAACTAACTAGTGGGGTTAGAGCTAGAAATAGCA	1	bc
ATTTCATAAA	GAAACACCGGTGAGAAGAGAACGTTTTGGGGTTAGCACTAGAAATAGCAA	1	bc
ATACCAACCC	GAAACACCGGTTGTAAGCGCTGGTTTGTGGGGTTAGAGCTAGAAATAGCA	1	bc
CAATGAGAGA	GAAACACCGGTGCTAGTGGGTTCTGAGTGGGGTTAGAGCTAGAAATAGCA	1	bc
GAGTCAACAA	GAAACACCGGTTATCGCTACGGATTTGTGGGGTTAGAGCTAGAAATAGCA	1	bc
GTTCTATCTA	GAAACACCGGTGAGAATGATAACGTCCGTGGGGTTAGAGCTAGAAATAGC	1	bc
TTCTCTTCAC	GAAACACCGGTACTAGTTACGTGCCGGTGGGGTTAGAGCTAGAAATAGCA	1	bc
CGCCCGCATC	GAAACACCGGTTCAACTGGCGAGGGCGTAGAGCTAGAAATAGCAATATAA	1	bc
AACAAGCCAA	GAAACACCGGTTCTAGATACTTACGGGTGGGGTTAGAGCTAGAAATAGCA	1	bc
ACCCTCACAA	GAAACACCGGTGGCAATTCGATCTGAGAGGGGTTAGAGCTAGAAATCTCA	1	bc
TTCATGTTAG	GAAACACCGGTTTTCGATCTTAGGCCGTGGGGTTAGAGCTAGAAATAGCA	1	bc
TAAACACACC	GAAACACCGGTTTACTTAGTTAAATAGTGGGGTTAGAGTTAGAAATGCAA	1	bc
ACTAACACAA	GAAACACCGGTTGTAAGCGATGGTTTGTGGGGTTAGAGCTAGAAATAGCA	1	bc
CTCACGAACG	GAAACACCGGTCCAACCGGCTGCGGTTTAGAGGTTAAAATAAGAAGTTAC	1	bc
AACTTGCAAA	GAAACACCGGTTCAGCCGGCGTCTTTTGTGGGGTTAGAGCTAGAAATAGC	1	bc
GAACAAAAAG	GAAACACCGGTTATCTTTGCGGGTGTGTGGGGTTAGAGCTAGAAATAGCA	1	bc
GAACTGAAGA	GAAACACCGGTGAGCATGAAAAGGTCCGGGGGGTAAAAACTAAAAAAAGA	1	bc
CCAATCTATA	GAAACACCGGTGAGCATGACAACGTCCGAGGGGCTAGAGCTAGAAATAGC	1	bc
AATCCCCTAT	GAAACACCGGTGACGCGAGGATGGGGGTGGGGGTAGAGCTAGAAATAGCA	1	bc
CGGCGATCAA	GAAACACCGGTGAGCATTGAACGTTGTGGGGTTAAAGCTTGAAATAGCAA	1	bc
GCAATCCACA	GAAACACCGGTGACCATGATAACGTACGTCGAGATAGAGCTAGATATAGT	1	bc
ATCTCGCCCC	GAAACACCGGTTCACGCGGCTTGGGGTTGAGAAATGAAAAGGAACGTAAA	1	bc
AAAATCGACG	GAAACACCGGTCCTGGAAGCTGAGTTGTGGGGTTAGAGCTAGAAATAGCA	1	bc
AAAGCAATAA	GAAACACCGGTTTAGAAATAGCAAGTTAACCTAAGGCTAGTCCGTTATCA	1	bc
CGACCATAAA	GAAACACCGGTTAGAACTGAATGTTTTGGGGGTTGAGCTTGGAATTGCAA	1	bc
TTGACCCACG	GAAACACCGGTGGCCTCCAGCTACTAGTGGGGTTAGAGCTAGAGATAGCA	1	bc
AATACTTCCT	GAAACACCGGTGCCCGTTAGCTCGCAGTGGGGTTAGAGCTAGAAATAGCA	1	bc
AGCCACTAAC	GAAACACCGGTGGCCTCTACTCACTTGTGGGGTTAGAGCTAGAAATAGCA	1	bc
GAAACCCCTA	GAAACACCGGTTTAGAAATAGCAAGTTAACCTAAGGCTAGTCCGTTATCA	1	bc
ATCTAACCAA	GAAACACCGGTGCTCGAATATTATGCTAGCGTAATACTAGGCAGCTTTCA	1	bc
TCACCAGATA	GAAACACCGGTGGTCCTAGAGTTTAAGAGGGCAAGTTCTCGTAATAGCAA	1	bc
AGACCGCCAA	GAAACACCGGTGTTCTTTGCTCGTTGTTGGGTTTAAGGCTGTAAATAGCA	1	bc
TCATCAGCAA	GAAACACCGGTGGTGTTGAAGCTAGAGTGGGCGAGTTAGCATGATAACCG	1	bc
AACTTGCCGA	GAAACACCGGTGTTCGGAGATAATGCGTGGGGATAGACATAGAAACAGCA	1	bc
ACTTATACCC	GAAACACCGGTGCGCTTTACTCCTTTGTGGGGTTAGAGCTATAAATAGCA	1	bc
AAACGCGCGA	GAAACACCGGTTTAGAAGTAGCAAGTGTGGCTGAAGAGAGACCGTTACCA	1	bc
TGGAAATATG	GAAACACCGGTGGCAGCCAGAGCATTGTGGGGTTAGGGCTGGACGTAGCC	1	bc
AATCCTGCTT	GAAACACCGGTTTTCCTGGAATCTACGTGGGGGAGATCTAAAATTAACAT	1	bc
CACCGACACA	GAAACACCGGTAGAAAGTCTACCTGAGTGGGGTTAGAGCTAGAAATAGCA	1	bc
ATACTCACCA	GAAACACCGGTTGTAAAAGTTGGCTTGTGGGGTTAGAGCTAGAAATAGCA	1	bc
AAATGCATGC	GAAACACCGGTTTTGGAATATAAAGTTAAGGTAAGGATAGTCCGTTATCA	1	bc
AAACCATATA	GAAACACCGGTGACAAAGGTATCGCAGTGGGGTTAGAGCTAGAAATAGCA	1	bc
AAAAGGTCAA	GAAACACCGGTGTTGAGGAACTCGGCGGGGGAGAAATAGCAAGTTAACCT	1	bc
AACCCCCCCC	GAAACACCGGTAGAATGGGGTTAGAGCTAGAAATAGCAAGTTAACCTAAG	1	bc
GAAAACTAAG	GAAACACCGGTGGCAGCCAGACCCTTGTGGGGTTAGAGCTAGAAATAGCA	1	bc
AAAATATCAA	GAAACACCGGTGAGAAAGGTAAGGCAGTGGGGTTAGAGCTAGAAATAGCA	1	bc
TCAATACTCA	GAAACACCGGTGAGCAGGAGACGGTGGTGAGGTTAGCGATAGAAATAGCA	1	bc
CACCTGCTAT	GAAACACCGGTTTTCGATCATAGGTCGTGGGGTTAGAGCTAGAAATATCA	1	bc
AGCACGCCAT	GAAACACCGGTTTTCGTTCACTCGTCGTGGGGTTAGAGCTAGAAATAGCA	1	bc
ATATCAAACA	GAAACACCGGTTGTAAGCGATGGCTTGTGGGGTTAGAGCTAGAAATAGCA	1	bc
ACACCGCACC	GAAACACCGGTTTGGCTTGCGCGAGGATTGGGCTAGAAATAGCAAGCTAA	1	bc
GATATATCTA	GAAACACCGGTGAGAATGATAAGGTAGGTGGGGTAAGAGCAAGAAATAGA	1	bc
ATCATTAATC	GAAACACCGGTTGAGATAATCAAAAAGTGGTGTAGAGCTACAAATAGCAC	1	bc
TCAATAATCA	GAAACACCGGTGACGCGGGGAAGGTCGAGAAATAAGAGGTAGACCTAAGA	1	bc
AACAAACTGG	GAAACACCGGTTTTCGGTCATAGGTCGTGGGGATAGACCAAGAAATAGCA	1	bc
GAATCATACA	GAAACACCGGTGACAAGCGTATGGTGGTGGGGTTAGAGCTAGAAATAGCA	1	bc
GTAACACACA	GAAACACCGGTTGCAATTCGATCTGAGTGGGGCTAGAGCTAGAAATAGCA	1	bc
TAGAAAAAAA	GAAACACCGGTTTACTTAATTAACTAGTGGGGTTAGAGCTAGAAATAGCA	1	bc
AAGACCGCAA	GAAACACCGGTGTTCTTTGCTCGAGGGTGGGGTTAGAGCTAGAAATAGCA	1	bc
GGGACATGCG	GAAACACCGGTGATCGTTACGGATTTGTGGGGTTAGAGCTAGAAATAGCA	1	bc
AACTAAACAA	GAAACACCGGTGACAAACGTATGTGAGTGGGGTTAGAGCTAGAAATAGCA	1	bc
AACACGCGGG	GAAACACCGGTTTTCGATCATAGGTCGTGGGGTTTGAGCTAGTAACAGCA	1	bc
