ACCCGCCGCC	GAAACACCGGTAGAATGGATCCACGGGTGGTGTTAGAGCTAGAAATAGCA	2	bc
CCCCGCCGCC	GAAACACCGGTAGAATGGATCCACGGGTGGGGTTAGAGCTAGAAATATCA	2	bc
CCCCGCCGCC	GAAACACCGGTAGAATGGATCCACGGGTGGGGTTAGAGCTAGAAATAGCA	2	bc
CACGGCGGGT	GAAACACCGGTCGTCGTTCGTAGGGCGTGGGGTTAGAGCTAGAAATAGCA	2	bc
AAATTCACAA	GAAACACCCGTGGCAATTCGATCTGAGTGGGGTTAGAGCTAGGAATAGCA	2	bc
GAATCAGCCG	GAAACACCGGTTTTAGTAAATGGTGAGTGGGGTTAGAGCTAGAAATAGCA	2	bc
CCCCGCCGCC	GAAACACCGGTAGTATGGATCCACGGGTGGGGTTAGAGCTAGAAATAGCA	2	bc
GAATAAAACC	GAAACACCGGTTTTAATAAATGGTGAGTGGGGTTAGAGCTAGAAATAGCA	1	bc
CTCTCACCGA	GAAACACCGGTGTCAGTACATTCTGAGTGAGGTTAGACCTAGAACTTGAA	1	bc
GAAGCAGCAG	GAAACACCGGTGGGGTTAGAGGTAGAAAGGGCATGTTGATCTAAGGATAG	1	bc
GCGGGCGCAC	GAAACACCGGTGAGATACACGTTAACGTGGGGCTAGTCTGATAAATAGTT	1	bc
TTATCCACCC	GAAACACCGGTGGGGATAGTGCTACGGAGGGGTTAGTGCCATAAATAGCG	1	bc
CCTTCCCAAC	GAAACACCGGTGGAAATTCGATATGAGTGTGGTTAGAGCTAGAAATAGCA	1	bc
TAGACTTCCG	GAAACACCGGTTCCCGTTAGCTCGTAGTGTGGGTAGAGCTAGAAATAGCA	1	bc
CGCACATCCA	GAAACACCGGTGAGAACAGAACGGTTTGGGTTTAGAGCTAGAAATAGCAA	1	bc
GCCTCTGAAA	GAAACACCGGTAGGGGTAGCTTTCGTGATAGCATATTGCTCGAAGTCGCA	1	bc
GACTAAGTCC	GAAACACCGGTACTATTAACTTACCCGTGGGGTTAGAGCTAGAAATAGCA	1	bc
TCCTTCAACA	GAAACACCGGTGCCGATAGTGCGCTCGTGGGGTTAGAGCTAGAAATAGCT	1	bc
GATTGAACAA	GAAACACCGGTGCTAATAGTTAGCTCGTGGGGGTAGTGCTAGAAATAGCA	1	bc
TTATTCTCGA	GAAACACCGGTTGAGGATGGAGGGAAGTGGGGTTAGAGATAGAAATAGCA	1	bc
CCCCGCCGCC	GAAACACCGGTTCAACCGGCGTCTTTTGTGGGGATATAGCTAGCAATAGC	1	bc
TAACGAAGCC	GAAACACCGGTTGAGAGATACAAAAAGAGGGAGAGAGCTAGAATAGCAAG	1	bc
AGACGGGTTT	GAAACACCGGTTGTAGTCCGTGGGTTGAGGGGTTAGAGTAAGAAGTTGCA	1	bc
CACTGAGTAA	GAAACACCGGTACTAGCGGTTTAGAGGTGGGGTTAGAGCTATAAATAGCA	1	bc
GACTCTTCAA	GAAACACCGGTACCAGTTACCTACGGGTGGGGTTAGAGCTAGAAATAGCA	1	bc
AACATACATA	GAAACACCGGTTTTCGATCATAGGTCGGGGGGTTAGAGCTAGAAAAAGCA	1	bc
GAGATATGTA	GAAACACCGGTGAGCATGATAACGTCCGTGGTGTTAGAGCTAGAAATAGC	1	bc
AACTTGCAAA	GAAACACCGGGCTACTAGTTGGCTCGTGGGGTTCGAGCTAGAAATAGCAA	1	bc
ACCTCGCCAC	GAAACACCGGTTCAACCGGCGTCTTTTGTGGGGTTAGAGCTAGACATAGC	1	bc
AGAAACCACC	GAAACACCGGTCCTAGAAGCTGAGGTGTGGGGTTAGAGCTAGAAATAGCA	1	bc
TGAATATGTA	GAAACACCGGTACTAGTTACTTACGGGTGGGGTTAGAGCTAGAAATAGCA	1	bc
GGCATATATT	GAAACACCGGTTACCATTATCTCGTCGGTGGGGTTAAGGCTGGAATTAGC	1	bc
TATTCATCCC	GAAACACCGGTCGCGAAAATGTGCCGGTGGGGTTAGAGCTAGAAATAGCA	1	bc
GATTACTCAA	GAAACACCGGTAAGCACAGGACGCTTTGGGGGTAGAGCTAGAAATAGCCA	1	bc
GACTCGCACA	GAAACACCGGTACAAGCGACGTCTTTTGTGGGGTTAGAGCTAGAAAAAGC	1	bc
ATAGTTCAAA	GAAACACCGGTCTTCCTGGAATCTACGTGGGGTAGAGCTAGAAATAGCAA	1	bc
CGACCGCACC	GAAACACCGGTGTTCTTTGCTCGTGGTGTGGGTTAGAGCTTGGAATTACC	1	bc
CACTTCTACC	GAAACACCGGTCGCGAAAATGTGCCGGTGGGGTTAGAGCTAGAAATAGCA	1	bc
CCGCGCGGCG	GAGACACCGGTCGTCGGGAGTAGGGCGTGGGGTTAGAGCTAGAAATAGCA	1	bc
CGGTCAACCA	GAAACACCGGTTCGCTTTACTCCTTTGGGGGGTTAGACCTATAATAACCA	1	bc
AATCCTTCCT	GAAACACCGGTGCCCGTTAGCTCTCAGTGGGGTTAGAGCTAGAAATAGCA	1	bc
AAATTCGTCC	GAAACACCGGTTCTGGTAACTAAAAAGTGGGGTAGAGCTATAAATATCAA	1	bc
CCGATATCTC	GAAACACCGGTGAGCTTTATTACTTCGGGGGGTTTAGGGTTTAAATAGGC	1	bc
TACCTCGCCC	GAAACACCGGTCGCGAAAGTGTGCCGGGGGGGATAAATCGAAAAATAACC	1	bc
CCATTATCTA	GACCCACCGGTTAGCATGATAACGTCCGTGGGGTTAGAGCTAGAAATAGC	1	bc
CCCTGCCGCC	GCAACACCGGTAGAATGGATCCACGGGTGGGGTTAGAGCTAGAAATAGCA	1	bc
CATTAATCTA	GAAACACCGGTGAGAACAGAATGTGTTGGGGTTAGAGCTAGGAATAGGAA	1	bc
ATGAAAGTGG	GAAACAACGGTCCTAGAAGCTGAATTGTGGGGATAGAGCTAGAACTAGCA	1	bc
AGGTCAGCAA	GAAACACCGGTGATAAAAGAAGAGTTGGGGGGTAAAACCAGGAATTAGAA	1	bc
TTATTCTAAC	GAAACACCGGTGGCGATAATGTGCCGGTGGGGTTAGAGCTAGAAATAGCA	1	bc
CGCCCTTCAT	GAAACACCGGTTCCCGTTAGCTCGTAGTGGGGTTGGAGCTAGAAATATCA	1	bc
GATATAGATA	GAAACACCGGTGAGCATGATAACGTCCGTGGGGTTAGAGCTAGAAATAGC	1	bc
ACATTGCACC	GAAACACCGGTTGTACTGGCGTGATTTATGGGGTTAAACCAGAAATAGCC	1	bc
ACGATCGCAC	GAAACACCGGTTCTATAAGCTGAGTTGTGGGGTTAGAGCTAGAAATAGCA	1	bc
GAGATCATCA	GAAACACCGGTGAGAACAGAACGTTTTGGGGTTAGAGCTAGAAATAGCAA	1	bc
ACATCGCAAC	GAAACACCGGTTCAACCGGAGTCATTTGTAGGGTTAGAGCTTGAAATTGC	1	bc
TAATATGTCA	GAAACACCGGTACTAGTTACTTAAGGGTGGGGTTAGAGCAAGAAATAGCA	1	bc
CAACCTTCTT	GAAACACCGGTGCTTGCGGCTTCGAAGAGGGGGTTAAGCTAGTGCTAGTC	1	bc
TGAGTAAAGC	GAAACACCGGTTATCGTTACGGATTTGTGGGGTTAGAGCTAGAAATAGCA	1	bc
AACTTACTGC	GAAACACCGGTTGACGTAATTAAAAAGTGGGGAAGAGCTAGAAATCGCAA	1	bc
AACCCGCCAC	GAAACACCGGTTTTCGATCATTGGCCGTGGGGTTAGAGCTAGAAATAGCA	1	bc
GCAGCATACA	GAAACACCGGTGAGGATAAAGCTGTAGTTGGGGTGAGAACTTAAAAAAGC	1	bc
TCATCCACCA	GAGACACCGGTTGCGGTAATCACATAGTGGGGTTGAGCTAGAAATAGCAA	1	bc
CCCCGCCGAC	GAAACACCGGTAGAATGGATCCACGGGTGGGGTTAGAGCTAGAAATAGCA	1	bc
ATATTAAACT	GAAACACCGGTGCTAATAGTTAGCTCGTGGGGTTAGAGCTAGAAATAGCA	1	bc
CATACTTACT	GAAACACCGGTGCCCGTTAGCTCGTAGTGGGGTTAGAGCTAGAAATAGCA	1	bc
AAGACGGCCG	GAAACACCGGTTCTAGAAGCTGAGGTGTGGGGTTAAAAGTAGGAAAAGCT	1	bc
ATAACCCTCT	GAAACACCGGTTGCGAGAGAAGGTTAGAGGGGGAAGTGGTAAGTAAAGCA	1	bc
CCCCCTCACT	GAAACACCGGTTCAACCTGCGTCTTTTGTGGGGTTAGAGCTAGAAATAGC	1	bc
TCAACCCTCT	GAAACACCGGTTTTCGATCATAGGTCGTGGGGTTAGAGCTAGAAATAGCA	1	bc
AGTCCGCCAC	GAAACACCGGTGACAAACGCATGTCAGTGGGGTTAGAGCTAGAAATAGCA	1	bc
TGATTCAAGC	GAAACACCGGTTATCGTTACGGATTTGTGGGGTTAGAGCTAGAAATAGCA	1	bc
ACAATGATAA	GAACCACCGGTTTTCTATCATTGGAAGTAGCAATATAGCTTGAGGTAACA	1	bc
TGCTAAGAAT	CTAAACACCGGTCTTACTGGAATCTACGTGTGGTAGAGCTAGAAATAGCA	1	bc
GCCTATGTCC	GAAACACCGGTACTAGTTACTTACGGATGGTATTAGTGCTAGGAATAGCA	1	bc
ATGTCAGCCG	GAAACACCGGTCCTAGAAGATGAGTTGTGGGGTTAGAGCTAGAAATAGCA	1	bc
AGAACAGACT	GAAACCCCGGTCTTAGAAATAGCAAGTTGACATAAGACTTAGGGGTTGTC	1	bc
TATCCAGAAA	GAAACACCGGTGTTAATTGGATCTAAGTGGGGTAATAGCAAGAAAAAGAA	1	bc
TTCTATTTAA	GAAACACCGGTACTGGATACGTACGGGTGGGGTTAGAGCTAGAAATAGCA	1	bc
AAATTAGTAC	GAAACACCGGTTGTGGGGATCAAGAAGTGGGGGAAATCGCAAGATAACCA	1	bc
ACACCGCACC	GAAACACCGGTTGAACGCGCGGGTTTTGTGGGGTTAGAGCTAGAAATAGA	1	bc
TATACATCAT	GAAACACCGGTTGCAATTAGATCTTAGTGGGGTTAGAGCTAGAAATAGCA	1	bc
AAATTAACGC	GTAACACCGGTGCTCATAACTAGCTTGTGGGGTTAGAGCTATAAATAGCA	1	bc
CGGCGGGCAC	GAAACACCGGTCGGCGTACGGAGGGCGAAGGGTTAGCGCTAGCGATAGCA	1	bc
GAATCAGTGA	GAAACACCGGTTTTGGATGTGGGGTTAGGGCTAGAAATAGCGAGATAACA	1	bc
ATGCAGCTCC	GAAACACCGGTCCTCTTAGCTGGGTTGTGGGGTTAGAGCTAGAAATAGCA	1	bc
GCATCTGTAA	GAAACACCGGTACGAGTTACTTACGGGATGGGTTAGTGCTAGAAATATCA	1	bc
ATATTATACT	GAAACACCGGTCGTAAGCGATGGTTGGTGTTGTTGGAGGAAAAAATAAGA	1	bc
ATGACAATAC	GAAACGCCGGTCCTAGAAGCTGAGTTGTGGGGTTAGAGCTAGAAATAGCA	1	bc
CATACTCAAT	GAAACACCGGTTCCCATTCGCTCGGAGTGTGGTTAGAGCTAGAAATAGCA	1	bc
ACCCGTGCCG	GAAACACCGGTGCAATTTATGGGACCGTGGGGTTAGAGCTAGAAATAGCA	1	bc
GACTGAGTTT	GAAACACCGGTACTAGCGACTTACGGGTGGGGTTAGAGCTAGAAATAGCA	1	bc
ATAACCCTCT	GAAACACCGGTTGTAAGAGCTGGGTTGTGGGGGTAGAGCTAGAAATAGCA	1	bc
CCCAGCCGCC	GAAACACCGGTAGAATTGATCCACGGGAGGGGTTAGAGCTAGAAATAGCA	1	bc
AGGATTAAAA	GAAACACCGGTGCTAATAGTTAGCTCGTGGGGTTAGAGCTAGAAATAGCA	1	bc
ATCAAACCGC	GAAACACCGGCTTGCGGAGACAAGTCGTGGGAAGACAGCTACAAACTAAA	1	bc
ATGCACCACT	GAAACACCGGTTGTAGGCGCTGGGTTATGGGGTTAGAGATCGAAATAGCC	1	bc
TTCTCTTCGT	GAAACACCGGTGCGCTTTGGTTCTGCGTGGGGTTAAAGCTAGAACTAACA	1	bc
AAATCAACAA	GAAACACCGGTGCTAATTGTACGTTAGTTGGGTTAGAGCTAGAAATAGCA	1	bc
AACTTGGTCG	GAAACACCGGTTTTCGATCATAGGTCGTGGGGTTAGAGCTAGAAATAGCA	1	bc
AACATGCACC	GAAACACCGGTTTAACCGGCTAGTTTTGTGGGGTTAAAGCTAGAAATAGA	1	bc
GTATTCATCG	GAAACACCGGTGCTAATAGCTAGCTCGTGGGGTTAGAGCTAGAAATAGCA	1	bc
GAGTCCTCCG	GAAACACCGGTTATCGTTACGGGTTTGTGGGGTTAGAGCTAGAAATAGCA	1	bc
TGAACTTACA	GAAACACCGGTTCCCGTTAGCTCGTAGTGGGGTTAGAGCTAGAAATAGCA	1	bc
AACACTTTAT	GAAACACCGGTTTTCGATCATATGTCGTGGGGTTAGAGCTAGAAATAGCA	1	bc
TAAACCAAAA	GAAACACCGGTGTGCTTAGAGTTAGACTTGGCATAGTAACCTAAGGCTAG	1	bc
CGCACCTACC	GAAACACCGGTTCCAGCTAGCTCGTAGTGGGGTTAGAGCTAGAAATAGCA	1	bc
CCCAAGCGCC	GAAACACCGGTTCACCCGGCGGCTTTTGTGGGGTTAGAGGTAGAAATAGC	1	bc
AATACTTCCT	GAAACACCGGGGCCTTGAGTTGGACCGTGAAAGTAGAGCTAGGGCTAGCA	1	bc
GCGACACGCG	GAAACACCGGTTATCGTTACGGATTTGTGGGGTTAGAGCTAGAAATAGCA	1	bc
AGTTAAGCGA	GAAACACCGGTGTTCCTGGAATCTACGTGGGGTAGAGCTAGAAATAGCAA	1	bc
AGACGGCATT	GAAACACCGGTGCTAGCGGTTTGGAAGTGGGGTTAGAGCTAGAAATAGCA	1	bc
AATTCCCACA	GAAACACCGGTGGCAATTAGATCTGCGTGGGGTTAGAGCTAGAAATAGCA	1	bc
GGCTCTGCCA	GAAACACCGGTTCCCGTTACCTCGTAGTGGGGTTATAGATAGAAATAGCA	1	bc
CCGCGCGGTC	GAAACACCGGTCGACGTGGGTTAGGCGTAGAAATAGCGATATAACTTACA	1	bc
ACTAGCGCAT	GAAACACCGGTGCTGCGAGACTCGGGGTGGGGGTAGTGCCAAGATAACCT	1	bc
ACACAGCGCC	GAAACACCGGTGCTCTTTACTGGAGGGCGGGGTTAGAGCTAGACATAGCA	1	bc
GCATTAAACC	GAAACACCTGTGCTAATAGTTAGCTCGTGGGGTTAGAGCTAGAAATAGCA	1	bc
CGACATGATA	GAAACACCGGTGCTAGCGGTTTCGAAGTGGGGTTAGAGCTAGAAATAGCA	1	bc
CCCATGTATC	GAAACACCGGTTCAACCGGTGTCTTTTGGGGGTTTAGAGCTAGACATAGC	1	bc
CGTCGGTTTA	GAAACACCGGTGAGCGTTCGTAGGACGTTGGGATGTAGCTAGAAATCGCA	1	bc
TCATTACACC	GAAACACCGGTTGAGCTAATCAAAATGGGGGGGAGAGCTCGAAAAAGCAC	1	bc
GACTCTGAAC	GAAACACCGGTACAAGGTACTTACTGGTGGGGTTAGAGCTAGAAAGAGCA	1	bc
CCCCCTTCCT	GAAACACCGGTTCCCGTTAGCTAGTAGTGGGGTTAGAGCTAGAAATAGCA	1	bc
GACTTCCCAC	GAAACACCGGTGCTAATAGTTAGCTGGTGGGGTTAGAGCTAGAAATAGCA	1	bc
TGGACAGACG	GAAACACCGGTTATCGTTACGGATTTGTGGGGTTAGAGCTAGAAATAGCA	1	bc
CCGATAAATC	GAAACACCGGTGAGCATGATAACTTCCGGGGGGTTAGAGCTAGAAGTAGC	1	bc
GTGAACGACG	GAAACACCGGTCCTAGACGCTGAGTTGTGGGGTTAGAGCTAGAAATAGCA	1	bc
GCAATATCTC	GAAACACCGGTTAGCTTGATACCTTCCGTGGGGTTAGAGCTAGAAATGGC	1	bc
AGACAATAAT	GAACCACCGGTGCTAGCTGCTCGGGGGTGGGGTTAGAGCTAGAAATAGCA	1	bc
AGAATTAACC	GAAACACCGGTGCTAATAGTTAGCTCGTGGGGTTAGAGCTAGAAATAGCA	1	bc
CAAAGAGACG	GAAACACCGGTGCTAGTAGATTCGAAGAGGGGATAGAGCTAGAAATAGCA	1	bc
CAATGAGCTG	GAAACACCGGTGCTAGCGGTTTCGAAGTGGGGATATAGCTAGAAATAGCA	1	bc
AATTAACAGA	GAAACACCGGTGGCAGGTGGATATGAGTGGTATTTGGGCTGGAACCAGAG	1	bc
AATCCTCCCT	GAAACACCGGTTCCCTGTGTTGGACTGTGGGGTTAGAGCTAGAAATAGCA	1	bc
ACCACGGACG	GAAACACCGGTTCTAGCAGCGTCTTTTGGGGGGTTAAGGCTAGAAATGGC	1	bc
TAAATATATC	GAAACACCGGTGCCCTTTATGGGACCGTGGGGTTAGAGCTAGAAATAGCA	1	bc
CCAACCCTCT	GAAACCCCGGTGCTAGCGGTTTCGAAGTGGGGTTAGAGCTAGAAATAGCA	1	bc
TGCTAAGATT	GAAACACCGGTCTTCCGGGAATCTACGTGGGGTAGAGCTAGAAATAGCAT	1	bc
TCATTCACAC	GAAACACCGGTGGCAATTGGATCTGAGGGGGTTTAAACTTGTAAATACCA	1	bc
AGACAAGAAG	GAAACACCGGTGTTAGTAAATCGTGGGTGGGGTTAGAGCTAGAAATAGCA	1	bc
TTCTCCTATC	GAAACACCGGTCCCGAAAGTGTGCCGGTGGGGTTCAACTTAGAAATGGCA	1	bc
TACACCCTAG	GAAACACCGGTTTTCTTTCATAACTCGCGGGGTTAGAGCTAGAAATAGCA	1	bc
CGTTCAACTC	GAAACACCGGTTAGCTTTACTCCTTTGTGGGGTTAGAGCTATAAATAGCA	1	bc
CGGCAGGCAC	GAAACACCGGTCGTCTTGCTTGGGGGTAGGGCTAGAGCTAGCAATATCAC	1	bc
GGCTATGTCG	GAAACACCGGTACTAGTTACTTACGGGTGGGGTTAGAGCTAGAAATAGCA	1	bc
TAAATCCACC	GAAACACCGGTTTAGTTAGTGGGGATAGGGGGGGAAATAGCGAAATAGCC	1	bc
TTTTCACACA	GAAACACCGGTCGCAATTCGATCTGAGTGGGGTTAGAGCTAGAAATAGCA	1	bc
CTGTCCGTCC	GAAACACCGGTCCTAGCAGCTGAGTTGTGGGTTTAGAGCTCGAAATAGCA	1	bc
GTGATAACTC	GAAACACCGGTGGGCATGAAACCTTTGTGGGGGTAAAACTATAAAAAGCC	1	bc
TTGGCCCAGC	GAAACACCGGTGAGGTGCAAGCTATACTAATGTTAGTCCCATATTAACTT	1	bc
TCCTATGCAC	GAAACACCGGTACTAGTTACTTACGGGTGGGGTTAGAGCTAGAAATAGCA	1	bc
TAATCAACCA	GAAACACCGGTGGGGTTAAACCTAGAAATAGCAAGTTAACCTAAGGCTAG	1	bc
AAATCATTAC	GAAACACCGGTTGAGATAATCAAAAAGGGGGGTAGAGCTAGAAATAGCAA	1	bc
GAAATCAACA	GAAACACCGGTGCTATAAGTTAGCTCGTGGGGTTAGAGCTAGAAATAGCA	1	bc
TAAAGCGATT	GAAACACCGGTTCTCTCGGTTCCGAAGTGGGGTTAGAGCTAGAAATAGCA	1	bc
GATTATGCCA	GAAACACCGGTACTCGTTACTTACGGGTGGGGTTAGAGCTAGAAATAGCA	1	bc
GTCCTATATT	GAAACGCCTGTGTTCATGGTAAAGCTGGGAATATCGAGCTAAAAAAAGCC	1	bc
TGATTGCAAC	GAAACACCGGTGTTCTATGTTTGCCGGTGGGGTTAGAGCTAGAAATAGCA	1	bc
GTCAAATATG	GAAACACCGGTGCGCATGATAAAGTTGTGGGGTTAGAGCTAGAAATAGCA	1	bc
ATTTAATCAA	GAAACACCGGTGAGAAGAGAATGTTTGGGGGATAGAGAGAGAAAGCAAGT	1	bc
AATTCGCTAG	GAAACACCGGTGTTCAATCATAGGTCGTGGGGTTAGAGCTAGAAATAGCA	1	bc
TACTTTTCCT	GAAACACCGGTGCCCTTTGGCACGTCGTGGGGTTAGAGCTAGAAATAGCA	1	bc
AACAAGCACG	GAAACACCGGTTTTCGATCATCGGTCGTGGGGTTAGAGCTAGAAATAGCA	1	bc
TACAGTTCCC	GAAACACCGGTTCCCCTTAGCTCGAAGTGGGGTTAGAGCTAGAAATAGCA	1	bc
AATCGTGACG	GCAACACCGGTGCCATTTATGGCACAGTGGGGTTAGAGCTAGAAATAGCA	1	bc
TATTTAGTAC	GAAACACCGGTTGAGATAATCAAGAAGTGGGGTAGAGAGAGAAATAGCAA	1	bc
CGGTGGGCAG	GAAACACCGGTCGTCGTTCGTTCGGCGTGGGGTTAGTGCTAGAATAAGCT	1	bc
CGCACTCACT	GAAACACCGGTTCAACTTGCGTCTTTGGGGGGGGAGGAGGTAGAAATAGC	1	bc
AAACTGCTAA	GAAACACCGGTTTTCGATCATAGGTCGTGGGGTTAGAGCTAGAAATAGCA	1	bc
AACCTGCCAC	GAAACACCGGTGTTCTTTGCTCGAGGGTGGGGTTAGAGCTAGAAATAGCA	1	bc
GATCCAAAAA	GAAACACCGGTCTTACTAGATACTACGTGGGGTAAGGCTAAAAATAGCCA	1	bc
ACGTACATCA	GAAACACCGGTGAGAACAGAACGTTTTGGGGTTAGAGCTAGAAATAACAA	1	bc
TAACCAATGC	GAAACACCGGTTTAGTATGGAGGGAAGTGGGGTTAGAGCTAGAATTAGCA	1	bc
AGACCCGTTT	GAAACACCGGTCTTCCTGGAAGGGACGTGGGGGAGAGCGAGAAATAGCAA	1	bc
TCCGCTGTAA	GAAACACCGGCACTAGTTACTTACGGGTGGGGTTATAGCTAGAAATATCA	1	bc
AGACGGGCAC	GAAACACCGGTGTACGTAACTCGTGGGTGGGGTTAGAGCTAGAAATAGCG	1	bc
AATACCTTCC	GAAACACCGGTCCTAGAAGCTGAGTTGTGGGGTTAGAGCTAGAAATAGCA	1	bc
TGCTCTCACT	GAAACACCGGTTCACGTTAGCACGAACTGGTTATACTGATGCTAATCCGT	1	bc
TTCTGCGCCT	GAAACACCGGTCGTGAAAGTGTGCCGGTGGGGTTAGAGCTAGAAATAGCA	1	bc
ATCTAACCTC	GAAACACCGGTGCTCGCGGATTAGAAGTGGGGTTAAAGATAGAAACAGAA	1	bc
GAATCGAGAT	GAAACACCGGTTTTCTTTACGGACTTGTGGGGTTAGAGCTAGAAATAGCA	1	bc
AAATCAAACA	GAAACACCGGTGCTAATAGTTAGCTCGTGGGGTTAGAGCTAGAAATAGCA	1	bc
GCCTTAAGAA	GAAACACCGGTGGTAACAGTAGAGTCGTGGGGATAGAGCTAGAAATAGCA	1	bc
AGTTAGCCAC	GAAACACCGGTGTTCTTTGCTCGAGGGTGGGGTTAGAGCTAGAAATAGCA	1	bc
ATCAACCCGT	GAAACACCGGTGAGCGGAGATCGTTCGTGCGAGAAAGCGCGTAATCTACG	1	bc
GAAATATCCA	GAAACACCGGTGAGCATGATAAGGTCCGTGGGGTTAGAGCTAGAATTAGC	1	bc
AATTCGCTAG	GAAGCACCGGTTTCCGATCATTGGGAGTGGGGTTAGAGCTAGAAATAGCA	1	bc
GGTACCTATA	GAAACACCGGTGAGCATGGTATCTTCCGTGGGTTTAGAGCTAGAAATAGC	1	bc
ATTACATCCC	GAAACACCGGTGCCAAAAGCTTGTCAGTGGGGTTACTGGTAGAAACAAGA	1	bc
GCAATATACC	GAAACACCGGTGAGCATGACAACGTCCGAGGGGTTAGAGCTAGAAATAGC	1	bc
TAACCAGATG	GAAACACCGGTCGTCTTAGAGAGGGCGTGGGGTTAGAGCTAGAAATAGCA	1	bc
GAACTACAAT	GAAACACCGGTGCTAATAGTTAGCTCGTGGGGTTAGAGCTAGAAATAGCA	1	bc
CATTCAATGA	GAAACACCGGTTTAGACTGGACGTTCTGGGGCTAGAGCTAGCAAGATCAC	1	bc
GAATCTCACA	GAAACACCGGTACTACCGGCGTCTTTGGTGGGGTAAAATCTAGAAATCGC	1	bc
TAAATAATAA	GAAACACCGGTTGAGATAGTCAAAAAGTGGGGAAGAGCTAGTAATCGCAA	1	bc
GATTGGGCCG	GCAACACCGGTTGTGGGGAGCTCGGTGTGGGAGTAATAGCAGGTTCACCT	1	bc
AGACAGGATT	GAAACACCGGTGTTCGCTGTTCGGGGGTGGGGTTAGAGCTAGAAATAGCA	1	bc
AAGCGGGTAA	GAAACACCGGTCGTCGTTCGTTGGGTGTGGGGTTAAAACTAAAATTACCA	1	bc
TGCTCGGATC	GAAACACCGGTTCTCCTGGAATCTTCGGGGGGGAGAGCGATAGATAGCAA	1	bc
GGATGAGTTG	GAAACACCGGTCGTCGTTAGTAGGTCGTGGGGTTAGAGCTAGAAATAGCA	1	bc
ACGATGCCAC	GAAACACCGGTTTTCGATCATAGGTCGTGGGGTTAGAGCTAGAAATAGCA	1	bc
GCCTAACTCA	GAAACACCGGTACTCGGAGCTTAGGGGGAGAAATAGAGAGAGAACTAACA	1	bc
TACTTCCTCC	GAAACACCGGTCTTGGATCTTAGGCCGTGGGGTTAGAGCTAGAAATAGCA	1	bc
AACATACCCG	GAAACACCGGTTTTCGATCATAGGGCGTGGGGTTAGAGCTAGAAATAGCA	1	bc
TGGCCCGCGT	GAAACACCGGTTGCAGTTAGCTTGTAGTGGGGTTAGTGCTATAAATATCA	1	bc
AGGCTAGACG	GAAACACCGGTCTTCTTTGCTGAGTTGTGGGGTTAGAGCTAGAAATAGCG	1	bc
AAACTGCTAT	GAAACACCGGTTTTCGCTCATTCGTCGTGGGGTTAGAGCTAGAAATAGCA	1	bc
TTCCGCAAAA	GAAACACCGGTGGGGTTAGAGCTAGAGATAGCAAGTTGACAGAAAGATAG	1	bc
TTGACAATAA	GAAACACCGGTGCTGGTAGATCTGTTAGTAGTAGAAAAAGCAAATTCTAC	1	bc
ATTTCACACA	GAAACACCGGTGGCAATTGGATCTGTGTGGGGTTAGAGCTAGAAGTAGCA	1	bc
GGCTCTTCCA	GAAACACCGGTTCTAGTTAGTTACTGGTGGGGTTAGAGCTAGAAATAGCA	1	bc
ACGCTCCTGA	GAAACACCGGTAGAATGGATCCACGGGTGGGTATAGCGAGAGAAATAGCG	1	bc
GGGTCGGGCG	GAAACACCTGTTGTCGTTCGGGGTTTGGGTGGATCGATCTAGAACTAGCT	1	bc
TAATCGAAAC	GAAACACCGGTTCAACTGGCTGATTATGTGGGGTTAGAGCTAGAAATAGC	1	bc
AAATTCACAA	GAAACACCGGTGGCAATTCGATCTGTGTGGGGGTAGAGCTAGAAATAGCA	1	bc
ATGCACGTAG	GAAACACCGGTGCTCGTCGCTGGGTTGTGGGGTTAGAGCTAGAAATAGCA	1	bc
GTCTCACAGA	GAAACACCGGTGAGCATGATATCTTCCGTGTGGTTAGAGCTAGAAATAGC	1	bc
GACTCTGCCA	GAAACACCGGTACTAGTTACTTACGGGGGGGGTTCGAGATATAACTAGCA	1	bc
CACAATCCCC	GAAACACCGGTACCCTTTAGGGGACCGTGGGGATAGAGCTAGAAATAGCA	1	bc
ATTACCTTCC	GAAACACCGGTCCTAGAAGCTGAGTTGTGGGGTTAGAGCTAGAAATAGCA	1	bc
GAATTCCTCA	GAAACACCGGTGCTAATAGTTAGCTCGTGGGGTTAGAGCTAGAAATAGCA	1	bc
CTCTCACACT	GAAACACCGGTCTACGTTGATTATTTTGGAGGGATAGAGCTAGAGATAGC	1	bc
ATTTCACACA	GAAACACCGGTTGCAATTGATTGTTTGTGGGGTTAGAGCTAGAAATAGCA	1	bc
TGTACATCCA	GAAACACCGGTTCCCGTTAGCTCGGAGTGGGGTTAGAGCTAGAAATAGCA	1	bc
GGTTCCCCCA	GAAACACCGGTGATCTCAAGATGCTTTTGGGGTAGAGGTAGAAAATGCAA	1	bc
TACTAAACCC	GAAACACCGGTTGAGATAATCAAAAAGTGGGGTAGAGCTAAAAATAGCAA	1	bc
TGAGCTTCAT	GAAACACCGGTTCCCGTTGGCTCGTAGAGGGGTTAGAGCTAGAAATAGCA	1	bc
AAATGGATTC	GAAACACCGGTTGAGGTAATCGAAAAGTGGGGTAGAGCTAGAAATAGCAA	1	bc
CAATAAGAAA	GAAACACCGGTGGTAGCGGTTTCGGAGTGGGGTTAGAGCTAGAAATAGCT	1	bc
TTGCCCGATG	GAAACACCGGTCTTCCTGGAGTCTATGTGGGGTAGAGCTAGAAATTACCA	1	bc
AAAAAGCCAC	GAAACACCGGTGATCTAAGCACCAGGGTGGGGTTAGAGCTAGAAATAGCA	1	bc
GTGTTAGTAG	GAAACACCGGGGGTATTAGGTAGGACGTGGGGTGAGAGCTTGAAATAGCA	1	bc
TTCTTCTATT	GAAACACCGGTCGCGCTGATGTGCCGGTGGGGTTAGAGCTAGAATTGCAA	1	bc
ATCTAGCCGG	GGAACACCGGTTTTCGATGATAGGTCGTGGGAATTAACAAAGAGCTAGAA	1	bc
AGAACGCACC	GAAACACCGGTGCTATTTGCTCGGGGGAGGGGTTAAAATTAGAAATTAAA	1	bc
GCATCAAGCA	GAAACACCGGTGATCGTTACGGATTTGTGGGGTTAGAGCTAGAAATAGCA	1	bc
TCAACCCTCT	GAAACACCTGTGACGCGAGGACGGGGGTGGGGTTAGAGCTAGAAATAGCA	1	bc
TAAACGCTAA	GAAACACCGGTGACGCGGAGATGGGGGTGGGAGTAGAGCCAGAGAAAGCT	1	bc
GAATTACATG	GAAACACCGGTGGTAATAGTTAGCTCGTGGGGTTAGAGCTAGAAATAGCA	1	bc
GAACAAAAAC	GAAACACCGGTGTTCTTAGCTAGCTCGTGGGGTTAGAGCTAGAAATAGCA	1	bc
GAACCAAACT	GAAACACCGGTCGTAAGTGCGGATTAGAGGGAGTAGTGGCAGGAAAAGCA	1	bc
AACATTCCCG	GAAGCACAGGTTTTCGATCATAGGTCGTGGGGTTAGAGCTGGAAATAGCA	1	bc
AAAATTAAAA	GAAACACCGGTGCTCATAGTTAGCTCGTGGGGTTAGAGCTAGAAATAGCA	1	bc
ATTTCCTCCA	GAAACACCGGTGATAACAGAACGGTTTGGGGTTAGAGCTAGCAAAAGCAA	1	bc
CGGCAGGAGC	GAAACACCGGTCGTCTTTCCTATGGTGTGGGGATAGAGCTATAAATCGCA	1	bc
GCAACAAATA	GAAACACCGGTGGGCATAGAGCTATACATGGCAAGTTAACCTGAGGCTAG	1	bc
TACTCTGTCA	GAAACACCGGTACTAGTTACTTACGGGCGGGGTTAGAGCTAGAAATAGCA	1	bc
AACTCTGTAC	GAAACACCGGTACTAGTTACTTACGGGTGGGGTTAGAGCTAGAAATAGCA	1	bc
TAAAACGAGG	GAAACACCGGTGCACTTTGTGGAACATTGGGGTTAGAGCTAGATATCAAA	1	bc
CACCAAGATC	GAAACACCGGTAATCGAGGGTTCGAAGTGGGGATAGAGCTAGAAATAGCA	1	bc
CGCCATGTTA	GAAACACCGGTCGTCGTTCGTATGGCGTGGGGTTAGAGCTAGAAATAGCA	1	bc
CCCCGCCGAC	GAAACACCGGTTGGCTTTACTCCTTTGTGGGGTTAGAGCTATAAATAGCA	1	bc
CAGTCCGAGA	GAAACACCGGTGGCAATTCGATCTGAGTGGGGTTAGAGCTAGAAATAGCA	1	bc
TGACCGCAAT	GAAACACCGGTGTTCTTTGCTAGAGGGTGGGGTTAGAGCTAGAAGTAGCA	1	bc
AAACCCTCGC	GAAACACCGGTGACGAACGGATGGAAGTGGGGTTAGAGCTAGAAATAGCA	1	bc
GAACCAGACT	GAAACACCGGTTTTCGTGGTTGAGTAGTGGGGTTAGAGCTAGAAATAGCA	1	bc
AAACCACAAA	GAAACACCGGTGGCAATTCGATCTGAGTGGGGTTAGAGCTAGAAATAGCA	1	bc
CACTAACACA	GAAACACCGGTTCAACCGGCGTCTTTTGGGGAGTTAGAGCTATAAATATC	1	bc
CCCCCTGATC	GAAACACCGGTCTTCCCGGCGTCTTGTGTTAGATTAGGCCTGGAAACATC	1	bc
ATCCGCCACT	GAAACACCGGTTGTAAGCGATGGTTTGTGGGGTTAGAGCTAGAAATAGCA	1	bc
TCAACACAAT	GAAACACCGGTGGGCTTAGAGCAATAAATGGCATGTTAATCTAAGTCTCT	1	bc
AGCTAACCAA	GAAACACCGGTGTGCGGTGATTAAGCGTGGGAAACAGCAAGGAACTCAAG	1	bc
GGCTTTTCCA	GAAACACCGGTGCTAATAGTTAGCTCGTGGGGTTAGAGCTATAAATAGCA	1	bc
GAATTCACCC	GAAACACCGGTGCTGATAATTAGCTCGTGGGGTTAGAGCTAGAAATAGCA	1	bc
GTATGAGATA	GAAACACCGGTGAGCATGATAACGTCCGGGGGGTTAGAGCTAGAAATAGC	1	bc
AAACTGCTCG	GAAACACCGGTTTTCAGTCATAGGTCGTGGGGTTAGAGCTAGAAATAGCA	1	bc
GCCTGCCGCC	GAAACACCGGTTATGGTTACGGATTTGTGGGGTTAGAGCTAGAAATAGCA	1	bc
CCCCGACGCC	GAAACACCTGTAGAATGGATCCACTGGTGGGGTTAGAGCTAGAAATAGCA	1	bc
TCACTACTCA	GAAACACCGGTGCTGATAGGTAGCTCGTGGGGTTAGAGCTAGAAATAGCA	1	bc
AATGAAGCGA	GAAACACCGGTGCGCTTAGAGGGAGCGTGGGGAAAGAGACATAACGCTAG	1	bc
TTGTTCTGCG	GAAACACCGGTCGCGAAAATGTGCCGGTGGGGTTAGAGCTATAAATAGCA	1	bc
TTCTATGCAA	GAAACACCGGTACTAGTTACTTACGGGTGGGGTTAGAGCTAGAAATAGCA	1	bc
TAAGGAATGA	GAAACACCGGTTGAGATAATCAAAAAGGGGGGAAAAGTTAGAAATAGCAA	1	bc
AGCCCTTCGT	GAAACACCTGTTCCCGTTAGCTCGTTGGGGGGTTAAAGCTCGAAATAGCC	1	bc
CTGTCAGCAG	GAAACACCGGTGAGAACAGAACTTGTTAGAGTTAGATCTACAAATGGCAG	1	bc
TACACCCACT	GAAACACCGGTTTAATTAGTTAACTAGTGGGGTTAGAGCTGGAAATAGCA	1	bc
TAAACACACT	GAAACACCGGTGGAAATTGGTTCTTAGTGGGGTTAGAGCTAGAAATAGCA	1	bc
AGACCACAAG	GAAACACCGGTTTTAAGTGATAGGTTGTTGGGTTAGAGCTAGAGATAGCA	1	bc
TACATAACCC	GAAACACCGGTTCCCGTTAGCTCGTAGTGGGGTTAGAGCTAGAAATAGCA	1	bc
TTCTCCCCGA	GAAACACCGGTGACGGGAGGGTTAGAGCTAGAAATAGCAAGATAACCTAA	1	bc
GCGTCACACG	GAAACACCGGTTATAGTTGCGGATTTGTGGGGTTAGAGCTAGAAATAGCA	1	bc
GTGGTCTATA	GAAACACCGGTGAGAATGATAACTTCCGTGGGGTTGAGGCTGGAAATCGA	1	bc
TGCTCAACCT	GAAACACCGGTTCCCGTTATCTCGTAGTAGGGTTAGAGCTAGAAATAGCA	1	bc
CAACCACCTT	GAAACACCGGTACCGGAGGTTTCGAAGTGGGATTACCGCTAAAAATAGCA	1	bc
TTCTTAAACA	GAAACACCGGTCGCGAAAGTGTTCCGGAGGGGTTAGAGCTAGAAATAGCA	1	bc
TTATTATCAA	GCCACACCGGTGCTAGAAGCTGAGTGGTGTTAGAACTGGCAATAACACGT	1	bc
AAACCCCTGA	GAAACACCGGTTTTCGATCATAGGTTGTGGGGTTAAATCTAGAAATAGCA	1	bc
TTATCACCCT	GAAACACCGGTTGTAAGCGATGGTTTGTGGGGTTAGAGCTAGAAATAGCA	1	bc
GAATCCAACC	GAAACACCGGTGCTAATAGTTAGCTTGTTGGGTTAGAGCTAGAAATAGCA	1	bc
CCACGACGTC	GAAACACCGGCTAGCAATAGAACGTTCGTCGAGGTAGAGCTAGTTATAGC	1	bc
AACAAGGTAA	GAAACACCGGTTTTCGATCATAGGTCGTGGGGTTAGGGCTAGAAATAGCA	1	bc
GAGGGAGAGG	GGAAACCCGGTTATCGTTACGGATTTGTGGTGTTAGAGCTATAAATAGCA	1	bc
CGCTAATTAA	GAAACACCGGTGAGAACAGAACGTTTTGGGGGTAGAGCTAGGAAAAACAA	1	bc
AAGTCGCTAG	GAAACACCGGTTATCGTTCCTAGGTTGTGGGGTTATAGCTAGAAATAGCA	1	bc
TTCACCCCCC	GAAACACCGGTCGCGAAAATTTGCCGGTGGGGTTAGAGCTAGAAATAGCA	1	bc
GACCGAAACA	GAAACACCGGTGCTATGAGTTTACTGGTGGGGATAGAGCTAGAAATAGCA	1	bc
GTACGCCACA	GAAACACCGGTTGTAAGCGATGGATTTTGGAATTACAAGTTAAACTAAGA	1	bc
AACGTTAACC	GAAACACCGGTTGGCTTTACTCCTTTGTGGGGTTAGAGCTATAAATAGCA	1	bc
CAGTCACCAC	GAAACACAGGTGGGCTTTCCTCCTTTGTGGGGTTAGAGCTATAAATAGCA	1	bc
GAAACAGTTA	GAAACACCGGTGCTCGCGGGTTCCAAGTGGGGTTAGAGCTAGAAATAGCA	1	bc
TCAACCCCCT	GAAACACCGGTGGCGCTAGGGTTAGAGCTAGAAAGATAACATAAACCTAA	1	bc
AGATTTAAAA	GAAACACCGGTGCTAATTGTTAGTTCGTGGGGTTAGAGCTAGAAATAGCA	1	bc
CAGTGGACAC	GAAACACCGGTTGAGTGGATCACAGTGTGGGGGAAAGGTAATGATAGCCA	1	bc
TACACTTGCG	GAAACACCGGTTCTCGTTAGCTCGTAGTGGGGTTAAAACTAGAATAAGCA	1	bc
AATAAATCCC	GAAACACCGGTGAGCTTTAGCTAGAAATGGGGTTTTAACCTAAAGCTAGA	1	bc
GTTTCATAAA	GAAACACCGGTGGGAATGAGAACGGAGGGGGGGTTAGAGTTAGAAAAAGC	1	bc
ACACCCCTAC	GAAACACCGGTGACGAACGGATGTTAGTGGGGGTAGTGGTAGAAAAAGCT	1	bc
CCCAACGTCC	GAAACACCGGTACTAGATGCTGACTTGTGGGGGTAGAGCTAGAAATAGCA	1	bc
ATGCCAGCAG	GAAACACCGGTGATAGACGCTGGGTAAGGGGGGTTGGAGCTAAAATCACC	1	bc
CATTGAGTCG	GAAACACCGGTAGAAGTTAGCAAGGCGTGGGGTTAGAGCTAGAAATAGCA	1	bc
CCCTCAAAAC	GAAACACCGGTTCTAACAGCGTCTTTTAGGAATATAGAGCTAGCCATAGC	1	bc
AGATAAACAC	GAAACACCTGTGTTCTTTGCTCGAGGGTGGGGTTAGAGCTAGAATTAGCA	1	bc
AAGTTAATAC	GAAACACCGGTTTTCTTTACTCCTTTGTGGGGTTAGAGCTATAAATAGCA	1	bc
CACTCGGCCC	GTAACACCGGTTCAATTGGTGGCTTTTGGGAGGTTAGAGCTAGAAAAAGC	1	bc
ACAATGCTCG	GAAACACCGGTTATCGGTGATCGGTAGAGGGATTAATAGTAGGAATAGCA	1	bc
ATGTCAGGCG	GAAACACCGGTTATCGTTACTGATTTGGGGGGTTATAGCTAGAAATAGCA	1	bc
ATATAAACGA	GAAACACCGGTGCTCATAGATAGCTCGTGGGGTTAAAGATAGAAACAGAA	1	bc
TACCCTGCCA	GAAACACCGGTACTCGTTACTTCGGAGTGGGGTTAGAGCTAGAAATAGCA	1	bc
ATTACCTCCC	GAAACACCGGTCGCGAAAATGTGCCGGTGGGGTTAGAGCTAGAAATAGCA	1	bc
GCAACCCTCT	GAAACACCGGTGACGCGAGGACGGTGGTGGGGTTAGAGCTAGAAATAGCA	1	bc
AATAACTCCC	GAAACACCGGTGATCTAAGTATGTCAGGGGGGGTTAGGCCAAGAAATACA	1	bc
ACATTAACCC	GAAACACCGGTTGTAAGCGATGGTTTGTGGGGTTAGAGCTAGAAATAGCA	1	bc
AAACTATCTA	GAAACACCGTTGAGCATGATAACGTCCGTGGGGTTAGAGCTAGAAATAGC	1	bc
AAACCACCAT	GAAACACCGGTGACAAACGTATGTCAGTGGGGTTAGAGCTAGAAATAGCA	1	bc
ATACTAAATG	GAAACACCGGTGGGGGGAGTCTATACGTGAGAAATATCGAGAAATCGAAG	1	bc
CAACAGGAAC	GAAACACCGGTGCTCTCTGTTTGGGAGTGGGGTTAGAGCTAGAAATAGCA	1	bc
AGAACAAACG	GAAACACCGGTTGTAAGCGATGGATTGTTGGGTTAGAGCTGGAAAGATCA	1	bc
GAATTAGCCA	GAAACACCGGTGCTAATAGTTAGCTCGTGGGGTTAGAGCTAGAAATAGCA	1	bc
AAGCCATCCG	GAAACACCGATGACAAACGTATGTCAGTGGGGTTAGAGCTAGAAATAGCA	1	bc
AGATTCTCCC	GAAACACCGGTCTCGTTAATGTGCCGGTGGGGTTAGAGCTAGAAATAGCA	1	bc
GAGACCTGCG	GAAACACCGGTTATCGTTACGGATTTGTGGGGTTAGAGCTAGAAATAGCA	1	bc
TATCCAGCAT	GAAACACCGGTGACAAACGTATATCAGTGGGGTTAGAGCTAGAAATAGCA	1	bc
AACTCACTCG	GAAACACCGGTTTTCGATCATAGGTCGTGGGGTTAGAGCTAGAAATAGCA	1	bc
CGCCAGCGAC	GAAACACCGGTGGTATTTGCTCACGGGTGGGGTTAGAGCTAGAAATAGCA	1	bc
TGCTCTCACC	GAAACACCGGTTCCAGCTGGGTCGTGTGGGTAGTGATAGCTAGAGATAGT	1	bc
GACACAAAAA	GAAACACCGGTGCTAATAGTTACCTGGTGGGGTTGGTGGTAGAAATAGGA	1	bc
TGCCTTTCCC	GAAACACCGGTTCCCGTTACTTCGTCGTGGGGTTCGATCTAGAAATAGCA	1	bc
GAGCCACGCT	GGAACCCCGGTTATCGTTACGGATTTGTGGGGTTAGAGCTAGAAATAGCA	1	bc
AATAATATGG	GAAACACCGGTGCACTATGTGGGAACGTGGGGTTAGAGCTAGAAATAGCA	1	bc
GAATGAGAAG	GAAACACCGGTGCTCGTAGGTAGCTCGTGGGGTTAGAGCTAGAAATAGCA	1	bc
GGACTATACA	GAAACACCGGTGAGCATGATAACAACCGTGGGGTTAGAGCTAGAAATAGC	1	bc
TAATCGCACC	GAAACACCGGTTCAACCGTCGTCTTTTGGGGGGTTAGAGCTAGAAATAGC	1	bc
GCAGGCCTCT	GAAACACCGGTGTCTCTAGGACGTTAGAGCTAGAAATAGCAAGATACCCT	1	bc
AAACGGCAAT	GAAACACCGGTGCTAGCGGCTCGGAAGTGGGGTTAGAGCTAGAAATAGCA	1	bc
AATATTTTCG	GAAACACCGGTGCCGATTATGTGACCGTGGGGTTAGAGCTAGAAATAGCA	1	bc
TTCATCCTCC	GAAACACCGGTAATCTAAAGATCCCCGTGGGGATAGAGCTGGAAATAGCA	1	bc
CCGTCACCTC	GAAACACCGGTTCAACCTGCGCCTTTTGTGGGTTTAGAGCTAGAAATAGC	1	bc
AGACCGGACC	GAAACACCGGTGTTCTTAGATGGAGGGTGGGGTTAGAGCTAGAAATAGCA	1	bc
GGACAAAATA	GAAACACCGGTCTTACTAGTAACCACGTGGGGTTGAACTAGGAAATGCAA	1	bc
AAGTTAGTCG	GAAACACCGGTCCTAGAAGTTGAGATGTGGGGTTAGAGTAAGAAATAGAA	1	bc
AGCAAGCAAA	GAAACACCGGTGTTCTTTGATCGAGGGTGGGGTTAGAGCTAGAACTAGCA	1	bc
TCAACCCTCT	GAAACACCGGTGACGCGAGGACGGTGGTGGGGTTAGAGCTAGAAATAGCA	1	bc
TAATAAACAA	GAAACACCGGTGCTCTTAGTTAGCTCGTGGGGTTAGAGCTAGAAATAGCA	1	bc
TGGTGAGTGG	GAAACACCTGTCGGCGGTCGTAGGGCGTGGGGTTAGAGTTAGAAACAACA	1	bc
CGTCCAGCTA	GCGAAACACCGCGCTTGCTTGAATCCACGTGGGGGAGAGCTAGAAAAAGC	1	bc
GAAACCCCCG	GACACACCGGTTATCGTTACGGATTTGTGGGGTTAGAGCTAGACATAGCA	1	bc
TACCCTGATT	GAAACACCGGTATTCGTTGAATACAGGTGGGGATAGCACGATAACTTAAA	1	bc
AACACATCAT	GAAACACCGGTGTCAGATGAATGTTTGTGGGGTTAGAGCTAGAAACAGCA	1	bc
CCCCTTCCCC	GAAACACCGGTTTTCGATCATATGTCGCGGGGTTAGAGCTAGAAATAGCA	1	bc
ACTCGTGCCG	GCAACACCGGTGCCCTTTATGCGCGCGTGGGGTTAGAGCTAGAAATAGCA	1	bc
ACTTAGTACC	CTAAACACCGGTGGAGTTTGCTAAATGGGGGGGATAGAGATAAATATCAC	1	bc
GTATATAATC	GAAACACCGGTGAGCATGATAACGTCCGTGGTGTAGAGCTAGAAATAGCA	1	bc
CCATCAAAAC	GAAACACCGGTTCAAATGGCGTCCTTTGGGGGGTTAGAGCTAGAAATAGC	1	bc
GCAACAATTA	GCAACACCGGTGAGCATGATAACGTCCGGGGGGTTAGAGTTAGAAATAGA	1	bc
AAATATATCC	GAAACACCGGTTCACTTTATGAAAACGTGGGGTTAGAGCTAGAAATAGCA	1	bc
GACTACAACA	GAAACACCGGTGGCAATAGTTAGAGCGAGAAATAGCAAGTTAACCTAAGG	1	bc
AAATCCATAA	GAAACACCGGTGCTAATAGTTGGGTCGTGGGGTTAGAGCTAGAAATAGCA	1	bc
GACACAGATC	GAAACACCGGTCATCTTAGAATCTACGTGGGGAAGAGGTTGGAAATGGAA	1	bc
ACCACGCAAG	GAAACACCGGTGGGGGTAGATCTAGAAATGGCATGTTAACCTAAAGCTAA	1	bc
GTACTATCTG	GAAACACCGGTGAGAGTGATAGCGTCGGTGGGGTTATAGCTAGAAATAGC	1	bc
ACTTACCAAC	GAAACACCGGTGTTCTTTGCTCGTGGGTGGGGTTAGAGCTAGAAATAGCA	1	bc
AAAATGATGA	GAAACACCGGTTTTGGATCATAGGTAGTGGGGTTAGAGCTAGAAATAGCA	1	bc
GAATACATCA	GAAACACCGGTGCTCATAGTTAGCTCGTGGGGATAGAGCTAGAAATAGCA	1	bc
AGACAGGACG	GAAACACCGGTGCACTTTACTCGATGGTGGGGTTAGAGCTAGAAATAGCG	1	bc
GGGTAACGAG	GAAACACCGGTTATCGTTGCGGATTTGTGGGGTTAGAGCTAGAAATAGCA	1	bc
GACTATTCCC	GAAACACCGGTAGTGAATACGTGCGGGTGGGGTTAGAGCTAGAAATAGCA	1	bc
CGCTCATCCC	GAAACACCGGTGGCGACAGAACGTTGTTGGGGTATAGCTAGGAATAGCAA	1	bc
ATATTACAGA	GAAACACCGGTGTGAGGAGATTATGCGTGAGATTTAGCAAGTAAATAAAG	1	bc
AATAAGGTAG	GAAACACCGGTTTTCGATCATAGGTCGTGGGGTTAGAGCTAGAAATAGCA	1	bc
AATTGGGATG	GAAACACCGGTGGTCATTCGATCTGAGTGGGGTTAGAGCTAGAAATAGCA	1	bc
CGCCGGCTTC	GAAACACCGGTCGACGCTCGTAGTTCGGGGGGTTTGGGCCTGGAATTGCA	1	bc
CGCTCTTCCA	GAAACACCGGTGAGAACAGAATGGTATGGGGTTAGAAGTAGAAATAGCAA	1	bc
CCCCGCCGCC	GAAACACCGGTAGAATGGATCCACGGGTGGTGTTAGAGCTAGAAATAGCA	1	bc
AGCAATCTCC	GAAACACCTGTACCCTTTATGTGCCCTTGGGGTTAGAGCTAGAAATAGCA	1	bc
GAATGAGATA	GAAACACCGGTGCTAGTAGTTTGCTCGTGGGGTTAGAGCTAGAAATAGCA	1	bc
GCCTACGCCA	GAAACACCGGTCCTAGTAGATGAGGGGGGGGAGAGCTAGAAAAAGCAGGG	1	bc
CTGACCGACT	GGAACACCGGTCCTAGAAGCTGAGTTGTGGGGTTAGAGCTAGAAATATCA	1	bc
TGCCCGTACT	GAAACACCGGTTGCGGTTAGCTCGTGGAGGGGTTAGATCTCGTAAGAGTA	1	bc
TCACCAAGCC	GAAACACCGGTGGGGTTAGAGCTAGAGTGGGCAAAGTAACCTAAATATAG	1	bc
CCCCGCCGCC	GAAACACCTGCGAGAAATGTCACGATGTCCTATTACAGCTACGTTAACAA	1	bc
GAGTTAAATG	GAAACACCGGTTATCGTTACGGGTTCGTGGGGTTAGAGCTAGAAATAGAA	1	bc
GAACTAAATT	GAAACACCGGTGCTAATAGTTAGCTCGTGGGGTTAGAGCTAGAAATAGCA	1	bc
AATCCAACCT	GAAACACCGGTTATCGTTACGGATTTGTGTGGTTAAAGCTAGAAATAGCA	1	bc
AGTAGTTCCT	GAAACACCGGTTCCCGGGAGCTCGTAGTGGGGGTAGTGACAGGTTCACCT	1	bc
GGGGCTGACA	GAAACACCGGTGAGAGATCTTTCGGGTGGTAGAGCTAGAAAGAGCAAGCT	1	bc
AAACATGACA	GAAACACCGGTACTAGTTGCTTGAGGGTGGGGTTAGAGCTAGAAATAGCA	1	bc
TCCCCAAATT	GAAACACCGGTCTTCATCGAGTCTACGTGGGGTAGAACTAGAAATTACCA	1	bc
TGCTTTTCAC	GAAACACCGGTTCCCGTTAGCTCGTAGTGGGGTTAGAGCTAGAAATAGCA	1	bc
TAAACACACA	GAAACACCGGTGGCAAGTCGATCTGAGTGGGGTTAGAGCTAGAAATAGCA	1	bc
AATTCTGAAA	GAAACACCGGTGGCAATTATAGCACCGTGGGGTTAGAGCTAGAAATAGCA	1	bc
GTCTTAAAGA	ACGTCCGCAACACCGGTGCTCGTAGTTAGCTCGTGGGGTTAGACCTCGAA	1	bc
AGCTGTGCAT	GAAACACAGGTTCTCGGTAACTCGGAGTGGGATTAGAGCTAAAATTAGCA	1	bc
GAGTGCAGGG	GAAACACCGGTTATCTTTCCGGATTTGTGGAGTTCGAGAAAGAGATAGCT	1	bc
AAACCGCCAC	GAAACACCGGTGTTCTTAGCTGTAGGGTGGGGTTAGAGCTAGAAATAGCA	1	bc
AACACGCCCG	GAAACACCGGTTTTCGAACATAGGTCGTGGGGTTAGAGCTAGAAATAGCA	1	bc
AGCCCTGCCG	GAAACACCGGTCCTCGTTAGCTGGTATAGGGGTTAGAATTAGAAGTTACA	1	bc
GTCGCTTCCT	GAAACACCGGTTCCCGTTAGCTCGGAGTGGGGTGAGAGCTAGAAATAGCA	1	bc
TAATCCATGC	GAAACACCGGTTTAGATAGTAGAGAATAGAGGTAGAGATAGCAATAGAAC	1	bc
CGTTATTTAA	GACACACCGGTGAGAACTGCTCGTGTTGGGGTTAGGGCTTGGAATAGCCA	1	bc
CCATCATCCG	GAAACACCGGTGAGAACAGAACGTTTTGGGGTTAGAGCTAGAAATAGCAA	1	bc
AATCATTCAT	GAAACACCGGTTCCCGATGTCTCTCAGTGGGGTTAGAGCTAGAAATAGCA	1	bc
AGGCAACCAC	GAAACACCGGTGTGCTTTGCTCGTTGGTGGGGTTAGAGCTAGAATAAGAA	1	bc
GCAAGGGATA	GAAACACCGGTGAGGGTGATAACGTCCGTGGGGATAGAGCTAGATAAACC	1	bc
TCCTCACACA	GAAACACCGTTGGGGTTAGAGCTATAAATAGCAAGTTAACCTAAGGCTAG	1	bc
ACTTCAGCAA	GAAACACCGGTTATGGGGGAGTCGGAGCTGGAGATATCACATTATCCTAT	1	bc
TCCACGCACT	GAAACACCGGTTCCACCGGGGTCGTATGTGGAGTTAGAGCTAGAAATAGC	1	bc
GACACTGTAT	GAAACACCGGCTCTCGCTAGCTACGGGTGGGGTTAGAGCTAGAAATAGCA	1	bc
TGAGCTACCT	GAAACACCGGTTGGCGTTGAGTTGGAAGTGGGGTGATAGCTTAAAGCTGG	1	bc
TTGACTGCCT	GAAACACCGGTTCTAGAACTTGAGTTGGGGTGGTACAGCAAGTAGAAGCA	1	bc
ATGAGGGTTG	GAAACACCGGTCGTAGAAGCTAAGGCGTGGGGTTAGAGCTAGAAATAGCA	1	bc
TTATTCACAA	GAAACACCGGTCGCGAAAGTGTGCCGGAGGGCATAGAGCTATAAAGAGAA	1	bc
AAACCCAAGA	GAAACACCGGTGCTAATAGTTAGCTCGTGGGGTTAGAGCTAGAAATAGCA	1	bc
TGATAGCTCC	GAAACACCGGTGTTCTTTGCCCGAGGGTGGGGTTAGACCTAGAAATAGAA	1	bc
GAGCCAAAAG	GAAACACCGGTGATCTTTGCGCGATGGTGGGGTTAGAGCTAGAAATAGCA	1	bc
CATTCACCCC	GAAACACCGGTGGCAATTCGATCTGAGTGGGGTTAGAGCTAGAAATAGCA	1	bc
CCTCATGCCG	GAAACACCGGTGCACTTTATGGGACCGTGGGGTTAGAGCTAGAAATAGCA	1	bc
ATGTTAGTAG	GAAACACCGGTCATAGAAGCTGGGTTGTGGGGTTAGAGCTAGAAATAGCA	1	bc
CAGCTGCTAG	GAAACACCGGTTGTCGATCGTAGGTCGTGGGGTTAGAGCTAGAAATAGCA	1	bc
AAACTAACAC	GAAACACCGGTGACAAACGTATGTCAGTGGGGTTAGAGCTAGAAATAGCA	1	bc
GAATTACACT	GAAACACCGGTGCCGCTAGTTAGCTCGCTGGGATAGACCAAGTAACCTCA	1	bc
AACTCACAAG	GAAACACCGGTGGCCGTTCAAACTGAGTGGGGTAAGAGCTAGAATAAGAA	1	bc
AAAATAGAAA	GAAACACCGGTGCCCATTATGAGACCGTGGGGTTAGAGCTAGAAATAGCA	1	bc
TAAATCTATA	GAAACACCGGTTTGCATAGTAACCTCCGTGGGGTTAAACCTAGAATTGCC	1	bc
CAGGGAGGGT	GAAACACCGGTCGTCGTTCGAAGGGCGTGGGGTTAGAGCTAGAAATAGCA	1	bc
GAACGCGAGT	CTAAACACCGGTGCTAGCGGTTTCGAGGTGGGAATAGAAATAGAAATAGA	1	bc
GACTGAGCAA	GAAACACCGGTGCTAGTGGCTTACGAGTGGGGTTAGAGCTAGAAATAGCA	1	bc
CAACATGCTC	GAAACACCGGTTTTCGAACATAGGTCGTGGGGTTAGAGCTAGAAATAGCA	1	bc
CGGGGGATGC	GAAACACCGGTCGGCGTTCGTAGGGCGTGGGGTTAGAGCTAGAAATAGCA	1	bc
GCATTAACCC	GAAACACCGGTGCTAATAGTTAGCTCGTGGGGTTAGAGCTAGAAATAGCA	1	bc
CCGATATCTC	GAAACACCGGTTGGCTTGACTCCTTCGTGGGGTTAGAGCTAGAAATAGCA	1	bc
CAACTCGCTT	GAAACACCGGTGCTAGCTGTTTCGAAGTGGGGTTAGAGCTAGAAATAGCA	1	bc
AGCATGTCAA	GACACACCGGTGTTCTCTGATCGTTCTTGGGTTTGAGCTAGGAAATGGAA	1	bc
AGGAACCAAG	GAAACACCGGTCCTCGTAGCTGGGGTGTGGGGTTAGAGCTAGAAATAGCA	1	bc
GACACATGCG	GAAACACCGGTTATCGTTATGGATTTGTGGGGTTAGAGCTAGAAATAGCA	1	bc
ATCACACACG	GAAACACCGGTTGTAAGCGATGGTTTGTGGGGTTAGAGCTAGAAATAGCA	1	bc
CACTAACACC	GAAACACCGGTTCAACCGGCGTCTTTTGGGGGGTTAGAGCTATAAATATC	1	bc
CCAGCAGATG	GAAACACCGGTCGGGTTTGAGATAGAGATAGCAAGGTACCATAAGGCTCA	1	bc
TCCGCAGATC	GAAACACCGGTCTGGCTGGAGTCTTGAATGGGCATATAGCCATAAGGTGC	1	bc
GCCATGCATC	GGAACACCGGTCGACCCTGCGAATTTTGGGGGGATAGCTATAGAAATAGA	1	bc
ATAAAAGACG	GAAACACCGGTGCTAATCATTGGTTTGTGGGGTTAGAGCTAGAAATAGCA	1	bc
AACTAAGCAA	GAAACACCGGTACTAGTTGCTTACGGGTGGGGTTAGAGCTAGAAATAGCA	1	bc
CGGCCGGACG	GAAACACCGGTCGTCGTCCGTAGTGCGTGTGGTTAGAGCTAGAAATAGCA	1	bc
GACTCAGCCG	GAAACACCGGTCTTCGTGGAATCTGGAGTGAGCCAAGAAACCTAAATCTC	1	bc
GGGACTACCT	GAAACACCGGTTATCGTTAGCGAGTAGTGGGGTTAGAGCTAGAAATAGCA	1	bc
ATCCCCCCCT	GAAACACCGGTTGTGATCGATGGTTTGTGGGGTTAGAGCTAGAAATAGCA	1	bc
AGCCCTCCCT	GAAACACCGGTTCCCGTTAGCTCGTAGTGGGTTAGAGCTAGAAATAGCAA	1	bc
AGAACCCACT	GAAACACCGGTGTTCTTAGTTTGCGGGTGGGGATAGAGCTAGAAATAGCA	1	bc
CCCTGCCGCC	GAAACACCGGTAGAATGGATCCGCGGGTGGGGTTAGAGCTAGAAATAGCA	1	bc
AAACCAGTCG	GAAACACCGGTGCTGGCGGATTTAAAGATGGGTTAGAACTAGAAAGCGAA	1	bc
GAGGGCGCCA	GAAACACCGGTGTGATGCAAGGTTAAGTAGGGTTAGTCCGATATAAACTT	1	bc
GACTTCCAAC	GAAACACCGGTACTAAAAGTAAGCTCGTGGGGTTAGAGCTAGAAATAGCA	1	bc
GCGACACGCG	GAAACACCGGTGATCGTTGGGGATTTGAGTGAGAAAAAGTAGAAATAGCA	1	bc
AAACCCTTGA	GAAACACCGGTGTGGTAGGGAGCGTAGTGGGGGTAGAGGCAGAAATTGGA	1	bc
GGCTTAACAT	GAAACACCTGTGCTCATAGTTAGCTCGTTGGGTTAGAGCTAGAAATAGCA	1	bc
TGCTCTTCAA	GACACACCGGTGACAACAGAATGTTAGTGGGATAGAGCCAGAAATAGCAA	1	bc
GCAACAAATA	GAAACACCGGTGAGGATGGTAATGGCCGTGGCGAGATAACCTTGGACTGC	1	bc
ATATTATACC	GAAACACCGGTTGTGACCGTTTGCTTGTGGGGTTAGAGCTAGAAATAGCA	1	bc
ATGATCGCCC	GAAACACCGGTCCTAGAAGCTGAGTTGTGGGGTTAGAGCTAGAAATAGAA	1	bc
ATCTAACCGA	GAAACACCGGTGTGCGGAGATTATGAGTGAGAAATAGCAAGTAACCTAAG	1	bc
ATGATGGCCC	GAAACACCGGTCCTAGAAGCGGAGTTGTGGGGTTAGAGCTAGAAATAGCA	1	bc
ATCTCTTCCT	GAAACACCGGTTCCCGTTAGCTCGGAGTGGGGTTAGAGCTAGAAATAGCA	1	bc
GTCTAAGCAA	GAAACACCGGTACTCGTTACTTATGGGTGGGGTTAGAGCTATAAACTGCA	1	bc
GATAAATACA	GAAACACCGGTGCGCTTTGTGCGAGCGAGGGGTTAGTACTCTAAAGAGCG	1	bc
AATACACCAA	GAAACACCGGTGGCCATTAGATCTGCGTGGGGTTAGAGCTAGAAATAGCA	1	bc
AACACCGACC	GAATCACCGGTCCTAGAAGCTGAGTTGTGGGGTTAGAGCTAGAAATAGCA	1	bc
AGAAACCAAT	GAAACACCGGTGTTCTTAGCTAGCTAGTTGGGTTAGAGCTAGAAATAGCA	1	bc
AAGTCAAAAG	GAAACACCGGTTATCGTTACGGATTTGTGGGGTTAGAGCTAGAAATAGCA	1	bc
ATGAAGCTAG	GAAACACCGGTCCTATAAGCTGGGGGGTGGGGTTAGAGCTAGAAATAGCA	1	bc
AATACGTCAG	GAACCACCGGTTTTCGTTCAAAGGCCGCGTGGTTAGATCTAGTAATAGTA	1	bc
TGGCGGGATT	GAAACACCGGTCGTCGTACGTAGGGCGTGGGGTTAGAGCTAGAAATAGCA	1	bc
TAAACACACG	GAAACACCGGTTTTCTAAGTTAAGTTTGGGGGTTAGAGCTAGAAATAGCA	1	bc
TAATCAAAAC	GAAACACCGGTTTTCATAGTTAACTAGTGGGGTTAGAGCTAGAAATAGCA	1	bc
TGTCACGCTT	GAAACACCGGTCTTCCTTGAATCTACGTGGGGTAGAGCTAGGAATAGCAA	1	bc
GACTCTTCAA	GAAACACCGGTACTCTAGACTTACGGGGGTGGCTAGAGCCTAGTCCGTCA	1	bc
CGGAGTTCTT	GAAACACCGGTCGTCGTTCGTACGGCGTGTGGTTAGAGCTAGAGATAGCA	1	bc
GGGTCAGACT	GAAACACCGGTTCTCGTTGCGTCTTTGTGGGGTTAAGGCTCGAAATAGCA	1	bc
TGGTCAGGCT	GAAACACCGGTTATCGTTACGTCTTTGTGGGGTTGGGGCAGGAAATGGCA	1	bc
