GTAATATATA	GAAACACCGGTCGTCGTTCGTAGGGGTGGGGTTAGAGCTAGAAATAGCAA	6	bc
ATACCACACT	GAAACACCGGTTGTAAGCGATGGTTTGTGGGGTTAGAGCTAGAAATAGCA	3	bc
AAACCCGCGG	GAAACACCGGTTTAGTATGTGGGGTTAGAGCTAGAAATAGCAAGTTAACC	2	bc
ACTCGCACCC	GAAACGCCGGGGTTAGAGCTAGAAATAGCAAGTTAACCTAAGGCTAGTCC	2	bc
AACTTGTCAG	GAAACACCGGTCGCGAAACTGAGGCGGTGGGGTTAGAGCTAGAAATAGCA	1	bc
CGTTGCTCCA	GAAACACCGGGGATAAAGATAGAAATAACCTGTTAACCTACCGCTAGTAC	1	bc
GTATCATCTG	GAAACACCGGTTTTAGTAATTGGTGCATTGTGGCTAGAGCTAGGAATAGC	1	bc
ATCAAACATA	GAAACACCGGTGTGCTTAGAGTGTTCGTGAGAAATAGCAAAGAATATAAT	1	bc
CCCTTCACAG	GAAACACCGGTTGCCTCCACTCCCTTGTGGGGTTAGAGCTAGAAATAGCA	1	bc
GTGGGCGAGA	GAAACACCGGTGGGGTTAGAGCTAGAAATAGCAAGTTAACCTAAGGCTAG	1	bc
GGCAACAACG	GAAACACCGGTGACAGCCAGCAACTTGTGGGTTTAGAGCTAGAAATCGCA	1	bc
GGACAGCACG	GAAACACCGGTGATCTTTGCGCGAGGGTGGGGTTAGAGCTCGAAATAGCA	1	bc
CAACGCATTT	GAAACACCGGTGTAGGCGGTTTGGAAGAGGGTTGAAAGATCAAAATAGCA	1	bc
TCATCCACCT	GAAACACCGGTGAGGCGAGCTTTAGAGTGAGAAATAGCAAGTAAACCTAA	1	bc
ATTACTGACG	GAAACACCGGTGCCCTTTATGGGACCGTGGGGTTAGAGCTAGAAATCGCA	1	bc
CACACCCTAC	GAAACACCGGTAATATAAAGATACCCGTGGGGATAGAGCTAGAAATAGCA	1	bc
GACCAAGCCA	GAAACACCGGTTTTAGTAAATGGTGGGGGGGGGTTGGAGCTGAAAATAGC	1	bc
AATACATTAT	GAAACACCGGTGACAAACGCATGTCAGTGGGGTCAGAGTTAGAATTAGCA	1	bc
AATTGAGCAA	GAAACACCGGTTGTGGGGAACTCGGTGTGGGAGAAATAGCAAGTTAACCT	1	bc
TCAACTTACT	GAAACACCGGTTCCCGTTGACTCGTAGTGGGCTTAGAGCTAGAAGTCGCA	1	bc
ATGACCTCAC	GAAACACCGGTCCTAGAAGCTGGGCTGGGGGGGTAAAACTAGAAAATAGA	1	bc
CCTCACACCC	GAAACGCCGGGGTTAGAGCTAGAAATAGCAAGTTAACCTAAGGCTAGTCC	1	bc
ATGACAGACA	GAAACACCGGTCCTAAAAGCTGAGGTGGGGGGGTTAGAGCTAAAATTAGC	1	bc
AGCATTAAAA	GAAACACCGGTGCTAATATTTAGCTCGCGGGGTTGGAGCTAGAAATAGCA	1	bc
TAATTTACAC	GAAACACCGGTTGAGATAATCAAAAAGTGGGGTAGAGCTAGAAATAGCAA	1	bc
GTAATATATA	GAAACACCGGTCGTCGTTCGTAGGGGTGGTGTTAGAGCTAGAAATAGCAA	1	bc
AAGACAATCG	GAAACACCGGTTATCGAGGATGATTTTGTGGGGTTAGAGCCAGAAATAGG	1	bc
GCAATAAACA	GTAACACCGGTGGTCGCCGTGGAGGGGGTGGGGATCGAGCTAGAAATAGC	1	bc
TATGCCGCCT	GAAACACCGGTGACGGGGAAGTTAGAGCGGGAAATAGAACGTTAACCTAA	1	bc
TACACCCTTC	GAAACACCGGTAATCTAAAGATCCCCGTGGGGATAGAGCTAGAAATAGCA	1	bc
AGCTAAGATT	GAAACACCGGTCTGCGGGGAATATGCGTGAGAAGTAGTAGATAACCTAAG	1	bc
ATTACAGGTT	GAAACACCGGTCCTAGAAGCTGAGTTTGCGGGGTTAGAGCTAGAAATAGC	1	bc
CCATCAAAAC	GAAACGCCGGGGTTAGAACAAGTAATAATAGCATGATATCCTAATAGTAG	1	bc
CGCTCATCCG	GAAACACCGGTTTTAGAAGAAGGTTTTGTGGGGTTAGAGCTAGAAATAGC	1	bc
TTTTCCCCCC	GAAACACCGGTCGCGATAATGTGTCTGTGGGGTTAGAGCTCGAAATAGCA	1	bc
CGGCGGGAAC	GAAACACCGGTGTTCTTTGCTCGAGGGTGGGGTTAGAGCTAGAAATAGCA	1	bc
AAACCCGTTT	GAAACACCGGTGGTGTAGGTCTCGATATATCAAGTTAATATAAGGCTAGT	1	bc
TAAACCTCCT	GAAACACCGGTTCCCGTGGGGTTAGAGCTAGAAATAGCAAGTCAACCTAA	1	bc
GAGTTATACA	GAAACACCGGTGTTCGTAATAGGGGAAGAGGTGTTAGAGCTAGGATTAGC	1	bc
AACATGCTAG	GAAACACCGGTTTTCGATCCTAGGTCGTGGGGTTAGAGCTAGAAATAGCA	1	bc
TCCCCAGGTT	GAAACACCGGTCGACCGGAACTACGGGTGTGGTAAAGCTAGAAATAACCA	1	bc
ACCTCGCTAC	GAAACACCGGGGATAAAGCTATATAAAGCAGGTTAAACTAAGAAATGGAA	1	bc
ATACCATACC	GAAACACCGGTTACAACCGATTGTTAGTGGGGTTAGAGCTAGAAATAGCA	1	bc
AACTCACCAA	GAAACACCGGTGTACGGAGATTATTCGTGGGGAATGACATGGAAACAAAG	1	bc
GAAAAACCCC	GAAACACCGGTGTTCTTTGCTCGCGGGTGGGGTTAGAGCTAGAAATAGCA	1	bc
GTCTACCCCA	GAAACACCGGTATTCGAAGATTATGCGTGGGAAATAGCAAGGAACCTACG	1	bc
GAAGAAATCC	GAAACACCGGTAATGTAAAGATCACAGTGGGGATAGAGCTAGAAATAGCA	1	bc
GGCAACTACG	GAAACACCGGTAGCAGCCAGCCACTTGTGGGGTTAGAGCTAGAAATAGCA	1	bc
AAACCGCGAC	GAAACACCGGTGTTATTAGCTCGCGGGTGGGGTTAGAGCTAGAAATAGCA	1	bc
CCCTTTAACC	GAAACACCTGTTGAGATAATCAAAAAGTGGGGTAGAGCTAGAAATAGCAA	1	bc
AACATGCTAG	GAAACACCGGTTTTCGATCATAGGTCGTGGGGTTAGAGCTAGAAATAGCA	1	bc
AAGATAACAC	GAAACACCGGTTGGCTTTACTCCTTTGTGGGGTTAGAGCTATAAATAGCA	1	bc
GGATACGACG	GAAACACCGGTGTTAGTCAATCGAGAGTGGGGTTAAAACCAGAAATTGCA	1	bc
TCATGCAACA	GAAACACCGGTTGGATGCATGATAACGTGAGGCAGGTCTCGTATTAGCTT	1	bc
TGCATATCCC	GAAACACCGGTTGCGGAGGGGTAAAAGTTGGAAGTAGCAAGATAACCAAA	1	bc
ATCCACCCTC	GAAACACCGGTGACGCGAGGGTTAGAGCTAGAAATAGCAAGTTAACCTAA	1	bc
AAATCAGCAA	GAAACACCGGTGGGGGTGAAGGCAGAAAGGGGGAATTAACCTAAGGCTCG	1	bc
GTGACCAGCG	GACACACCGGTTATCGTTACGGATTTTGTGGGGTTCGAGCTAGAAATAGC	1	bc
AATTTAACAA	GAAACACCGGTGCTAATAGTTAGCTCGTTGGGTTAGAGCTAGAAATAGCA	1	bc
ATATTCTACC	GAAACACCGGTCGCAAACGTGTGCGGGTGGGGTTAGAGCTAGAAATAGCA	1	bc
CTCTCATCGA	GAAACACCGGTGTGCGGAGATTATTCGTGAGATATAGCAAGTAATCTCAG	1	bc
ATCAGCACCA	GAAACACCGGTGAGGTAAGAGCTATAAATCGCAAGTTAACCTAAGGCTAG	1	bc
AAACAGCTCC	GAAACACCGGTGTTCTTTGCTCGAGGGTGGGGTTAGGCCTAGAAATAGCA	1	bc
CCATCAGGCG	TGGGGGAAGGGAGGAAACACGGGAGTTAGTAAATGGGGAGGGGGGTTGTG	1	bc
GTAATATATA	GAAACACCGGTGAGCATGATAACGTCAGTGGGGTTAGAGCTAGAAATAGC	1	bc
AATTTCTCAC	GAAACACCGGTGACAAAAGTATGTCAGTGGGGTTAGAGCTAGAAATAGCA	1	bc
AATTCCTAAA	GAAACACCGGTGACAAACGTATGTCAGTGGGGTTAGAGCTAGAAATAGCA	1	bc
GATTACCCAC	GAAACACCGGTAATGGAGAGATCCGCGTGGGGGTAGAGCTATGTTTAGCT	1	bc
CCTCCAACAC	GAAACACCGGTGACATTTACACGTTTGTGGGGTTAGAGCTATAAATAGCA	1	bc
AGTCCATACT	GAAACACCGGTCTTCCTTGAATGTACGTGGGGTAGAGCTAGAAATAGCAA	1	bc
GAATTCAACC	GAAACACCGGTGCTAATAGTTAGCTCTTGGGGTTAGAGCTAGAAATAGCA	1	bc
AAATCACTCA	GAAACACCGGTGTCAGTTCGAGGTGAGTGGGGTTAGAGCTAGAAATAGCA	1	bc
TAAAACCACC	GAAACACCGGTTTACTTAGTTACCTAGTTGGGTTAGAGCTAGAAATAGCA	1	bc
AGTCAAGCTT	GAAACACCGGTCTTCCTGGAATCTACGTGGGGTAGAGCTAGAAATAGCAA	1	bc
AACATGCTTG	GAAACACCGGTCCTAGAAGATGAGTTTGTGGGGTTAGAGCTAGAAATAGC	1	bc
ATCTTATCGC	GAAACACCGGTCGCGAGAGTGTGCCGGTGGGGATAAAGAAAGAACTAAAA	1	bc
TAATCAAACA	GAAACACCGGTTGAGATAGTGCCATAGAGGGGAAGAGAACTTAATAGAAA	1	bc
CACTCGGACG	GAAGCACCGGGTTTAGAGCTAGGAATAGCAAGTTAAACTAAGGCTAGTCC	1	bc
AATCCAGATA	GAAACACCGGTCTTCGTGGAATCTCCGTGGGGTAGAGCTAGGAAACCCAA	1	bc
AAGTAAAGGG	GAAACACCGGTTTTCGTTGATGATTTTGGGGAGATAGCGCGAGAAATAGC	1	bc
GAACCATCAA	GAAACACCGGTGATAATCGTATGTCAGTGGGGTTAGAGCTAGAAATAGCA	1	bc
TATGCAACAC	GAAACACCGGTGAGAATCGAATTAGAGTTGGGATAGTGCTATAAAGATCA	1	bc
TTAATCTCAT	GAAACACCGGTGGCGTTAGTTTGCTAGTGGGTTTAGAGCCAGAAATAGCC	1	bc
AGCACTTAAT	GAAACACCGGTGCCAGTGGGGTTAGAGCGGGGATAAACCAGGAAATAGAA	1	bc
CCACCAACAC	GAACCCCCGGTTGGCTTTACGCCTTTGTGGGGTTAGGGTTATAATTGCAA	1	bc
TGGTTAACCC	GAAACACCGGTTTTCTTTACTTCTTTGTGGGGTTGGAGTTATAATAAGCA	1	bc
AGGTCCTCCA	GAAACACCGGTCCGAGCAGCCTGGTTTTTGGAAGTAGAGCTAAGGCTAGC	1	bc
CCCCCCCTCT	GAAACACCGGTGACGCGAGGGCTAGAGCTGGGAAAAACCAGTTAACATCA	1	bc
AGGGAGAAAA	GAAACACCGGTGTTGTTAGAGCGAGAAAGAGCATGTTAATCTAAGTCTAA	1	bc
AGCCCACAGA	GAAACACCGGTTTACCGGGAATCTATGGGAGAAATAGCAAGTAAACCAAC	1	bc
TTTTCAGCAA	GAAACACCGATCTTCCTGGAATCTACGTGGTGTAGATCTAGAATTAGCAA	1	bc
CAGTCAGTCG	GAAACACCGGTTCTAGTTGCTGATTAGAGGGGGTAATAGCAAGATAACCT	1	bc
GAGTGAGACG	GAAACACCGGTTATAGTCCATGGTGACGTGGGGTTAGAGCTAGACCTAGC	1	bc
TACTTATCAC	GAAACACCGGTGGTGAAAGTGTGCTGGTGGGGTTAGAGCTAGAAATAGCA	1	bc
CACACGGACC	GAAACGCCGGGGTTAGAGCTAGAAATAGCAAGTTAAACTAAGAAAAGTCC	1	bc
AACCCTTCCC	GAAACACCGGTGACAAACGTATGGCAGTGGGGTTAGAGCTAGAAATAGCA	1	bc
TAATCAGAAA	GAAACACCGGTGGTGGTAAAGATAGAGAGGGGAAAGAGACATAAAGAGCA	1	bc
GAACCATCCC	GAAACACCGGTTTTAAACGATTGTCAAGGGGGTTTAGAGTTGGAATAGGC	1	bc
AACATGGTAG	GAAACACCGGTTTTCGAAGATAGGTCTGGGGGGTAAGACTTGAAATAGGA	1	bc
CTCCTATGCC	GAAACACCGGTAGGATGGGTCCAAGGTAGAAACAGTAAGCTTACCTATGG	1	bc
GACACAATCC	GAAACACCGGTAATCTAAAGATCCCCGTGGGGGTAGAGCTAGGAATAACA	1	bc
ATGCACTTCA	GAAACACCGGTTCCCGTGGGGTTAGAGCTAGAAATAGCAAGTTAACCTAA	1	bc
GTAATATATA	GAAACACCGGTGATCATGATTGCGGAGCAGGTTATACTGCTACTAGTCGC	1	bc
TGACCCCACT	GAAACACCGGTGTTGCTAGGGTTAGCGCTGGGTATAGCAAGTAAACGTAA	1	bc
ATAACCCCCT	GAAACACCGGTGAGGCGAGGGTTGGAGCGAGAAATAGCAAGTTAACTTAA	1	bc
GAGTTCAAAC	GAAACACCGGTGCTCATCGTTAGCTCGTGGGGCTAGAGCTAGAAATAGCA	1	bc
ATGATCGATG	GAAACACCGGCGCTAGTAGATGTGGTTGTGGGGAGATAGTTAGAAACAGG	1	bc
ATCTTGCCAC	GAAACACCGGTGTCGGTAGTGTGTGGGTGGGGTTAGAGATAGAAATAGCA	1	bc
TCACCACACA	GAAACACCGGTGGGATGAGAGCTATAAATGGGATGTTAACCGAAGGATAG	1	bc
GAGACACGCT	GAAACACCGGTTTTCGTTGCGGATTTTGGGGGGTTAGAGCTAGAAATAGC	1	bc
AGAACTCCCT	GAAACACCGGTGTTAGTTGGGCGAGAGCTAGAATAAGGAAGGTAATCGAA	1	bc
GACTGTGATT	GAAACACCGGTACTAGCGGCTTCCGGGTGGGGTTAGAGCTAGAAATAGCA	1	bc
TGGACAGCCT	GAAACACCGGTCGGCCTTAAATCTATGTGGGGTTAGAGCTAGAAATAGCA	1	bc
AGCCAACATA	CTGAACACCGGTGTGCGGGGAATATGCGTGAGAAATAGCAAGTAACCGAA	1	bc
TCAGTAAACC	GAAACACCGGTTGAGATAGTGCTAGAAATGGGAAGTGAAACAAATAGTAA	1	bc
GCGGGCGACA	GAAACACCGGTGCCCTGTATGGGACCGTGGGAATAGAGCTATAAATAGCA	1	bc
ATTTCAGCAA	GAAACACCGGTCCTAGTAGCTTATGTGTGGGGGTTAGGCTTGAAATTACC	1	bc
AAACCCGTTT	GAAACACCGGTCTTGCATGTGTCGATATGGCGAGAAATAGCAAGTTGACC	1	bc
AGCCACCCCC	GAAACACCGGTGCCCTTTATGCGAGGGTGGGGTTAGAGCTAGAAATAGCA	1	bc
CAGCTACATA	GAAACACCGGTGGCCATTCGATCGGATGGGGGTTGAAATATGAAATTAAC	1	bc
ATTCTTCTAC	GAAACACCGGTCGCGAAAATGTGCCGGTGGGGTTAGAGCTAGAAATAGCA	1	bc
AAACCCCTCC	GAAACACCGGTTTTCTATGTGTGGTTGTGGGTATAGATCTCAAAATAACC	1	bc
AATTGGTCAA	GCAACACCGGTTGCGAGCGTCTCGCAGTGGGGGTAGTGGCAGGTTTACCT	1	bc
CCCTTGCCAC	GAAACGCCGGGGTTAGAGATAGAAATAGCGAGTTAACCTAAGGATAGTCC	1	bc
TTAATCTTCT	GAGACACCGGTGAGGCGAGTGTTAGAGCTAGAAATAGCAAGATAACTTAC	1	bc
TGAAAACTTT	GAAACACCGGTAATCTAAAGATCCCCGTGGGGTTAGAGCTAGAAATAGCA	1	bc
AATTGGGCAA	GAAACACCGGTTGTAGTGGACTCGGTGTGGGGGAAATAGCAAAAAAACCT	1	bc
AAGCTAACAC	GAAACACCGGTGGGCTTTGCTCGTTTGTGGGGTTAGAGCTATAAATAGCA	1	bc
GAAACACTCT	GAAACACCGGTGACGTGAGGGTTAGAGATGGAAATAGCAAGATAACCTAA	1	bc
CGACCGCCCC	GAAACACCGGTGTTCTTTGCTCGAGGGTGGGGTTAGAGCTAGAAATAGCA	1	bc
ACACCATAAC	GAAACACCGGTGACAAACGAAAGTCAGAGAGCATAGTACTCGAAATCGCA	1	bc
ATCTGCCCGC	GAAACACCGGTGGACGGAGATTATGCGTGGGGATTGGGCAGTAACCTGCA	1	bc
TGCTCTGTTT	GAAACACCGGTCTTCCTGGAATCTACGTGGGGTAGAGCTAGAAGAAGCAA	1	bc
GTAATCTATG	GAAACACCGGTGAGCATGGTAACGTCCGTGGGGTTAGAGCTAGAAATAGC	1	bc
AGACCGAAAA	GAAACACCGGTGTTCTTTGCTCGAGGGTGGGGTTAGAGCTAGAAATAGCA	1	bc
AAACAGGACG	GAAACACCGGTGTTCTTTGCTCGAGGGTGGGGTTAGAGCTAGAAATAGCA	1	bc
ACAGTTAACA	GAAACACCGGTTGGCTTTACTCCTTTGTGGGGTTAGAGCTATAAATAGCA	1	bc
ACACCCCTAC	GAAACACCGGTGACTCAAGGATTACAGCGAGAAAAAACAAAGTAACCGAA	1	bc
GAGTAATGAG	GAAACACCGGTGATCGTTACGGATTTTGTGGGGATAGCGCTAGAAATAGC	1	bc
AATACAGATG	GAAACACCGGTCGTCCTGGAACCAACGTGGGCTAGATCTCGAAATAGCAA	1	bc
TAAGCAAATC	GAAACACCGGTGGGGTTAGAGCTAGAAATAGCAAGTTAACCTAAGGCTAG	1	bc
TAATTCCTAT	GAAACACCGGTGAGGCGAGGGTTAGAGCTAGATTTATCAAGTTAACCTAA	1	bc
GACTTATCCT	GAAACACCGGTTCCCGTTGTTACGTCGTGGGGTTAGAGCTAGAAATAGCA	1	bc
CATTCCATGA	GAAACACCGGTTTAGTTTGTGTGTTTAGAGGTATAAAGAGCAAAATAGCC	1	bc
AAGACAGAAA	GAAACACCGGGGGGGGTTAGAGCTAGGAGTGGTTAGATATAGTAAGACTA	1	bc
ATACCAGATT	GAAACACCGGTGACAAACGTATGTTTGTGGGGTTAGAGCTAGAAATAGCA	1	bc
GCCTAGCAAC	GAAACGCCGGGGTTAGAGCTAGAAATAGCAAGTTAACCTAAGGATAGTCA	1	bc
TTCTTATCAA	GAAACACCGGTCGCGAAAATGTGCCGGTGGGGTTAGAGCTAGAAATATCA	1	bc
AATCCAGCTT	GAAACACCGGTCTCACAGGAATCTACGTGGGGTAGAGGTAGGAATAGGAA	1	bc
TTTTGCTCCG	GAAACACCGGTCGCGGAGATGTGGCGGTGGGGGTAGAGCCAGGAAAAGCA	1	bc
TTATTCGCCT	GAAACACCGGTCGCGAAAATGTGCCGGTGGGGTTAGAGCTAGAAATAGCA	1	bc
CCACCCATGC	GAAACACCGGTTTAGTATGTGGCGTTGGAGCTAGAGATCGCAAGTTAACC	1	bc
CCAATAATAC	GAAACACCGGTGAGCTGTACGCTAGAGCTGGGTAAGGGAAGTAGACAGAA	1	bc
GAGTCAGCAA	GAAACACCGGTTTCAGTAAATGGTGAATTGGGGTAAGAGCTAGAATAGGC	1	bc
TCATCACTCA	GAAACACCGGTGAAGCGAGGGCTAGAGCTGGAAATAGCAAGTTAAACTAA	1	bc
CGTCAAGTTT	GAAACACCGGTCTTCCTTGATTCTGCGTGGGGTAGAGCTAGAAATAGCAA	1	bc
GACTTATCAC	GAAACACCGGTGACAAAAGTTAGCTCGTGGGGTTAGAGCTAGAAATAGCA	1	bc
TAAACAATCT	GACACACCGGTGACGCGAGTGATAGAGCTAGAAATAGCAAGTTAACCTAA	1	bc
GAGCCACACT	GAAACACCGGTTATAGGTGCGGATCTTGGGGGGTTAGAGCTAAAAATAGA	1	bc
GAAAATCTCA	GAAACACCGGTAACACGAGGTTTAGAGCGGGAAAAAAGATATAAACCGAA	1	bc
GCAAACCTAA	GAAACACCGGTGACGGGAGGGTTAGAGCGGGAAATAGGAAGGTAACAGAA	1	bc
AGAACGGACG	GAAACACCGGTCCTATAAGCCGGGGGGGTGGGTTTGAAGCTAGAAATAGC	1	bc
CCGACAATCA	GACGAAACACCGGTTGACGCGAAGCTTATAAATATAAGTAGCAAGTTAAA	1	bc
GAGGCCCAGT	GAAACACCGGTTAGCTGCCTCAACTAGGGGTTTTAGCTCGAAAAATAGCA	1	bc
TCATTCCTCA	GAAACACCGGTGCTGCTAGGTATATCCCTATAGTTAGCGAGATAACCAAA	1	bc
AACTAATCAC	GAAACACCGGTGACAAACGAATGTGCGTGGGGATAGAGATAGAAACAGCA	1	bc
GAAACATATA	GAAACACCGGTTGGGTTAGAGCTAGAAAGAGCGAGTAGACCTATTGCTAG	1	bc
GAGACAAACT	GAAACACCGGTTATCGTAACGAATTAGGGGGGGTTAGAGCAAGAAAAAGC	1	bc
GAGTAAGGAG	GAAACACCGGTTATCGTTACGGATTTTGTGGGGATGGAGCTAGAAATAGC	1	bc
GCCTCACCGA	GAAACACCGGTGTGCGGAGATTATGTGTGAGAAATAGCAAGTAACCTACG	1	bc
TATCCAGCAT	GAAACACCGGTCTTCCTTGAATCTACGTGGGGTAAAGCTAGAAATAGCCA	1	bc
ACGAAAGCAG	GAAACACCGGTGCGCTTTATGCGTTCGTGGGGTTAGAGCTAGAAATAGCA	1	bc
TGAACACCCT	GAAACACCGGTGACACTAGGATTGGAGCTGGGAATAACAAGTAAACATAA	1	bc
ATACCCATCT	GAAACACCGGTTTAGTATGTGGTGTTAGAGCTAGAAATAGCAAGTTAACC	1	bc
TAAGCAATCA	GAAACACCGGTGGGGTTAGAGATAGAAATAGCAAGATAAACTAAGGCTAA	1	bc
GCATTACAAC	GAAACACCGGTGCTAATAGTTAGCTCGTGGGGTTAGAGCTAGAAATAGCA	1	bc
GATTCAACAC	GAAACACCGGTGATAGTTGCGGATTTTGGGGGGTTAGAGCTAGAAATAGC	1	bc
AACAACCCTC	GAAACACCGGTGACGCGAGGGTTAGAGCTAGAAAAAGGAAGTAAACCTAA	1	bc
GGACCAGATG	GAAACACCGGTCTTCCTGGAATCTACGTGGGGTAGAGCTAGAAATAGCAA	1	bc
CAGTCGAACG	GAAACACCGGTTATCGTTACGGATTTTGTGGGGTTAGAGCTAGAAATAGC	1	bc
AGTAAAGCAG	GAAACACCGGTGCCCTTTATGGCTCCGTGGGGTTAGAGCTAGAAATAGCA	1	bc
TCACCCCATT	GAAACACCGGTCTTCCTGGAATCTACGTGGGGTAGAGCTAGAAATAGCAA	1	bc
TGAACACATT	GAAACACCGGTGATCCTGGGATTAAAGCTGGGAAGAGCAAGAAATCGTAA	1	bc
CCCCCAGACT	GAAACACCGGTCTTCCTGGAATCTACGTGGGGTATAGCTAGAAATAGCAC	1	bc
AGACCGCACT	GAAACACCGGTGTTCTGTGCTCGAGGGTGGGGTTAGAGCTAGAAATAGCA	1	bc
ACATTCAAAC	GAAACACCGGTGCTCATAGTTCGCTCGTGGGGTTAGAGCTAGAAATAGCA	1	bc
ATCTCTTCCC	GAACCACCGGTTCTCGTTCCTTATTAGTGGGGTTTAGGAAGTAACTTTAG	1	bc
TAAACAATCT	GAAACACCGGTGATGGGTGCACATTATGGGGAGAAATAGCAAGATAACCT	1	bc
GAGGTCGAAA	GAAACGCGGGGGCTGATCGAGAACTCGCAGGGTTACCTCAGGATAGAGCG	1	bc
TGAAATACAT	GAAACACCGGTAATCTAAAGATCCCCGTGGGGTTAGAGCTAGAAATAGCA	1	bc
CCTTTTCCCC	GAAACACCGGTTCCCTTTACTCCTTTGTGGGGTTAGAGCTATAAATCGCA	1	bc
TTATACCAGA	GAAACACCGGTGTGCGGAGATTATGAGTGAGAAATAGCAAGTAACCTAAG	1	bc
ACCCGAGATT	GAAACACCGGTGCTAGCGGTTTCGAAGTGGGGTTAGAGCTAGAAATAGCA	1	bc
ATAACGGCAC	GAAACACCGGTGCTCTTTGCTCGAGGGTGGGGTTAGAGCTAGAAATATCA	1	bc
GAGTAAATCC	GAAACACCGGTTATCTATAGGGATTTTGGGGGGTTAGAGCTAGAAATACC	1	bc
TTATTATCCA	GAAACACCGGTCGCAAAAAGGTGCCAGTGGGGTTAGAGCTAGAAATAGCA	1	bc
GACTTGAACC	GAAACACCGGTGCTAATAGTGAGTTTGGGTGGGTAGGGCTAGGAATAACA	1	bc
GCAGTCCTCT	GAAACACCGGTGACGAGAGGGATAGAGCTAGAAATAGCAAGTTAACCTAA	1	bc
AAACCAAAAA	GAAACACCGGTTTAGTTTGAGGGGTTAGTGGTAGAAATAGCAAATTAAAC	1	bc
TCCGTTAGCA	GAAACACCGGTTGGCTTTACTCCTTTGTGGGGTTAGAGCTATAAATAGCA	1	bc
CAGGGAGATT	GAAACACCGGTGGGGGTGGAGTTGGAGTGAGCAAATAAACCGAAGGCTCA	1	bc
GAGGCAGGGA	GAAACACCGGTTAGAGGTCCGGATTTTGTAAGGTTAGAGCTAGCTATAGC	1	bc
AATACAGCAA	GAAACACCGGTGCCATTTATGGTACAGAGGGGTTAGTGATAGAAATCGCA	1	bc
ATGATCGCCT	GAAACACCGGTCCTAGAAGGTGAGTTTGTGGGGATAGAGCTATAAATAGC	1	bc
GACACGTCCT	GAAACACCGGTAATCTAAAGATCCCCGTGGGGATAGAGCTAGAAATATCA	1	bc
ATGTCAGTAG	GAAACACCGGTGCTAAAAGTTAGGTTGTTGGGGTAAGGGTTAGAATAGCA	1	bc
GAATCCGCGA	GAAACACCGGTTTTGGTAGATGGGGAAGTGGGGTTAGAGCTAGAAATAGC	1	bc
CCGTGCCCCC	GAAACACCGGTAGACTGTACTCATGCGTGGGGTTAGAGCTATAAATAGCA	1	bc
ATCTTCAACC	GAAACACCGGTTTCGAAAGGGGGCGGGAGGGCTAGAAGTAGCAAATAGCC	1	bc
GGTACAGATA	GAAACACCGGTCATCCTGATAACTACGTGGGGTAGAGCTAGTAATAGCAA	1	bc
TCATCAACAC	GAAACACCGGTGGGGTTAACGCTAGTAATAGCATGTTAACCTAAGGCTAG	1	bc
ATCAACTCTC	GAAACACCGGTTGCTCGAGGGGTGGAGGTAGAAATAGCAAGTAAAACTAA	1	bc
AACTGGGACA	GAAACGCCGGGGTTAGAGAAAGAAATAGCAAGTTAACCTAAGGCTAGTCC	1	bc
TCAACACACA	GAAACACCGGTGACCAGGGTATTGGAGCTGCAAATAGCAAGTTGACATAA	1	bc
ATAACAATAA	GAAACACCGGTGGGGGTAGATCTAGATATAGCGAGAGAACTAAAGGTAAG	1	bc
GAAACACAAC	GAAACACCGGTTTACTTAGTTAACTAGTGGGGTTAGAGCTAGAAATAGCA	1	bc
CTGACAATAC	GAAACACCGGTCCTCGTAGCTGCGTTTGTGGGGTTAGAGCTATAAATAGC	1	bc
TTCCTCTAAC	GAAACACCGGTCGCGATAGTGCGCCGGTGGGGTTAGAGCTAGAAATAGCA	1	bc
CAAAGATCAT	GAAACACCGGTGATAACAGAATCTTCGTGGGGTTAAAGCTAGAAATAGCA	1	bc
AAACCAACAA	GAAACACAGGTGACAATAGTTTGTCAGTGGGGTTAGAGCTAGAAATAGCA	1	bc
CAGTCACCAC	GAAACACCGGTTGGCTTTACTCCTTTGTTGGGTTAGAGCTATAAATAGCA	1	bc
AAACCCCTCC	GAAACACCGGTTTAGTATGCTGGGTTGGGGGGATAAAGATCAAAATAACC	1	bc
GGCCCAGATC	GAAACACCGGTCTCCCTGGAATCTACGTGGGGTAGAGCTATAAATAGCAA	1	bc
TTCGTAAAAC	GAAACACCGGTCGCGAAAAAGTGACGGAGAGCAAAGAGCTAGAAAGAGCA	1	bc
TTATTAAACA	GAAACACCGGTGGCGATAGTGCTAGAGATGGCTTGTTAACATAAATCTCG	1	bc
CATACCCCAC	GAAACACCGGTGAGAAAAGGATTAGAGCTAGCAAAGTGCTCGAAGTATAG	1	bc
AGCAAATAGG	GAAACACCGGTGGGAGGCAACCATGCGTGGGATATAGCAAGGAAACAAAG	1	bc
CATCATACCG	GAAACACCGGTGCCCTTTATGGTACCGAGGGGATGTAGCTCGAAATCGCA	1	bc
GGAATATATA	GAAACACCGGTCTTCCTGGTATAGTGCTGGAAATGCAAGGTTACCCAAGG	1	bc
TTATTATATC	GAAACACCGGTCGCGAAAATGTGCCGGCGGGGTTAGAGCTAGAAATAGAA	1	bc
GTGTTAGACA	GAAACACCGGGGCTAATAGCTAGCTAGTGCAGGTAGAGCTAGAAATAGCA	1	bc
AAACCTGTAA	GAAACACCGGTTCTGGTTGTTTGGTTGGGGGGTTAGAGCTCGAAATAACC	1	bc
TGTTGGGAAT	GAAACACCGGTTTTGCTGGACTCTGCGTGGGGGAAATCGCAAGTTAACCT	1	bc
ATCATCAGCA	GAAACACCGGTGGGGTTAAAGCTAGAAATAGCAAGTTAACCTGTTACTAG	1	bc
GACAAACAAC	GAAACACCGGTACTCATAGGATGCTCGTGGGGATAGAGCTAGAAATATCA	1	bc
CCACGCATGA	GAAACACCGGTTTAGTATGTGGGGTTAGGGCTAGAAATAGCAAGTTAACC	1	bc
AATCCACTAG	GAAACACCGGTGATAAACTTATGTCAGTGGGGTTAGAGCTAGAAATAGCA	1	bc
CAACCATTTT	GAAACACCGGTGCCAGCGGTGTGGAAGTGGGGTTAGAGCTAGAAATAGCA	1	bc
CCGTAACCCC	GAAACACCGGTTGGCTTTAATCGTTTGTGTGGTTAGAGCTATAAATAGCA	1	bc
TCAGCAGCCA	GAAACACCAGTGGGGTTAGAGCTAGAAATAGCAAGTTAACCTAAGGCTAG	1	bc
GATAAAAAAA	GAAACACCGGTGCTAATAGTTAGCTCGTGGGGTTAGAGCTAGAAATAGCA	1	bc
TCTAAAGAAG	GACGCACCGGTGCCCTTTATGGGACCGTGGGGTTAGAGCTAGAAGTAGCA	1	bc
AACACCCTCT	GAAACACCGGTGACGCGAGGGATAGAGCTAGAAATAGCAAGTTAACCTAA	1	bc
GAGTTAACCC	GAAACACCGGTTTTCTTTACTCCTTTGGTGGGGTAAAGCTTTGAAATACC	1	bc
TCGCCCGACT	GAAACACCGGTCTTACTGGCATCTACGTGGGGTAAGACTAAAAATAGCCA	1	bc
TCAACAATAT	GAAACACCGGTGACGCGTGGGTCAGAGCTGGAAATAGGAAGTTAACATAA	1	bc
TCAAAACTGT	GAAACACCGGTGACGCGAGAGTTAGAGCGAGAAATAGCAAGTTAACCTAA	1	bc
GAGTCACCAG	GAAACACCGGTTTTAGTAAATGGTGAGGGGGGGTTTGAGCTAGAAATAGA	1	bc
GACAAATACG	GAAACACCGGTGGCAGCCAGCCACTTGTGGGGTTAGAGCTAGAAATAGCA	1	bc
ACGTTGAACA	GAAACACCGGTTGGCTTTCCTACTTTGTGGGGTTGGGGCTATAAATAGCA	1	bc
TCAGCAATCT	GAAACACCGGTTACGCGAAGGATAGAGCTGGAAATAGCAAGTTAAACTAA	1	bc
AAAATCCCAC	GAAACACCGGTTTACTAAGATAACTAGTGGGGTTAGAGCTAGAAATAGCA	1	bc
AATTGGTCAA	GAAACACCGGTGACAAACGTATGGCAGTGGGGGTAGAGCTAGAATAAGCA	1	bc
GGACCAGCTG	GAAACACCGGTCTTGCTGGATTGTAAGGTGGGGAGAGCTATAAATAGCAC	1	bc
TATTGGTCAA	GAAACACCGGTTCCCGTGGGGTTAGAGCTAGAAATAGCAAGTTAACCTAA	1	bc
CCCGCAAACA	GAAACACCGGTGGGGTTAGAGCTAGAAATAGCAAGTTAACCTAAGGCTAG	1	bc
AAAACACAAA	GAAACACCGGTTTACTTAGTTAACTAGTGGGGTTAAAGCAAGAAATAGCA	1	bc
GTTCTTCTCA	GAAACACCGGTCGCGAAAATGTGCCGGTGGGTTTAGAGCTAGAAATAGCA	1	bc
TCCAGCCTAT	GAAACACCGGTGACGCGAGGGTTAGAGCTGGAAATATCAAGTTAACCTAA	1	bc
GAGTCATATT	GAAACACCGGTTATCGTTGCGGTTTTTGTAGGGTTAGAGCTAGAGATAGC	1	bc
ATGAAAGCAG	GAAACACCTGTCCTAGAAGCTGAGTTTGTGGGGTTAGGGCTAGAAATAGC	1	bc
ATCCCGCAAC	GAAACACCGGTTGGGTTAGAGCTAGAAATAGCAAGTTAACCTAAGGCTAG	1	bc
CATAAACTCA	GAAACACCGGTAATCTAACGATCCCCGTGGGGATAGAGCTAGAAATAGCA	1	bc
TCCAACATCT	GAAACACCGGTGACGCGCGGGTTAGAGCTGGAAATAGCAAGTTAACCTAA	1	bc
ACCAGCGCCC	GAAACACCGGTAGACTGGATGCAAGGGAGGAATTGCAAGTTGAACTAGGG	1	bc
GATTGGGCAG	GAAACACCGGTTTTAGTAAATGGTGAGGGGGGGTTAGAGCTAGAAATAGC	1	bc
CCCTCAGATC	GAAACACCGGTTCTCCTGGATTCTATTGGGGGTTTAGAGATAAATATCAA	1	bc
TCGTTCACCC	GAAACACCGGTTGGCCTTGTGCCATTGTTGGGTTAAAGATATAAGCCTCA	1	bc
CGACCAGATC	GAAACACCGGTCTTCCTGGCATCTACGTGGGGTAGAGCTAGAAATAACAA	1	bc
AGCACTCCCC	GAAACACCGGTGTTCTTTGCTCGGGGGTGGGGTTAGAGCTAGAAATAGCA	1	bc
TGACAAGATC	GAAACACCGGTCTTCTTTGCACCTACGTGGGGTAGAGCTAGAAAAAACAA	1	bc
CCGTTAATTA	GAAACACCGGTTGGCTTTACTCCTTTGTTGGGTTAGAGCTATAAATAGCA	1	bc
AGACACATTA	GAAACACCGGTTTAGTTTGTGTCGTTAGAGCTAGCAAGAGCAAGTAAACC	1	bc
CAGTACCCCC	GAAACACCGGTTGGCTTTACTCCTTTGTGGGGTTAGAGCTATAAATAGCA	1	bc
GGCAACTACC	GAAACACAGGTGGTTTAAAGTTCCAAGTGGGGCTAAGGCTGGATCGAGAT	1	bc
ATTACCGAAG	GAAACACCGGTCCTAGAAGCTGATGTGGGGGGGTTAGACCTAGAAATAGC	1	bc
TACCCCCACT	GAAACACCGGCTTGCTAAGTTAACTTGAGGTAAGAGAGCTCGAAATAGCA	1	bc
AGAATATAGA	GAAACACCGGTTTAGTATGTGGGGTTAGAGCTAGAAATAGCAAGTTAACC	1	bc
AGCTACCCAC	GAAACACCGGTGATCTATAGACGCCGGTGGGGTTAGAGCTAGAAATAGCA	1	bc
AATTATTCAA	GAAACACCGGTGCCAGTTACATGTCAGTGGGGTTAGAGCTAGAAATAGCA	1	bc
GGATCAGCAA	GAAACACCGGTGTTAGCAGAACGTTTAGGGGTGATAGCTATAGATATCAA	1	bc
TGCTCTGATA	GAAACACCGGTCCTAGTGACATACACGTGGGGTTGAGCTTGGAATTGCAA	1	bc
GCAGTGAAAA	GAAACACCGGTGCTGATAGTTAGCTCGTGGGGTTAGAGCTAGAAATAGCA	1	bc
CAGCCAGGTG	GAAACACCGGTCATCGTTCCGAATTTTAGGGGGATAGATCTCGAGTTAGC	1	bc
GACTAAATAC	GAAACACCGGTAATCTAAAGATCTCCGTGGGGATAGAGCTAGAAATAGCA	1	bc
TAGTCCCGCT	GAAACACCGGTTATCGTTACGGATTTTGTGGGGTTAGGGCTAGAAATAGC	1	bc
GTCTTTGCCC	GAAACACCGGTCCCGGAAATTTGCCGGTGGGGTTAGAGCTAGAAATAGCA	1	bc
TTAGCCTCCC	GAAACACCGGTGGCGATAATGCGCCGGTGGGGTTAGTGATAGAAATCTCA	1	bc
GAAGCCGCCA	GAAACACCGGTGAGATGCCTCACCGGGTTTAGAGCTAGAAATAGCAAGTT	1	bc
CCGTCAAAAA	GCACGGACGAAACACCGGTGGGCTTTGATCCTTTGATGGGTTAGTGATCT	1	bc
GAATCACACT	GAAACACCGGTTATCGTCGCTGATTTTTGGGGTTTGAGCTAGAAATAGCA	1	bc
AAACAGTAGC	GAAACACCGGTGGTCTTTGCTCGATGGTGGGGTTAGAGCTAGAAATAGCA	1	bc
AGAGACCTCT	GAAACACCGGTGACGCGAGGGTTATAGCTAGAAATAACAAGGTAACCTAA	1	bc
TCACACCTAC	GAAACACCGGTGACGCGAGGGCTAGAGCTGGAAATGGCCAGGTAACCTCA	1	bc
AAATAATCAC	GAAACACCGGTGAGAAACGTATGTCAGTGGGGATTGAGAAAGAAATAGAA	1	bc
GTATTAGCCC	GAAACACCGGTGGCGGAAATGTGACGGTGGGGTTAGAGCTAGAAATAGCA	1	bc
TCAGATGCCG	GAAACACCGGTGACGCGTGGGTTAGAGCGAGAAATAGCAAGGTAACCTAA	1	bc
AGCCTAGATT	GAAACACCGGTCTTCCTGGAATCTACGTGGGGTTGAGCCAGGAATAGCGA	1	bc
AATCCCTAAA	CTAAACACCGGTGACAAACGTATGTCAGTGGGGTTAGAGCTAGAAATAGC	1	bc
GCCTTGCAAA	GAAACACCGGTGCTAATGATAACGTCGGTGGGGTTAGAGCTAGAAAACCC	1	bc
TTCCCAGAGT	GAAACACCGGTCTTCCTGGGATCTACGTGGGGTAGAGCTAGAAATAGCAA	1	bc
GAAGGCGTGC	GAAACACCGGTGAGATGCAAGATAAACTAAGGCTGGTCCGTTATCACCTT	1	bc
TCACGACGCC	GAAACACCGGTGGAATGGATGCACGAAAGGGCTAGTAAAAAGAAGTCGAG	1	bc
AATTGAGCAA	GAAACACCGGTTACGAAGGAATGGGAGTGGGGGAAATGGTAGGATAACCT	1	bc
TGTTCATCTT	GAAACACCGGTCTTCCTGGAATCTACGTGGGGTAGGGCTAGAAATAGCAA	1	bc
CGAAAGGTTG	GAAACACCGGTCGTCGAACGAAGGGGGTGGGGTTAGAGCTAGAAATAGCA	1	bc
GGCAACTACG	GAAACACCGGTTTTAGCAAATGGTGAAGGGGGGTTAGAGCTAGAAATAGC	1	bc
TAAGTCATGA	GAAACACCGGTTGAGATACTCAAAAAGTGGGGTAGGGCTAGAAATCGAAA	1	bc
CTATTATCCC	GAAACACCGGTGGCGAAAGTGCGAGAGTGGGGATGGTAATCGAAATCGAG	1	bc
TGGTCAATCG	GAAACACCGGTTATCGTTACGGATTTTGTTGGGTTAGATCTAGAAATAGC	1	bc
AATTTATCCC	GAAACACCGGTGACAAAAGTATGTCAGTGGGGTTAGAGCTAGAAATAGCA	1	bc
ATGGTCATCG	GAAACACCGGTCCTAGAAGCTGAGTTGTGGGGGTTAGAGTTAGAAATAGC	1	bc
AGCAGTTCCC	GAAACACCGGTTGCCGTGAGCTCGGAGTGGGGGTAGAACTAGGAATAGCA	1	bc
GTATTGTACC	GAAACGCCGGTGAGAAAGCTAAAGTCCGTAGGGTTAGAGCTGGATAGAGC	1	bc
CAGTCACGCA	GAAACACCGGTTATAGTTACAGATTTTATGGGGTTAAAGTTAGAAATGGC	1	bc
TCCACCCCCC	GAAACACCGGTTGACTTAATTCACGGTGGGGATAGCAAGTTAACCTAAGG	1	bc
TCATCATTCC	GAAACACCGGTGACGCGAGGGTTAGAGCTGGAAATAGCAAGTTAACCTAA	1	bc
AAGTTAGCAC	GAAACACCGGTTGGCTTTACTCGTTTGTGGGGGTAGAGCTATAAATAGCA	1	bc
GACAGGCTAA	GAAACACCGGTAATCTAAAGATCCCCGTGGGAATAGAGCTAGAAATAGCA	1	bc
ACGATAACAG	GAAACACCGGTGGGCTTTACTGCTTCGTGGGGTTAGAGCTAGAAATATCA	1	bc
GGTTATTTAA	GAAACACCGGTACTAGCAACTTACTTTGGGGTTAAGACCTAAAAATACCA	1	bc
GCGTCCCGCG	GAAACACCGGTTATCGTTTCGGATTTTGTGGGGATCCAGCTAGAAATCGC	1	bc
GATAAACAAA	GAAACACCGGTGGCAATTGGACTAGAGAGGGGATGTTACTATAAATAGAG	1	bc
TCCTCACAAA	GAAACACCAGTGGGGTTAGAGCTAGAGTTAGCAAGTTAACCTAAGCCTAG	1	bc
CATCCAGGTT	GAAACACCGGTCTTCCTGGAATCTACGTGGGGTAGAGCTAGAAATATCAA	1	bc
TCCTAAACCT	GAAACACCGGTGGTCACAATGGGGTGGATGGAGATAGAGCTAGAAATAGC	1	bc
AAAAGGGATT	GAAGCACCGGTTATAGTTACGTCTTTGGTGGGGTTAGAGCTAGAAATAGC	1	bc
CCGTTTATAA	GAAACACCGGTTGTCGTTACTCCCTTGTGGGGTTAGAGCTATAAATAGCA	1	bc
AACCCCCTAC	GAAACACCGGTAATCTACAGATCCCCGTGTGGATAGAGCTAGAAATAGCA	1	bc
TGCTCTAAAA	GAAACACCGGTTCCGGTAGAGTTAGATATAGAAATAGCATGATAACATAA	1	bc
AAACCCCTCC	GAAACACCTGTATTGTATGTGGGGTTAGAGCTAGAAATAGCAAGTTAACA	1	bc
TCCACAGATT	CTAAACACCGGTGTTGCTGGAGTCAAAAAGGGCTAGTGAACGAAATAGCA	1	bc
TGCTCATCAC	GAAACACCGGTGGCGATAGTATGGCAGTGGGGTTAGAGCTAGAAATAGCA	1	bc
CAAAAACTCT	GAAACACCGGTGACGGGAGGGTTAGAGCTAGAAATAGCAAGTAAAACTAA	1	bc
ATGATCACCG	GAAACACCGGTCGGATAAACGCTATTGAGGGGATAGTGATATAAAGAGAA	1	bc
CGTCAACCAT	GAAACACCGGTGAGGCGAGGGCTAGAGCTAGAAATAGCAAGTAAACCTAA	1	bc
ACTAACTACC	GAAACACCGGTGACAAACATATGTCAGTGGGGTTAGAGCTAGAAATAGCA	1	bc
GCAGCCAAGA	GAAACACCGGTGGGGTTAGAGCTAGAAATAGCAAGTTAACCTAAGGCTAG	1	bc
ATGGGCGAAC	GAAACACCGGTGGTAGTAGATCTAGAAATGGCAAGTTAACTTAAAGCTAG	1	bc
GTCCGATGCC	GAAACACCGGTAGACTGGATCCACGGTAGAAAAAGCATGTTAACCTAAGG	1	bc
GGCACCTCCC	GAAACACCGGTGATCTAAAGACCTTTGTGGGGTCAGACTAGAAAAAACAA	1	bc
ACCTACCCGG	GAAACACCGGTGTGCGGAGATTTTGCGATAGAAGTATCACGTAACCTAAG	1	bc
CTGTCCCACC	GAAACACCGGTCCTAGAAGCTGAGTTTGTGGGGTTAGAGCTAGAAATAGC	1	bc
AACCACTCCC	GAAACACCGGTAACCTAAAGATCGCCGTGGGGTTAGAGCTAGAAATAGCA	1	bc
GAATTGCAAC	GAAACACCGGTGCTACTAGTTAGCTCTTGGGGGTAGAACTAAGAATAGCA	1	bc
AATTCATGCG	GAAACACCGGTTATCGTTGCGGGTTTTGTGGGGTAAGGGCTGGAAATAGA	1	bc
TGACCCGACT	GAAACACCGGTCTTCCTGGAATCTACGTTGGGTAGAGCTAGAAATCGCAA	1	bc
AAACCAGTTT	GAAACACCGGTTTTGCTGGTGGCTATGGAGGTAGGAGTTGCAAGTAGCAA	1	bc
TTCTCATCCA	GAAACACCGGTCGCGAAAGTGCGCCGGAGGGGTTAGAGCTAGAAATAGCA	1	bc
AGTTAGCCAC	GAAACACCGGTTGTCTTTGCTTGAGGGTGGGGGTAGAGCTAGAAATAGCA	1	bc
AAACCGAAAC	GAAACACCGGTGGGGTTAGAGCTAGAAATAGCAAGATAACCTAAGACTAG	1	bc
ATGTTCTCCG	GAAACACCTGTCGTGGAAGTGTGCCGGTGGGGTTAAAACTAGAAATAGCA	1	bc
ATGACCTCAA	GAAACACCGGTCCTAGTAGCTGCGTTTGTGGGGTTAGAGCTAGAAATCGC	1	bc
GTCACCGGCG	GAAACACCGGTCCTAGAAGCTGAGTTTGTGGGGCTAGAGCTAGAAATAGC	1	bc
TTTTTTTAAC	GAAACACCGGTCGCGAAACTGTGCCGGTGGTGTTAGATCTAGAAATAGCA	1	bc
AAACATCCCC	GAAACACCGGTGTTCTTTGCTCGAGGGTGGGGTTAGAGCTAGAAATAGCA	1	bc
GCGTCAAAAA	GAAACACCGGTTGTCGTTACGTATAATTTGCAGTTTAAGCTAAAGCTAGC	1	bc
TTCTTATCAA	GAAACACCGGTCGCGATAATGTGCCGGTGGGGTTAGAGCTAGAAATAGCA	1	bc
AACATGCTAG	GAAACACCGGTTTTCGATCAATGGCCGTGGGGTTAGAGCTAGAAATAGCA	1	bc
AAGTTAATAG	GAAACACCGGTTATCGTTACTGATTTTGGGGGGTTGGGCCTAGAAATACC	1	bc
GTGTAACGGG	GAAACACGGGTGATCGGAACGGATGCTGGAGGGATAGCAAGTAACCTAGC	1	bc
CCCTTCACCC	GAAACACCGGTTGGCTTTACTCCTTTGTGGGGTTAGAGCTATAAATAGCA	1	bc
ATGCCAGACG	GAAACACCGGTTCTAGGCGCTGGGTTTGTGGGGTTTAGGCAAAAAAAGGC	1	bc
CACAAACAAC	GAAACACCGGTGGCAAATCGATCCGCGTGGGGATAGAGCTAGAAATAGCA	1	bc
AATCTATAAA	GAAACACCGGTGACAATCGTATGGCCGGGGGGGTTGGAGTAGGAATAGCA	1	bc
GAGAGTGCCG	GAAACACCGGTGCCCTTTATGGGACCGTGGGGTTAGAGCTAGAAATAGCA	1	bc
CCCTGACAAC	GAAACACCGGTGCTAATAGTTAGCTCGTGGGGTTAGAGCTAGAAATAGCA	1	bc
TCACCCCAAC	GAAACACCGGTGACCCGAGCGCTAGAGCTGGGATAAGCAAGTTAACCGAA	1	bc
GAATTATCTG	GAAACACCGGTTTTAGTAATTGCTTAAGTGGGGTTAGAGCTAGAAATAGC	1	bc
CCCCGGCAAC	GAAACACCGGGGTTAGAGGTAGAAATGGGGGGTTAGCGCAAGACTTAGCC	1	bc
CGGTCAGATT	GAAACACCGGTTTTCTTGGAATCGTTTGGTGGAGCTAGCTATAGAAAGCT	1	bc
CCACCACTTT	GAAACACCGGTTTTAGTAATTGGTGAAGTGGGGTTAGAGCTAGAAATAGC	1	bc
TAATCCCCCT	GAAACGCCGGTTTTATTAGTTGGCTAGGTGGGGTTAGAGCTAGAAATAGC	1	bc
ATAACAGACG	GAAACACCGGTCCTAGTAGAAGGGGAAAGAGCAAGTAATACTAAGGCAAA	1	bc
AGGCCAAGCG	GAAACACCGGTTATCGTTGCTCTTTTTGTGGGATAAAAGCAAGAAAATGA	1	bc
GTGTTAAAAG	GAAACACCGGTGCTGATAGTTATCTAGATGGGTTAGTGCTAGAAAGAGCG	1	bc
TCAACATATA	GAAACACCGGTGAGCATGGTAACATACGTGGGGAGATAACTAGAAATAGG	1	bc
AATTCAGGCG	GAAACACCGGTTATCGTTACGTCTTTTTTGGGGTTATAGCTAGTCATAGC	1	bc
GATTCACTCC	GAAACACCGGTAATCTTTAGATCTTAGTGGGGTTAGAGCTAGAAATAGCA	1	bc
TTATCCACAC	GAAACACCTGTGGGGTTAGAGCTAGAAATAGCAAGTTAACCTAAGGCTAG	1	bc
