GTAGTCTAGA	GAAACACCGGTGGGCTTTCAGAGAGAGCGAGTTAGCGCTAGAAATAGCAG	1	bc
AAACTAAAAT	GAAACACCGGTGCTAATAGATAGCTCGTGGGGTTAGAGCTATAAATAGCA	1	bc
AACATGGTCG	GAAACACCGGTTCTCGATGTTAGGTCGGGGTGGTGGTGCTAGAAATAAGA	1	bc
AACACCCTAA	GAAACACCGGTTTTCGATCCTAAGACGTGGGGTTAGAGCTAGAAATAGCA	1	bc
GACAAAGCCG	GAAACACCGGTTTTCGAAAATGGCGAGTGGGGTTAGAGCTAGAAATAGCA	1	bc
CTGACCGTCG	GAAACACCGGTCCTAGAGGCTGATGATAGGGCTAGAAATAGCAAGTTAAA	1	bc
AGCTCATCAC	GAAACACCGGTGCCAATAGTCTGCCCGTGGGGTTAGAGCTAGAAATAGCA	1	bc
TGTTTATTAC	GAAACACCGGTGAGAACAGGGGTTAGAGCTGGAAATAGCAAGTTAACCTA	1	bc
CATTTCGTCC	GAAACACCGGTTGGGATTATCAAGTTGAGGGAAAGATAGACAGTTATCAA	1	bc
TGCACTTCCT	GAAACACCGGTTCCCGTTGGCTCGTAAGTGGGGTTAGAGCTAGAAATAGC	1	bc
ATCTACCGGC	GAAACACCGGTGAGCGGAGATTAGGCGAGAGAAGTAGCAAGTAACCTAAG	1	bc
ATACGACTTT	GAAACACCGGTTGTAGTAAATGGAGAGTGGGGTTAGAGCTAGAAATAGAA	1	bc
GTTTTACAAA	GAAACACCGGTCGTCGTTCGTAGGGGTTGGGTTATAGCTAGAAATAGCAA	1	bc
TAAACCCCCA	GAAACACCGGTGGTGTGGGAGTTAGAGCTGGAGATATAACATGTTACTAA	1	bc
TTACCCCCCT	GGAACACCGGTTGTACGAGATGGTTTGAGGGGTTAGAGCTAGAAATAGCA	1	bc
AGGCCCGTCT	GCAACACCGGTCATCCAGCCTGCATTGGCTTGATATAGATAGATATCGTA	1	bc
TATTTACTCA	GAAACACCGGTGGCAATTCGATCTGAGTGGGGTTAGAGCTAGAAATAGCA	1	bc
CAATCAATGA	GAAACACCGGTTTAGTATGTGGGGTTAGAGCTAGAAATAGCAAGTTAACC	1	bc
AATCGAGATT	ATGACTAAACACCTGTGGTAGCGCTCTCGGTGGCGGGTTAACCTCAGGCT	1	bc
AAATGGGAAC	GAAACACCGGTGTTCTTTGCTCGAGGGTGGGGTTAGAGCTAGACATAGCC	1	bc
TCCGCACCAA	GAAACACCGGTGTGGTTAGAGCTAGAAATAGCAAGTTCACCTAAGGCTAG	1	bc
TACAGTGTAA	GAAACACCGGTATACGTTACTTACGAAGGGGGTTTAGAGCTGAAAATGGC	1	bc
TACTCTGCAA	GAAACACCGGTACTATTTACTTACTGTTGGGGTTAGAGCTAGGAATAGCA	1	bc
GAATTTTATA	GAAACACCGGTCGTCGTTCGTAGGGGGGGGGGTAGAGGTTGGAAATGCAA	1	bc
GAATCAGTAA	GAAACACCTGTTTTAGTAGATGGTGAGTGGGGTTAGAGCTAGAAATAGCA	1	bc
CAATCAATAA	GAAACACCGGTTTGGTTTGGGGCTTTGTGGGGTTAGATCTCTAAATAGCA	1	bc
CCCTGCCGAA	GAAACACCGGCTAGAAATAGCAAGTTAAGCTAAGGCTAGTCCGTTATCAA	1	bc
CGGGCAGCAA	GAAACACCGGTGAGGATAGAGCGAGTTGGGGCTAGAGATCGTAAGAGCAG	1	bc
AAAGATAAAA	GAAACACCGGTGGGGTTAGAGCTAGAGATAGCATGTAACTCTAAGGCTAG	1	bc
CAACGAGATT	GAAACACCGGTGCTAATAGTTAGCTCGTGGGGTTAGAGCTAGAAATAGCA	1	bc
CGTTCTGTAA	GAAACACCGGTGCTAGTTACTTACGTAGTGGGTTACCACTCGAAATATCC	1	bc
CACTTCACCC	GAAACACCGGTCCTCTAAACTCCTTTGTGGGGATAGCGCTATAAATCGCA	1	bc
CATTTTACAA	GAAACACCGGTTTAGTTTCTTCCTTTGGGGGGTTAAAGCTATAAATAGCA	1	bc
TACCCCATCC	GAAACACCGGTCTAGGATGGTGGGGAGAGGGCTTGAAATAGGAAATTGAC	1	bc
AAACACAACA	GAAACACCGGTTGTAATCGATAGTTTGTGTGTTTAGAGCTAGAAATAGCA	1	bc
CTCCCGCACT	GAAACACCGGTTCAACGCGCTGGTTTGTGGGGTTTGGGCTTGGAATAGCC	1	bc
ATATTCACAA	GAAACACCGGTGGCAATCCGATCTGAGTGGGGTTAGAGCTAGAAATAGCA	1	bc
ACATCGACAA	GAAACACCGGTGGTGGTAGAGCTAGAAATAGCGAGATAACCTGTTGCCAT	1	bc
TTCTGCGCGA	GAAACACCGGTCCTGTTAGATGTAGAGAGGGTAGAGCTAGAAAAAGCAAG	1	bc
GACTTACTCC	GAAACACCGGTTATCTAAAGATCCACGTGGGAATAGAGCTAGAAATAGCA	1	bc
TTTACAGATT	GAAACACCGGTCTTCCTTGGATCGCGGGGGAGAGCTACTAATAGTAGTTT	1	bc
GACTTCAACA	GAAACACCGGTGCTAATAGTTAGCTCGTGGGGTTAGAGCTAGAAATAGCA	1	bc
GAAATCTACA	GAAACACCGGTTTTCGTAGGTAGGGGGGGGGGTTGAGCTAGAAATAAGAA	1	bc
CCAAGCCTCC	GAAACACCGGCTAGAAATAGCAAGTTAACCTAAGGCTAGTCCGTTATCAA	1	bc
AGAACGCCAC	GAAACACCGGTGTACTTTGATAGAGAGTGGGGTTAGAGCTAGCAATAGCA	1	bc
GAGATCGAAA	GAAACACCGGTGCTAATAGTTAGCTCGTAGGTATAGAGCGAGAAGTATCA	1	bc
ATCACTCCGA	GAAACACCTGTGCGCGGTAGTTATGCGTGTGAGATAGCGCTAAAACTAGC	1	bc
ATACACCTCC	GAAACACCGGTAGTCTTAGCGCTCGCGTTGGCATATTGCTATAAGGCTCT	1	bc
AAGACCGTCG	GAAACACCGGTTCGAAATAGTTAGTTGAGGGGAGAGTGCTACAAAATGCA	1	bc
CTACTCCACC	GAAACACCGGTGGGCTGGATCCCCTCGTGGGGTTAGAGCTAGAAATAGCA	1	bc
TATCCAATGA	GAAACACCGGTGTTCACTTTGGGTATAGCGGGAGATAGCGAGAGATCCCA	1	bc
CTCTCACACT	GAAACACCGGTGGCAAGCGATGGTTTGTGGGGTTAGAGCTAGAAATAGCA	1	bc
CGACCATTGA	GAAACACCGGTTTAGTACGTGGGGTTAGGGGTAGAAATAGCAAGTTAACC	1	bc
AGCTCATAAA	GAAACACCGGTGAGAACAGATGGTTTTGGGGTTTAGGCTAGAAATAGCAA	1	bc
ACATCGCACA	GAAACACCGGTTTAACCGGCGTGTGTGGATCTAGCTAGAACTAGCAAGCT	1	bc
TCATCTATAA	GAAACACCGGTGGGGTTAGCTTTCGAGAGGGCATGGTACTAGAAGGCTCG	1	bc
ACAGTTAACA	GAAACACCGGTTGGCTTTACTAATTTGTGGGGTTAGAGCTATAAATAGCA	1	bc
ATTTACGCTA	GAAACACCGGTGTGCGGTGATTATCCGTGGGAAAAGAGAAAGAACCTACG	1	bc
TTGTTCAGCC	GAAACACCGGTTCTCGATACGGGTTTTGTGGGGATAGAGCTAGAAATAGC	1	bc
ACTTCGCCCC	GAAACACCGGTGCCACAGGCGTGTCGGGTTGGAGAGAGCAATAACTAGCA	1	bc
ACACTACCCC	GAAACACCGGTGGCAATTCGATCTGCGTGGGGTTAGAGCTAGAAATAGCA	1	bc
CATTTACACC	GAAACACCGGTCGCAATTAGGTCTGAGTGGGGTTAGAAATAGCAAAAGCA	1	bc
AGACACCCTC	GAAACACCGGTAATCTAAAGATCCCCGTGGGGATAGAGCTAGAAATAGCA	1	bc
GGATCATCAG	GAAACACCGGTGAGAGTAGAACGTGGGGGGGGTAGAGGGATAAACAGGAA	1	bc
TCCTATGCAA	GAAACACCGGTACTAGTTACTTACGGGTGGGGTTAGAGCTAGAAATAGCA	1	bc
GACTAAGTCC	GAAACACCGGTACTGGTTATTTAAGGGTGGGGTTAAAGCTAGAATAAGCA	1	bc
GAATAACACC	GAAACACCGGTTTTCTTAACTCGAGAGTGGGGTTAAGGGCAGAAAAAGCA	1	bc
GGGCAGAACG	GAAACACCGGTTATCGTTGCGCGTTGGTGGGGTTAGAGCTAGAAATAGCA	1	bc
GAACCCAGCA	GAAACACCGGTTTAGGATGGGGTGGAGCGAGGATGGAGCTAGAAACATCA	1	bc
CATAATTAAT	GAAGCACCGGTTGAGATAATCAAAAAGTGGGGTAGAGCTAGAAATAGCAA	1	bc
GTATGTGTAA	GAAACACGGGTACTAGGTACTTAAGGGTGGGTTTAGAGATAGAAATAGCA	1	bc
TCAATAATCT	GAAACACCGGTTGGGCTAATCCAAAAGTGGGGTAGAGCTAGAAATAGCAA	1	bc
ATACTATCAC	GAAACACCGGTGAGCATGATAACGTCTTGAAATAGCAAGTTAACCTAAGG	1	bc
CCCTTCACCC	GAAACACCGGTTGTATTTGCTCATGTGGGGGGAGTGCAACTAAAAGTAAG	1	bc
GCATTAACTA	GAAACACCGGTTGGCTTTCGTACTGTGTTGGGTTAGAGCAATAAATAGCA	1	bc
GAACACCAAA	GAAACACCGGTAATCTATAGATCACCGTGGGGATAGAGCTAGAGATAGCA	1	bc
TGGCCAGATT	GAAACACCGGTGAGCTTATAGCAATAGCAAGTTAGCCTAACGAAGGTCCG	1	bc
TGTCCAGATT	GAAACACCGGTCTTCCTGGAATCTGGTAGAGCTAGAAATAGCAAGTTAAC	1	bc
CGCTCCCCAC	GAAACACCGGTGAGCTCTGATCGCTTTGGGGTTAGAGCTAGAAATAGCAA	1	bc
AACTATACAA	GAAACACCGGTAGTAGGTACTTACTTGTGGGGTTAGAGCTAGAAATAGCA	1	bc
TCAGACTAAA	GAAACACCGGTGGGGTTAGACCTAGAGAGAGGATGTTGCTCGAAGTCTCA	1	bc
ATATCACAGA	GAAACACCGGTTGGAAGCGATGGTTTGTGGGGTTAAAGCTAGAACTAACA	1	bc
TCCTTACTCC	GAAACACCGGTTCAGCTAATCAAAAAGTGGGGAAGTGCTAAAAATAGCAT	1	bc
GAAAACCAAC	GAAACACCGGTAATCTAAGGATCCCCGAGGGGATATTGCTAGAAGGAGCA	1	bc
CACTGCGCAA	GAAACACCGGTAGTAGGGAACTACGGGTGGGATAAAAAGCAAATTTACCT	1	bc
CCTAAAACAC	GAAACACCGGTTGCCTTTATGTCTCCGTGGGGTTAGAGCTATAAATAGCA	1	bc
GACATCTTCG	GAAACACCTGTTTTCGCCAGCCACTTGTGGGGTTAGAGCTAGAAATAGCA	1	bc
CTGTCAAAAG	GAAACACCGGTTGTCTTTACTGCTTTGTGGGGTTAGAGCTAGAAATAGCA	1	bc
GCATATGTCC	GAAACACCGGCTGTAAGCGCTTGTTTGTGGGGTTAGAGCTAGAAATAGCA	1	bc
ACCCGCCTGA	GAAACACCGGTATAGTGGGTGCAGGTGGGGGTAGAAATATCAAAATAGCC	1	bc
AAAACCAACG	GAAACACCGGTGTCGGATGGGGGGTTGGAGGGAGGAATAGAAAGTTAACC	1	bc
CCGTGGCCCA	GAAACACCGGTTCAGCCGGCGTATGGGGGTGGGACTAGAAAAGTCAAGTT	1	bc
TCATCATCCC	GAAACACCGGTCGCGAAAATGCGAGAGAGGGGATGGAGCTAGAAATAGAA	1	bc
GACCCCTCCG	GAAACACCGGTTGCCGTGACTCGTGCGTGGGGTTAGAGCTTAAACTAGCA	1	bc
TTATTACCCC	GAAACACCGGTCCTAGAAGCTGAAGTGGGGTTAGAGCTAGAAATAGCAAG	1	bc
TGCACTTCAT	GAAACACCGGTGACAATTGACTGGTTGGGGGGTTAGACCCGGAAATAGCA	1	bc
AAGCCAGCCG	GAAACACCGGTTATCGTTACGGATTTTGCGGGGTTAGAGCTAGAAATAGC	1	bc
TAATGCCCCA	GAAACACCGGTGACGCGGTGGTTAGAGCGAGAAATAGAAAGTGATCCCAA	1	bc
TCCTATAAAA	GAAACACCGGTACTAGTTACTTAAGGGAGATCATAGAGCTATAAAGAGCA	1	bc
CCTACAACAC	GAAACACCGGTTACCTTAGTTTGTTAGTGGGGTTAGAGCTAGAAATAGCA	1	bc
GCAATCCATT	GAAACACCGGTGAGGCTAGGGTTAGAATTAGAAATTAAACTAAAACCTAA	1	bc
ATCAACCACC	GAAACACCGGTAATCTAAAGTGCTCCGTGGGGATAGAGCTAGAAATAGCA	1	bc
ATACCACCAA	GAAACACCGGTTGGAAGAGATGGTTTGTGGGTTTAGAGCTAGAAATGGCA	1	bc
AATCCATCAC	GAAACACCGGTTGTGGGGAACTCGGCGTGGGAGTAATAGCAAGATAACCT	1	bc
GACACTCCCC	GAAACACCGGTAATCTAAAGATCCCCGTGGGGATAGAGCTAGAAATAGCA	1	bc
GAGACCATCG	GAAACACCGGTTACGCGTGCGGAATAGAGCTAGATATCGCAAGTAACTCT	1	bc
CTATCACCGA	GAAACACCGGTGTGCGGAGATTATGCGTGAGAAATAGCAAGTAACCTAAG	1	bc
CAAGGAGAAA	GAAACACCGGTGCTAGCGGCTTCGGAGTGGGGTTAGAGCTAGAAATAGCA	1	bc
TCTTCGCACT	GAAACACCGGTTCCGCGGGGGTCGTTGTGGGGTGAGAGCAAAGATAAGCA	1	bc
GAATCCCTCC	GAAACACCGGTTTTCTCAAGTTGCCAGTGGGGTTAGAGCTAGAAATAGCA	1	bc
GACAAAAACA	GAAACACCGGTAATCTAAGGATCCCCGTGGGGATAGAGCCAGAAATAGCA	1	bc
GACACACGCG	GAAACACCGGCTAGAAATAGCAAGTTAACCTAGGGCTAGTCAGTTATCCT	1	bc
GACAAACTAA	GAAACACCGGTAAGCAAAGAATGCCCGGGGGGAAAGAGCAAGAATAGGAA	1	bc
ACCCACCGAC	CAAAACACCGTTGTTCAATGCCCAATGAAGGGAAGAGAACTAGAAATATC	1	bc
AACATACAAA	GAGACACCGGTGGCAGTTCGATGTGAGTGGGGTTAGACTTGGAAATAGCA	1	bc
TACGCCAGCC	GAAACACCGGTGGGGTTAGAGCTCGCAATAGCATGTTACCCTAAGGCTCG	1	bc
CCCGCCCCCC	GAAACACCGGCTAGAAATAGCAATGTAACCTAAGGCTAGTCCGTTATCCA	1	bc
CCCTGGCCAC	GAAACCCCGGTTGAATCGGATTCTGGGTGTGGGTATAGGAATATCAAGTT	1	bc
GCACGCCCCG	GAAACACCGGCTTGAGAAAGCGGGGAGACCTATTAGAGCTACAAATACCA	1	bc
CGCTTCTACC	GAAACACCGGTTGCCGTTACTCCTTTGTTGTGTTAGAGCTATAAATAGCA	1	bc
GTCCGAAGCC	GAAACACCGGCTAGAAATAGCAAGTTGAGCTAAGAGAGGTCCGATATCAA	1	bc
GCATTCCACA	GAACCACCTGTGCTCCTAGTTCGCTCGTGGGGTTAGAGCTAGACATAGCA	1	bc
AAAACCCACG	GAAACACCGGTCTCGTATGTGGGGCTAGAGGTAGAAATAGCAAGATAACC	1	bc
TCACCGCTCC	GAAATACCGGTGACGCTAGGACGGTGGTGGGGTTAGAGCTAGAAATAGCA	1	bc
TGACCACAAT	GAAACACCGGTTAGAATAGGTGGTTAGTGTGGTTAGAGCAAGTTATAGCA	1	bc
TCTTCACTCA	GAAACACCGGTGACGCGAGGATTTGAGCTAGAAATAGAAGGTTAACCTAA	1	bc
ATACCAGCTT	GAAACACCGGTGATAAACGTTTGGCTGTGGGGTTAGAGCTAGAAATAGCA	1	bc
AACTCGATGA	GAAACACCGGTTTAGCATGCGTGGTTAGAGCTAGAAATGGCAAGTTAAGC	1	bc
GCCTCACACG	GAAACACCGGTTCTAGCAAATGCTTATTGGGGGTAAGAGCAGAAAATGCC	1	bc
