AGAATAAGCC	GAAACACCGGTTTTAGTAAATGGTGAGTGGGGTTAGAGCTAGAAATAGCA	3	bc
AACATGCTAG	GAAACACTGGTTTACTTAGTTAACTAGTGGGGTTAGAGCTAGAAATAGCA	2	bc
GATTCTGAAA	GAAACACCGGTACTAGTTACTTACGGGTGGGGTTAGAGCTAGAAATAGCA	2	bc
ACGATAATCA	GAAACACCGGTCCTAGAAGTTGAGTTAGGGGGGTGGTTAGAGCAAGAAAC	1	bc
AACCAAACCT	GAAACACCGGTGGTCGCCGTGGAGAGGGGGGGGTTAGAGATAGAAATAGC	1	bc
GCCTATCTCC	GAAACACCGGTACTAGCTACTTACGGGTGGGGTTAGAGCTTGAAAAAGCA	1	bc
GTACCAAGCG	GAAACACCGGTTATCGTTGCGGATTTGTGGGGTTAGAGCTAGAAATAGCA	1	bc
TCACCATAAC	GAAACACCGGTGACAAACGTATGTCAGAGTGGATAGAGCTAGAAATAACA	1	bc
AGCTTCTCAC	GAAACACCGGTGGCGAAAGTGCGCCGGTGGGGTTAGAGCTAGAAATAGCA	1	bc
TTTATTTCCG	GAAACACCGGTCGCGTATATGTGCCGGTGGGGTTAGAGCTAGAAATAGCA	1	bc
GACCCAGTTA	GAAACACCGGTCTTCCTGGTAGAGCTAGAAGTAGCAAGTTAACCTTAGGC	1	bc
CACTCTCTAC	GAAACACAGGTGCTAGTTGCTTATGTTGGGGGGTAGAGCTAGAAATAACA	1	bc
AACCAGCAAG	GAAACACCGGTGTTCTTTGCTCGAGGGTGGGGTTAGAGCTAGAAATAGCA	1	bc
AAGACCATCA	GAAACACCGGTCTTAGTAGCTGAGTTAAAAGTGAGTTTAGATCTAGATAT	1	bc
TGGTTAACAT	GAAACACCGGTTGGCTTTACATCTACGTGGGGTTAAGCCAGTAAATAGCA	1	bc
TGAACATATA	GAAACACCGGTGAGCATAGAAAGGTTTGGGGGGGGTGGTAGAAATAATAA	1	bc
AAACACCACC	GAAACACCGGTTGTAAGCGATGGCTCGTGGGGGTAGAGCTAGAAATAGCA	1	bc
TTATTACCCC	GAAACACCGGTTGCGAAAATGAGACGGTGGGGTTAGAGTTAGAAATAGCA	1	bc
AACTACATGA	GAAACACCGGTTTAGGAAGTGGGGTTAGAGCTAGTAATAGCAAGTTAACC	1	bc
TACGTTAACA	GAAACACCGGTTGGCTTTACTCCTTTGTGGGGTTAGAGCTATAAATAGCA	1	bc
AGACGGCCAA	GAAACACCGGTTTTGTTGGACTCGGGGTGGGATAAATAGCAAGATAACAA	1	bc
ATCACGCTCG	GAAACACCGGTCCTAGAAGATGGGTTTGAGGGGTTAGAGCTAGAAATGGC	1	bc
CGATGATCAT	GAAACACCGGTGAGAACGGTACGTTTGTGGGTTAGAGCTAGAAATAACAA	1	bc
GGATAGCCAC	GAAACACCGGTGTTCTTTGATCGAGGGTGTGGTTAGAGCTAGAAATAGCA	1	bc
CGACGGGAAC	GAAACACCGGTCTTCTTTGATCGCGCGTGGGGTTAGAGCTAGAAATAGCA	1	bc
AATTCTTTAA	GAAACACCGGTACTGGTTACTTACGGGTGGTATTAAGTTAAGAAATAGCA	1	bc
TGTTCACCCA	GAAACACCGGTGGCAATTCGATCTGAGTGGGGTTAGAGCTAGAAATAGCA	1	bc
GATTCTGTAT	GAAACACCGGTATTAGTTGCTTCTGCGTGGGGTAGGGGTAGAAATAGCAA	1	bc
TGTTCAAAAA	GAAACACCGGTGGGGATAGAGCGATATATAGCAAGTGAACCTAAGGCTAA	1	bc
GAATCAATCT	GAAACACCTGTTATCGTAGCGGATTTGTGGGGTTAGAGCTAGAAATAGCA	1	bc
AAGTTAACAA	GAAACACCGGTTTGCTTTACTCCTTTGTGAGGTTAGAGCTATAAATAGCA	1	bc
AAAACGAAAA	GAAACACCGGTTTTCGAACAGATAGAGAGGGGATGTTGATATAAGGATAG	1	bc
AATCAGCCAC	GAAACACCGGTGTTATTTGCTTGAGGGTGGGGTTGGAGCCAGAAATAGCA	1	bc
TCAACATTCA	GAAACACCGGTGACAGGAGGGGTAGGGCTAGAAATAGCAAGATAAACTAC	1	bc
GTGAATGTAA	GAAACACCGGTCCTAGATACTTACGGGTGGGGTTAGAGCAGGAAATAGCA	1	bc
CCGATAAAAA	GAAACACAGGTTGGCTTTACTCCTTTGTGGGGTTAGAGCTGAAAATAGAA	1	bc
ACCGTGAACA	GAAAAACCTGTTGGCTTTAATCCTTTGTGGGGATAGAGCTATAAATAGCA	1	bc
AGACTATAAC	GAAACACCGGTGTTCTTTGCTCGAGGGGGGGGTTAGAGCTAGAAATGTCC	1	bc
CCAATGTATA	GAAACACCGGTCGTCGCTGCGAGTGTTGGGGTTATAGCTAGAGATATAAA	1	bc
TACTCAGAAA	GAAACACCGGTAGTAGTTACTTACGGGTGGGGTTAGAGCTAGAAATAGCA	1	bc
GGAACTTACT	GAAACACCGGTGAGCGTTAGAACGTACGTGGGGTAGGAGCTAGACATAGG	1	bc
TCATCTGAAA	GAAACACCGGTGGTAGTAGAGCTAGAGATGGCAAGTTAACATAAATATAG	1	bc
TGTTCAGCCG	GAAACACCGGTTTTCCTGGTAGAGCTAGGGGTATCAAGCTAACCTTAGCA	1	bc
GCACGCCACC	GAAACACCGGTAGGGTTGGTAAAGTGCGAGGGATTAGAGCTAAACATAAC	1	bc
TTCCTCGTAT	GAAACACCGGTCGCGAAAATGTGCCGGTGGGGCTAGAGCTAGATATAGCA	1	bc
GGCCGTGTCC	GAAACACCGGTACTCGTTACTTACGGGTGGGGTTAGGGCTAGAAATAGCA	1	bc
TCCACTAACT	GAAACACCGGTTCCGGTTGACTTATAGATGGCATAGTGACCTAAGTCTCA	1	bc
AGCTCATTCA	GAAACACCGGTCCAAACAGCTCAGTTTGGGGTTAGAGCTAGAAATAACAA	1	bc
AAGTCTGTAA	GAAACACCGGTACTAGATGCTGAGGTGTGGGGTGGGAGATAGATATAGAA	1	bc
TTAACCTACT	GAAACACCGGTGGCGCGAGGGATAGAGCTAGAAATAGCAAGTAAACCTAA	1	bc
GCCTAGCACA	GAAACACCGGTTCAACCGGCTTTAGAGCGAGAAATAAGAAGGTAACCTAA	1	bc
AGTTAGGAAC	GAAACACCGGTGTTCTTTGCTCGAGGGTGGGGTTAGAGCTAGTTAAAGCA	1	bc
ATAACCGACT	GAAACACCGGTTGTGATAGATCTTTTATGAGGTTGGTAATAGAAATAGAG	1	bc
GATTGGTAAA	GAAACACCGGTTGTGGGGAACTCGGTGGGGGAGAAATAGCAAGTCAACCT	1	bc
AACTAAGCAA	GAAACACCGGTGCGAATAGCTTATGGGGGTGGATAGAGCTAGAAATCGCA	1	bc
CAGCCAACAC	GAAACACCGGTTGGCTTTACTCCTTTGTGGGGTTAGAGCTATAAATAGCA	1	bc
ATGATCTCCC	GAAACACCGGTCCTAGAAGTTGAGCTAGAAGTGTGGATATAGCTATAAAA	1	bc
CATTCCCTAC	GAAACAACGGTGGCAATTCGATCTGAGTGGGGTTAGAGCTAGAAATAGCA	1	bc
GATTCTGTAC	GAAACACCGGTACTAGTTACTTACGGGTGGGGTTAGAGCTAGAAATAGCA	1	bc
TTCCTATACC	GAAACACCGGTCATGAAAATGTGCCGGTGGGGTTAGAGCTAGAAATAGCA	1	bc
AAACGAGATT	GAAACACCGGTTTACTTAGTTAACTAGTGGGGTTAGAGCTAGAAATAGCA	1	bc
TCCTCATACA	GAAACACCGTTCGCGAAAATGTGCCGAGGGGGTAAGAGTTGGAAATAGAA	1	bc
GAAACAGACT	GAAACACCGGTTTACTTAGTTAACTAGTGGGGTTAGAGCTAGAAATAGCA	1	bc
GTCGACGAAA	GAAACACCGGTACTAGGTATTTACGGGTGGGGTTAGAGCGATAAATTAAG	1	bc
TGATCACCCA	GACACACCGGTGAGAAGAGAACGTTTGGGGGTTAGAGGCAGAAATTACAA	1	bc
AGTCCGGACC	GAAACACCGGTGATATATGCTGGTTTGTGGGTTTGGGGATGGAAAGAACA	1	bc
TAAACCATGC	GAAACACCGGTCTAGAAAGTGGGGCGGGAGGGATGGAGAGCAAAATAACA	1	bc
AATTACCTAA	GAAACACCGGTGGCAATACGAACTGAGTGGGGTTAGAGCTAGAATGAGCA	1	bc
CATTTAAACA	GAAACACCGGTGCTAATAGTTAGCTCGTGGGGTTAGAGCTAGAAATAGCA	1	bc
GCATCGTACA	GAAACACCGGTGCACACGGCATTAGAGGTGGAAGTAGCAAGATAACATCC	1	bc
AGCCGCCACC	GAAACACCGGTAGAGTGTGGTTAGAGCTAGAATTAGCAAGTTAACTAAAG	1	bc
TAATTATCCC	GAAACACCGGTGGTGAAAATGTGCTTGTGGGGTTAGAGCTAGAAATAGCA	1	bc
ATGGCAGAAG	GACACACCGGTCCTAGCAGCTGAGTTAGAAGTGGGGTTAGAGATAGACAT	1	bc
ATGCAATCAC	GAAACACCGGTGACAAACGTATGACAGTGGGGATAGAGCTAGAAATAGCA	1	bc
AAACAATAAC	GAAACACCGGTGCTAATAGTTAGCTGGTGGGGTTAGAGCTAGAAATAGCA	1	bc
TCCTCACCAA	GAACCACCGGTGGTGTTGGAGCTAGAAATAGCCAGTTCACCTAAGGCTAG	1	bc
ATGTCATCCG	GAAACACCGGTCCGAGAAGCTGAGTTAGGGGTTAGGGTAGAGAAAGAAAA	1	bc
TTCATCTACA	GAAACACCGGTCGCGAAAATTTGCCGGTGGGGTTAGAGCTAGAAATAGCA	1	bc
TCAGAGACAA	GAAACACCTGTGGGGTTAGAGCTAGAAATAGCAAGTTAACCTAAGGATAG	1	bc
TAATTAATCC	GAAACACCGGTTGACATAGTCAACAAGTGGGGTAAAGCTAGAAGTAGCAA	1	bc
GCCTCTGACC	GAAACACCGGTTCAAGCTACGTAAGAGCGAGATTTAGCAAGTTAATCGAA	1	bc
TCACCAGATA	GAAACACCGGTGGGGGTAGAGCTAGAAATAGCAAGGTAACCTACGTCTAG	1	bc
TGCTTATCAA	GAAACACCGGTGAGGAAAGTACGCTGGGGGGTTAGAGGTAGAAATAGAAA	1	bc
GAAACCGAAA	GAAACACCGGTACACGTTACTTACGGGTGGGTTAGAGCTAGGAATAGCAA	1	bc
AGATAGGCAA	GAAACACCGGTGTTGTTTGATCGAGGGTGGGGTAAAAGCCAAAAAAAGCA	1	bc
GCCTCCCGCG	GAAACACCGGTTGTGGGGGGTTAGAGGTAGAAATAGCAAGTTAACTTAAG	1	bc
AAATTAATAC	GAAACACCGGTTACAAACGTATGTAAGTGGGGTTGGAGTTGAAAAAACAA	1	bc
GACTCGCACA	GAAACACCGGTTCAACCGACGTTAGAGCGGGAAATAGCAAGGTAACCTAA	1	bc
TCTTCACTCA	GAAACACCGGTGAGAAGAGAACGTTATGGGTATAGAGCTCGAGATAGCCT	1	bc
AAAACATCCC	GAAACACCGGTTTTAGTAAATGGTGAGTGGGGTTCGAGCTAGAAATAGCA	1	bc
ATACTAACAC	GAAACACCGGTTGTAAGCGATGGTTTGTGGGGTTAGAGCTAGAAATAGCA	1	bc
CGCTAACCGC	GAAACACCGGTGTGCGGAGATTATGCGTGAGAAATAGCAAGTAACCTAAG	1	bc
CTGATAACAA	GAAACACCGGTTGGCTTTACTCCTTTGTGGGGATAGAGCTATAAATAGCA	1	bc
ACCCTCACAC	GAAACACCGGTTCAACCGGCGTTAGAGCTAGAAATAGCAAGTTAACCTAA	1	bc
TAATTAATCC	GAAACACCGGTGGGGTTAGAGCTAGAAATAGCAAGTTAACCTAAGGCTAG	1	bc
AATTAACAGA	GAAACACAGGTGGCAATTCGATCTGAGTGGGGTTAGAGCTAGAAATAGCA	1	bc
TAAATAATCA	GAAACACCGGTTCTAATAGTTAAGTTGGGGGGGGGGGTAGAGAAAGAAAA	1	bc
ACACCAAAGA	GAAACACCGGTTGAGTATGAGGTGGTAGGGGTAGGAATAGCAAGTTAACC	1	bc
CGAACGTCAA	GAAACACCGGTGAGCATAGAACGTTTTTGGGATAGAAATAGAAATATCGA	1	bc
CGATCATTCA	GAAACACCGGTGAGGACAGTACGAATTGGGGTTAGAGCTAGAAATAGCAA	1	bc
GGCATTTAAA	GAAACACCGGTCGTCGTTCGTCTGGGTGGGGTTAGAGCTCGAAATAGCAA	1	bc
AGACATGAAA	GAAACACCGGTGTTATTTGCTCGAGGGTGGGGTTAGAGCTAGAAATAGCA	1	bc
GGGCAACACG	GAAACACCGGTTATCGTTACGGGTTTGTGGGGTTAGAGCTAGAAATAGCA	1	bc
ATCTAAAGAC	GAAACACCGGTGTGCGGAGATTATGCGTGAGAAATAGCAAGTAACCTAAG	1	bc
AAATAACAGT	GAAACACCGGTGTTAGGGGATTCTACGTGAGGAATTACAAGGAACCTGCG	1	bc
TTCTTAAACA	GAAACACCGGTCGCGTAAGTGTGACGGAGGGGTTGTAGATAGAAATCGAA	1	bc
AAGAATGTTG	GAAACACCGGTGCTCTTTCTGGGACCGTGGGGTTAGAGCTAGAAATAGCA	1	bc
AAAAATCACT	GAAACACCGGTGCACTTTGTGGGATCGTGGGGTTAGAGCTAGAAATATCA	1	bc
AAGACGCAAG	GAAACACCGGTTCTAGTAGGTGAGTTAGGAGTGTGGATCGAGATAGAAAA	1	bc
ATTCTTATCC	GAAACACCGGTCGCGAAAATGTGCCGGTGGGGTTAGAGCTAGAAATAGCA	1	bc
ATATCCCCCC	GAAACACCGGTTCTAGGGGAATATCAAGTTGACCTGAGCCTAGACCGTTA	1	bc
TCAGCCCACA	GAAACACCGGTGGGGCTAGAGCTAGAAATAGCAAGTTAACCTAAGGCTAG	1	bc
GGCAACTACA	GAAACACCGGTGAGAACCGGCCACTTGTGGGGTTGAGGCAAGAATAAGAA	1	bc
ACCAACCGAC	GAAACACCGGCAGAGTGGGGTTAGGGGTAGAAATAGAAAGAGAACTAAAG	1	bc
AAAACATAAC	GAAACACCGGTTTAATTCGTTAATTAGGGGGGGTAGAGGCAGGAATAGCA	1	bc
ATGACATTCA	GAAACACCGGTGCGAGAAGATCTGTTAGAAGTAAGGTTAGAGAAGGCTAT	1	bc
ATCTCCACGA	GCAACACCGGTGTGCGGAGATTATGCGTGAGAAATAGCAAGAAACCTAAG	1	bc
TCACCCCGCC	GAAACACCGGTAGAGTGGGGTTAGAGCTAGAAATAGCAAGTTAACCTAAG	1	bc
GTCTCCTGCC	GAAACACCGGTCGCGAAAACGTGTCGGTGGGGTTAACGCTAGAAATAGCA	1	bc
ATTTATGCAA	GAAACACCGGTACTCGTTGATTACGCGTGAGAATAGACATAGAACCTGAA	1	bc
TCCAACACCC	GAAACACCGGTGGTCGCCGTGGAGAGGGTGGGGTTAGAGCTAGAAATAGC	1	bc
AAATCGCCAG	GAAACACCGGTTTTCGTTCATGGTGAGTGGGGTTAGAGCTAGAAATAGCA	1	bc
ATACAAGAAT	GAAACACCGGTTGTAAGCGATGGTTTGTGGGGTTAGAGCTAGAAATAGCA	1	bc
TGTCTCGACT	GAAACACCGGTCTTCCTGGAAGAGCTAGAAATAGCAAGTTAACCTGAGGC	1	bc
ATACCATCCC	GAAACACCGGTGCCAAACGTCTGTCAGTGGGGTTAGAGCTAGGAATAGCC	1	bc
TCCGCATACA	GAAACACCGGTGGGGTTAGAGTTGGAGATAGCAAGTTAACCTAAGGCTCG	1	bc
AGAAAGCCAA	GAAACACCGGTGTTCTTTGCTCGAGGGTGTGGTTAGAGCTAGAAATAGCA	1	bc
CACCCCATCC	GAAACACCGGTATAGTGTGGATAGAGGTGGGGTTAGCAAGTTAACCTGCG	1	bc
TGTTTATCCA	GAAACACCGGTGAGTACAGTACGTTTTGGGGTTAGAGCTAGCAATAGCAA	1	bc
TAATCAGATT	GAAACACCGGTCTTCCTGGTAGAGCTAGAAATAGCAAGTTAACCTAAGGC	1	bc
ATGTCACTCA	GAAACACCGGTCCTCGGAGATGATTTGGGAGAGGGATTAAGGCTCGAAAT	1	bc
AATTACGCCA	GAAACACCGGTTGTGGGGAACTCGGTGTGGGAGAAGTAGCAAGTTAACCT	1	bc
AGGTTCATGA	GAAACACCGGTGAGAACAGAACGTTTTGGGGTTAGAGCTAGAAATAGCAA	1	bc
TCACCGCAAC	GAAACACCGGTGTACTTTGCTCGCGGGTGGGGTTAGAGCTAGAAATAGCA	1	bc
GCCAACGTCA	GAAACACCGGTGGCGGGAGGTTAAGAGCTAGAAATAGCCAGGTAACCTAA	1	bc
GGACATGAAA	GAAACACCGGTGCTATTTACTCAAGGGTGGGGTTAGAGCTAGAAATAGCA	1	bc
GTGCCAATCC	GAAACACCGGTGAGCGCAGCGCATTTGGGGGGTAAGGCTAGGAAAAACCA	1	bc
ATGCCACAAC	GAAACACCGGTTGGCTTTACTCGTTTGTGGGGTTAGAGCTATAAATAGCA	1	bc
AGACCACCAC	GAAACACCGGTGATCTTTGCACGAGGGTGGGGTTAGAGCTAGAAATAGCA	1	bc
TGTTCACCCA	GAAACACCGGTGAGGACAGAACGATTTGGGGTTAGAGCTAGAAATAGCAA	1	bc
GAGCCCGTGA	GAAACACCGGTGTAGTATGTGGGATTAGAGCTAGAAATAGCAAGTTAACC	1	bc
AGATTGCCAC	GAAACACCGGTGTTGTATGCTTGAGGGTTGGGTTTGAGTTTGAAATAGCA	1	bc
AGATAACACC	GAAACACCGGTTTTCTTAATTCAAAGGTGGGGTTAGAGCTAAAATTGCAA	1	bc
GAACTGTAAA	GAAACACCGGTGTGCATGGTAACGGAGCGGGGTTAGATCAGGAAATAGCA	1	bc
AAAACCCTCC	GAGACACTGGTGACGCGCGGGTTAGAGCTAGAAATAGCAAGTTAACCTAA	1	bc
ACCACTCCCT	GAAACACCGGTTCCAGTTAGCTCGTAGTGGGGTTAGAGCTAGAAATAGCA	1	bc
GAGTTCATCC	GAAACACCGGTAATCTAAATACCCTCGTGGGGTTAGAGCTAGAAATAGCA	1	bc
TTCTCCCTCC	GAAACACCGGTCGCGAAAATGTGCCGGTGGGGTTAGAGCTAGAAATAGCA	1	bc
TATTCAGCCT	GAAACACCGGTTTTAGTACATGGTGAGTGGGGTTAGAGCTAGAAATAGCA	1	bc
ATACCAACCC	GAAACACCGGTTGTATGCACTCCTTTGTGGGGTTAGAGCTAGAAATAGCA	1	bc
AGACAGATCC	GAAACACCGGTGTTCTTTATTCGAGGGTGGGGTTAGAGCTAGAAATAGCA	1	bc
ACCTCGATGC	GAAACACCGGTTTAACATGGGTTAGAGCTGGGTATAGCAAGGTAACATAA	1	bc
GACGTTCATC	GAAACACCGGTGAGAACAGAACGTTTTGGGGTTAGAGCTAGAAATAGCAA	1	bc
AAGTTCACAC	GAAACACCGGTTTGCTTTACTCCTTTGTGGGGTTAGAGCTATAAATAGCA	1	bc
TATGCAGAAA	GAAACACCGGTTGTGTGAGAGCTAGAAAGGGCAAATTAACATGAGAATCT	1	bc
ATCTCTCCCC	GCACCACCGGTGTCCTTTGTTTATGCGTGGGCCTTAGCAAGTAACCTCAG	1	bc
ACATCAGAAA	GAAACACCGGTGGGGGTAGATCTAGAAAGGGGAAGTTAACCGAAGTCGAG	1	bc
AACATGCTAG	GAGACACCGGTTATCGTTACGGATTTGTGGGGTTAGAGCTAGAAATAGCA	1	bc
AAACGGGCAC	GAAACACCGGTTGTGGGGGACTCGGGGTGGGGGTAGTGGCAGGTTTACCT	1	bc
GGAATAGATT	GAAACACCGGTCTTCCTGGTAGAGCTAGAAATAGCAAGTTAGCCTAAGGC	1	bc
ACTACTGCCC	GAAACACCGGTAGAGTGTGGGTAGAGGTGGGAATAGCACTTGAACCTGAG	1	bc
TACAATCTCT	GAAACACCGGTAATGCGAGGGTAAGAGCTAGAATTAGCAAGTTAACCTAA	1	bc
AACTCTGTAC	GAAACACCGGTACTAGTTGCTTACGGGTGGGGTTAGAGATAGAAATAGCA	1	bc
TAATTTGTAC	GAAACACCGGTACTAGTTACTTACGGGTGGGGTTAGAGCTAGAAATAGCA	1	bc
CCAACAGAAA	GAGACACCGGTGGGGTTAGAGCTAGAAATAGCAAGTTAACCTAAGGCTAG	1	bc
AGCCACTAAG	GAAACACCGGTGGCTTGAGCTCGCAAGTTAGCCTAGGGCTGGTACGATCT	1	bc
CCGCTCCCCC	GAAACACCGGTAGGGTTTGGTTATAGCTGGGATTAGCACTATAACCTAAG	1	bc
GTATCAGCAC	GAAACACCGGTTTTCGTAACTGGTGAGTGGGGTTAGAGCTATAAATAGCA	1	bc
GGGTCAAGAA	GAAACACCGGTTATCACTACGGATTTGTGGGGTTAGAGCTAGAAATCGCA	1	bc
AAACCAATCG	GAAACACCGGTTTAGTATGTGGGGTTAGAGCGAGAAATAGCAAGATAACC	1	bc
GCGTCAAAAC	GAAACACCGGTTGGCTTTACGCCTTAGTGGGGTTAGAGCTATAAATCGCA	1	bc
AGATCAAAAA	GAAACACCGGTGCTCTTTGATAGAGGGTGGGGTTGGAGCTAGAAATAGCA	1	bc
CTCACCCTCC	GAAACACCGGTCCTAGAAGCTCAGTTTAGGGTGGGGTTAGAGCTAGAAAT	1	bc
AAATGCCCAA	GAAACACCGGTTGTGGGGAACTCGGTGTGTGAGTAATAGCAAGTCAACCT	1	bc
TCAACTGTCA	GAAACACCGGTGACGCTAGCGTTAGAGCTGGAAATAGCAAGTTAACCTAA	1	bc
ATATCAAAAA	GAAACACCGGTGGCAATTCGATTTGAGCGGGGTTAGAGCTAGAAATAGCA	1	bc
AACCACGTGA	GAAACACCGGTTTTGTATGTGGGGTTGGGGGTAGAGATCGAAAGTTAGCA	1	bc
GACTGCGCAA	GAAACACCGGTAGTAGGTAATTGAGGGTGGGAGTAAAGTTACCTAAAGCT	1	bc
AAAACAGTCG	GAAACACCGGTTTTCGTAAATGGGTGGTGGGGTTAGAGAAAGAAAAAGCA	1	bc
GGCACTAGCT	GAAACACCGGTTCCCGTTAGCTCGTAGTGGGGTTAGAGCTAGAAATAGCA	1	bc
TCTAAACCTT	GAAACACCGGTGTCCGGAGGGTAGGGGTGGGAATAACCAGTTAACATAAG	1	bc
GGGACAAACG	GAAACACCGGTTATCGTTACGGATTTGTTAGGTTAGATCTAGAAATAGCA	1	bc
AAAACGCTCT	GAAACACCGGTGTCGCGAGGGTTAGAGCTGGAAATAGAAAGTTAACATAA	1	bc
TCATTGGGCA	GAAACACCGGTTGGCTTTACTCCTTTGTGGGGTTAGAGCTATAAATAGCA	1	bc
AATCACTCCC	GAAACACCGGTGACAAACGTATGTCAGTGGGGTTAGAGCTAGAAATAGCA	1	bc
CCCTAACCGC	GAAACACCGGTTCGCGCGGCGTAAGAGCTAGAAATAGCAAGTAAACCTAA	1	bc
ATGCCCATCA	GAAACACCGGTCTTGTACGCTGAGATTGTGGGTGAGATCTAGCTAGACCT	1	bc
AATTCCCAGA	GAAACACCGGTGGCAATTGGATCTGAGTGGGGTTAGAGCTAGAAATAGCA	1	bc
GCGTGCAGCG	GAAACACAGGTTATCGTTACGGATTGGTGGGGTTAGAGCTAGAAATAGCA	1	bc
CACTCGCATA	GAAACACCGGTTTAACCTGGGTGAGAGCGGGAAATAGCAAGTAAACCTAA	1	bc
GAATAACAGA	GAAATACCGGTGAGAAAGCCATATGTTTGGGGAGAGAGAGAGAAATAACT	1	bc
ACCAGCCTCC	GAAACACCGGTAGAGGGGGGTTAGAGCTAGAAATAGAAAGTTAACCTACG	1	bc
GGTTCTTTAA	GAAACACCGGTGAGAACTGAACGCTTTGGGGTTAGAGCTAGAAAAAGCAA	1	bc
GAAAAAGACG	GAAACACCGGTTTTAGTAAATGGAGAGTGGGGTTAGAGCTAGAAATAGCA	1	bc
CCTCTAAATC	GAAACACCGGTTAGCATGATAACTTTGTGGGGTTAGAGCTAGAAATAGCA	1	bc
CGTCACGATT	GAAACACCGGTCTTCCTGGTAGAGATAGAAATCGCAGGTTAACCTAAGGC	1	bc
AATCCCGTGT	GAAACACCGGTTGTGGGGGACTCGGTGCGGGTGAAATAGCAAGTTAACCT	1	bc
TCCGCTTCCA	GAAACACCGGTTGGGTTAGAGCTAGAAATAGCATGTTAACCTAAGGCTAG	1	bc
GACCATCAAA	GAAACACCGGTACTAGTTACTTGAGGGTGGGGTTAGAGCTAGAAATAGCA	1	bc
GAGCCAAACT	GAAACACCGGTCATCGTTAAGTCTTTGTGGGGTTGGAGCTTGAAATAGCA	1	bc
GGCTCAACAA	GAAACACCGGTGAGGTCAGAACGCGCTGGGGCAAGAGCTAGTAAGTGTAA	1	bc
TCCGATAAAA	GAAACACCGGTGGGGGTAAAGCTAGAGATAGCAAGTTAACATAAGGATAG	1	bc
CCATCACTCC	GAAACACCGGTTCAAACAGCGAGAAGGTAGGGCTGGTAGAAACAAGATAA	1	bc
GAATCTGTAG	GAAACACCGGTACTGGTTAATTACGGGTGGGGTTAGAGCTAGAAATAGCA	1	bc
GCCCGCCCCG	GAAACACCGGTATAGTGGGGTTAGAGCTAGGAATAGCACGTTAACCTACG	1	bc
GAATAATACG	GAAACACCGGTTTTAGTAAATGGTGAGTGGGGTTAGAGCTAGAAATAGCA	1	bc
CAACGCCGAA	GAAACACCGGTGGTGTGGGGTTAGAGCTAGAAATAGAACGATAACCTACA	1	bc
GTGTCATGAG	GAAACACCGGTTATGGTAACTGATTTGTGGGGTTAGAGCTAGACATAGCA	1	bc
AGATATCAAA	GAAACACCGGTGTTCTTTGCTCGAGGGAGGTTTTAGAGCTAGAAATAGCA	1	bc
TCAACAATAT	GAAACACCGGTGGGGTTAGAGCTAGAAATAGCAAGTTAACCTAACGCTAG	1	bc
AAATCCAACC	GAAACACCGGTTTAGTATGTGGGGGTAGGGCGATGAATAGCAAGATAACC	1	bc
TTTTCATCAC	GAAACACCGGTGACAAAAGTGTGTCGGTGGGGTTAGAGCTAGAAATAGCA	1	bc
TATTTACTAA	GAAACACCTGTGGCAATTCTATCTGAGTGGGGTTAGAGTTAGAATTAGCA	1	bc
CACTTTGCAC	GAAACACCGGTACTCGTTACTTACGGGTGGGGTTAGAGCTAGAAATAGCA	1	bc
TAGTTAATAC	GAAACACCGGTTGGCTTTACTTCTTTGTGGGGTTAGAGCTATAAATAGCA	1	bc
CCCAACCACC	GAAACACCGGTGGCGGGGAGCTAGAGCTAGGAATAGCAAGTTAACATAAG	1	bc
CAACGTGTCT	GAAACACCGGTACTAGTGGCTTACGGGTGGGGTTAGAGCTAGAAATAGCA	1	bc
TAGACCATAT	GAAACACAGGTGACGCGTGGGCTAGAGCTAGAAATATCCAGTTAACATAA	1	bc
TCAGCCACAC	GAAACACCGGTGTGGTTAGAGCTAGAAATAGCAAGTTAACCTAAGGCTAG	1	bc
GCAATATCTT	GAAACACCGGTCGTCGTTCGTAGGGGTGGGGGTAGAGCTAGAAATAGCAA	1	bc
GACTAAAGAG	GAAACACCGGTACTAGTTACTTACGGGTGGGGGTAGAGCTAGAAATAGCA	1	bc
ATGACATACA	GAAACACCGGTCAGAGAAGCGGAGTTAATAGCAAGGTAAGAGATAGATAT	1	bc
GCACTAGGCC	GAAACACCGGTAGGGTTATAGCAAGAGATGGGTTGGAGATTGAAGTCTAA	1	bc
GTGACAGGCG	GAAACACCGGTCCTAGAAGCTGATTTAGTGGGGTGGGTGCTACTAGAAAT	1	bc
CTCTCCTACC	GAAACACCGGTCCCACAGGTGTTCCAGCTGGAATTAGCCTGGTAATCTAA	1	bc
GACTATATCC	GAAACACCGGTACTGGTTACTTAAGGGTGGGGTTAGGGTTAGAAAAGGCA	1	bc
GGAAAAGAAA	GAAACACCGGTGATCTTTACTCAGGGGTGGGATTAGAGCTAGAAATAGCA	1	bc
AATGCGACAA	GAAACACCGGTTGGGTTAGACCTAGAGATGGCGAGTTAGCCTGAGGCTCG	1	bc
GACTCTCAAA	GAAACACCGGTGGCAGTTCGATCTGAGTGGGGTTAGAGCTAGAAATAGCA	1	bc
TCATCACACC	GAAACACCGGTGGGGCCAGCGCTAGATTTGGGATGATAACCAAAGGCTAG	1	bc
AACATCCGAG	GAAACACCGGTAGAGTGGAGTTAGAGTTAGAAATAGCAAGTTAAACTAAG	1	bc
GAGACACGCC	GAAACACCGGTTATCGAAAGGGCTTTGTGGGGATAGAGCTAGAAATAGCA	1	bc
GAGTTAACAG	GAAACACCGGTTATCGTTACGGATTTGTGGGGTTAGAGCTAGAAATAGCA	1	bc
CCATCGAACA	GAAACACATGTTCAAACGGTGATAGAGCTGGGTATAGCAAGTTAACATAA	1	bc
TAAGCAATAC	GAAACACCGGTGGGGTTAGCGCTAGAACTAGCACGATAAGCTAAGGCTAG	1	bc
TGCGACTAAA	GAAACACCGGTGGGGTTCGAGCTCGTGATGGCAAGTTGCCCTAAGGATCG	1	bc
ATAACCGACT	GAAACACCGGTTCTAGGAGATGGTTTGTGGCGTTAGAGCTCGAATTAGCA	1	bc
GAAACAGCAT	GAAACACCGGTTTTAGCAGTTGGAGAGGGGGGTTAGAGCTAGGAATAGCC	1	bc
GAATCGCACC	GAAACACCGGTTTAACTGGAGGCTTTTGGGGGGTAAGGGCAAGAAATAGA	1	bc
GCATCAATCG	GAAACACCGGTTATCGTTACGGATTTGTGGTGTTAGAGCTAGAAATAGCA	1	bc
AATTGACCGA	GAAACACCGGTTGTGGGAAACTAGGCGTGGGAGAAAGCGCGAATTAACCT	1	bc
TGCTCTGTAT	GAAACACCGGTTCTAGTTACTTACGGGTGGGGTTAGTGCTAGTAGCAGCA	1	bc
ATCCAATACT	GAAACACCGGTTGCAAGCGACGGTTTGTGGGGTTAGAGCTAGAAATAGCA	1	bc
GACTAAGCAG	GAAACACCGGTATTAGTAAATGGCGGGTGGGGTTAGAGCTAGAAATAGCA	1	bc
TCCTACCTCT	GAAACACCGGTAACGGGAGGGTTAGAGCTAGAATTAGCAAGGTAACATAA	1	bc
TCTACACTAT	GAAACACCGGTGACAAGAGGATTAGAGCTGGGATTAGCAAGGTAACCGCA	1	bc
AAGACCGCCC	GAAACACCGGTCCCAAAAGTAGAGTTAGAGGGGGTGTTAGAGGAGGTAAT	1	bc
ATGTGGGTAG	GAAACACCGGTCCTAGAAGCTGAGTTGGGAGTGGTGTTAGAGCTAGACAT	1	bc
AGATCATTGA	GAAACACCGGTTAAGAAAGAACGTTTTGGGGTTGAAGTTAGAAATAACAA	1	bc
ATTCTTCTCA	GAAACACCGGTCGCGAAAATGTGCCGGTGGGGTTAGAGATAGAAATAGCA	1	bc
CTCCGACCTA	GAAACACCGGTGTGCGGTGATTGGGCGTGGGAAGTAGCAAGTAACCTCAG	1	bc
AATCATGCGA	GAAACACCGGTGCCGTTTATGGGAGCGTGAGGTTGGAGCTGGAAGTTACA	1	bc
AATTGGTCCC	GAAACACCGGTTGTGGGGAACTCGGTGTAGGAGTAATAGCAAGTTAACCT	1	bc
ACTCGACCCC	GAAACACCGGTAGAGTGGGGTTAGAGCTAGGAATAGCAAGTTAACCTAAG	1	bc
TGTTCATCCT	GAAACACCGGTGAGAATAGAACGTTATGTGGTTAGAGCTAGAAATAGCAA	1	bc
ATGCGAGTCG	GAAACACCGGTGCTAGAGGCTGAGGTTGGAGATAGGATAGTAATCTAAGG	1	bc
AGAATATAAA	GAAACACCGGTGGTCGTTCGTAGGGGTGGGGTTAGAGCTAGAAATAGCAA	1	bc
GAGTTTGCAC	GAAACACCGGTAGTCGTTACTCATTGGTGGGGTTAGAGCTATAAATAGCA	1	bc
CATTCCCTCC	GAAACACCGGTAGCAATTCGATCTGCGTGGGGTTAGAGCTAGAAATAGCA	1	bc
CGCTCATCCC	GAAACACCGGTGAGAACAGAACGTTTTGGGGTTAGAGCTAGAAGTAGCAA	1	bc
GAGTTAACCC	GAAACACCGGTTGGATTTACTCCTTTGTGGTGTTAGAGCTATAAATAGCA	1	bc
AACAAGCACC	GAAACACCGGTTCAATAGGCGTTAGAGCTAGGAAAAGCAAGGTAACATAA	1	bc
AGACACCTAA	GAAACACCGGTGTTCTGTGCTGGAGGGTGGGGATAGAGATAGAAATAGCA	1	bc
GGGTCAAGAA	GAAACACCGGTTATCGTTGCGGGTTTGGGGGGTTAGAGCTGAAAATGGAA	1	bc
ATGCCGGTAG	GAAACACCGGTCCTCTAAGCTGAGTTAGGGGTGGGGATCGAGCTAGAGCT	1	bc
TACTATTCAT	GAAACACCGGTACTAGTTACTTACCGGTGGGGTTAGAGCTAGAAATAGCA	1	bc
ACCATTGAAC	GAAACACCGGTTCAACCGGCGTTAGAGCTAGAAATAGCAAGTTAACCTAA	1	bc
GTAGAGCAGA	GAAACACCGGTGATCTTTGCTCGAGGGGGGGGTTAGAGCTAGGAATAGCA	1	bc
GTGAAAATCA	GAAACACCGGTTATCGTTAGATCGTAGGGGGAGAAAAGGCAAGATAACCA	1	bc
GTGCTCTGTA	GAAACACCGGTCCTCGTTACTTCCGGGTGGGGTTAAAGCTAAAATTACCA	1	bc
CCCTTGAACA	GAAACACCGGTGCAAACGGCGAGAGAGCTAGAAAGAGCAAGTAAATCTAA	1	bc
GAATCTGAAA	GAAACACCGGTACTCGTTACTTACGGGTGGGGTTAGAGCTAGAAACAGCA	1	bc
GATCCAAAAG	GAAACACCGGTTATCGTTACGGATTTGTGGGGTTAGAGCTAGAAATAGCA	1	bc
ATAGAAAAGA	GAAACACCTGTGTGGGGAGAGAAAGAGATAGAAAGTGAACGTAAGGCAAG	1	bc
CACACGCTCC	GAAACACCGGTTCACCCGGCGTTACAGCTGGAATTAGCATGGTAATCTCA	1	bc
AGACTATGTC	GAAACACCGGTACTAGTTACTTACAGGTGGGGTTAGAGCTATAAATAGCA	1	bc
CCGTTGCAAC	GAAACACCTGTTGGCTTTACTCCTTTGTGGGGTTAGAGCTATAAATAGCA	1	bc
TCAGACCCCA	GAAACACCGGTGGGGTTAGAGCTAGAAATGGCATGTTAACATAAGGATCA	1	bc
GACTTCAACC	GAAACACCGGTAATCTAAAGATCCCCGTGGGGGTAGAGCTAGAAATAGCA	1	bc
CGTCGATCAC	GAAACACCGGTGAGAAGAGAACGTTTTGGGGTTAGAGCCAGAAATAGCAA	1	bc
ATTCCGTAAC	GAAACACCGGTGACAAACGTATGTCAGTGGGGTTAGAGCTAGAAATAGCA	1	bc
TTTCTCTATC	GAAACACCGGTCGCGCTGATGTGCCGGTGGGGTTAGAGCTAGAAATAGAA	1	bc
CCATCACACA	GAAACACCGGTGGCAATTCGACCTGAGAGGTAGTAGAGCTAAAAAAAGCA	1	bc
ATCTTATCCA	GAAACACCGGTGTCCGAAGATTATCCGTGAGAATTAGCAAGTAACTTAAG	1	bc
ACACTACCCC	GAAACACCGGTTGTATTCGCTGCTTTATGGGGTTAGAGCTATAAATAGCA	1	bc
CAACGGGATG	GAAACACCGGTGGTGGTGGAGCTGGAAGTGGGGAGATAGCCAGAGACTGG	1	bc
AGTCCAGCTG	GAAACACCGGTCTTCCTGGTAGAGCTAGGAGTAGAAAGTTAGCCAAAGGC	1	bc
TTATTGTCAC	GAAACACCGGTCGCGAAAATGTGCCGGTGGGGTTAGAGCTAGAAATAGCA	1	bc
TTGCCAGACT	GAAACACCGGTCTTAGAAGCTGAGTTAGAAGTAGCGATAGAACTAGAGAT	1	bc
CATCGATCTC	GAAACACCGGTGACAAACGTATGTCAGTGGGGTTAGAGCTAGAAATAGCA	1	bc
CCTTCACCAC	GAAACACCGGTGGCCATTCGTTCTGAGTGGGGTTAGAGCTAGAAATAGCA	1	bc
ATATTCTCCA	GAAACACCGGTTGCGAATGTGGGGCGATGGGGATGGAGAGAGAAATAGCA	1	bc
CCGTTGCCCC	GAAACACCGGTTGAATTGGCTCCTTTGTGGGGGGAGAGCTATAGATAGCA	1	bc
GAGGCAGCAA	GAAACACCGGTGAGAACAGAACGTTTTGGGGTTAGAGCTAGAAATAGCAA	1	bc
TGTAAAGCTT	GAAACACCGGTCTTCCTGGTAGAGCTAGAAATAGCAAGTTAACCTAAGGC	1	bc
TCAGCGAACC	GAAACACCGGTGGAGTTAGCGCTAGAAATAGCAAGTTAACCTAAGGCTAG	1	bc
AAATCAGCAC	GAAACACCGGTTACCTTCGCTTGTTTGTGTGGTTAGAGCTAGAAATAGCA	1	bc
ATGAAAGTAG	GAAACACCGGTCCTAGGAGCTGAGTTGGAAGAGGGGTTAGAGTTAGAAAT	1	bc
TACGCACACC	GAAACACCTGTGGGGTTAGAGCTAGAAATAGCAAGTTGACCTAAGGCTAG	1	bc
ATCTTCTTTC	GAAACACCGGTCGCGAAAAGGTGCCGGTGGGGTTAGAGCTAGAACTAGCA	1	bc
CTGTCACGCG	GAAACACCGGTTATCGTTGCTGATTTGTGGGGTTAGAGCTAGAAATAGCA	1	bc
AAATTGCCAG	GAAACACCGGTTTTCGTTCATGGGGAGTTGGGTTAGAGCTAGGGATTACA	1	bc
AATAATGGAA	GAAACACCGGTGCCCTTTATGAGATCGTAGGGATAGAGCTAGAATTAGAA	1	bc
GAGTGAAAGG	GAAACACCGGTTATCTTTGCGAATTTGTGGGTATAGAGCTATAAATCGAA	1	bc
CCCGCATCAA	GAAACACCGGTGAGGACAGAACGATAAGGGGTTAGAGCAAGTAAGAGCAA	1	bc
CAATCCCCAT	GAAAAACCGGTTTACTTAGTTAACTAGTGGGGTTAGAGCTAGAAATAGCA	1	bc
AGACAAAAAA	GAAACACCGGTGTTATTAGCTAGAGGGTGGGGTTAGAGCTAGAAATAGCA	1	bc
AAATTCACAA	GAAACACCGGTGGCAATTCGATCTGAGTGGGGTTAGAGCTAGAAATAGCA	1	bc
CACTTAACAT	GAAACACCGGTTGGCGTGACTTATGTGTGGGGTAAAAGAAATAAACAGCA	1	bc
CACTCCTCAA	GAAACACCGGTCTCGAAAGTAGGCCGGTGGGGTTAGAGCTAGAAATAGCA	1	bc
TCCCAACTCC	GAAACACCGGTAGAGTGGGGTTAGAACTAGAAATAGCAAGTTAACCTCCG	1	bc
GTGTAAACCG	GAAACACCGGTGATCGTTACTGATTTGTGGGGTTAGAGCTATAAATAGCA	1	bc
GACTTATCCC	GAAACACCGGTCGCGAAAATGTGCCGGTGGGGTTAGAGCTAGAAATAGCA	1	bc
ATGTCAGCCG	GAAACACCGGTCCTAGAAAATGAGTTGGGGGGTTAGAGATAGCAAGAGAT	1	bc
TCCTGCAGCC	GAAACACCGGGGGAGGGGGGTTAGAGCTAGATAAAGCAAGGTAACCTATG	1	bc
ATGATAGTAA	GAAACACCGGTCCTAGAAGCTGAGTTAGGGGGGGAGATAGAGAAAGAGAT	1	bc
CCAACACCCA	GAAACACCGGTGAGACCAGGACGTTATAGCTAGAGATAGCAAGTTAACCT	1	bc
AAACGAATTA	GAAACACCGGTTTAGTATGCGGGGTTAGAGCTAGAAATAGCAAGTTAACC	1	bc
CAGACAGTCG	GAAACAACGGTCCTAGAAGCTGAGTTAGGGGGGGGGGTAGAGCTAGAAAT	1	bc
AATCCCAAAA	GAAACACCGGTTTTGTAGGACTCGGTATGGGTAAAAAAACCAATTAACCC	1	bc
GTGTGACGCG	GAAACACCGGTTATCGTTACGGATTTGTGGGAATAAAGCTAGAAATTGAA	1	bc
GGGCAAAGCG	GAAACACCGGTGATCGTTACGGATTTGTGGGGTTAGAGCTAGAAATAGCA	1	bc
ATCAAACACT	GAAACACCGGTTGTAAGCGATGGTTTGTGGGGTTAGAGCTAGAAATAGCA	1	bc
AATTTCCCAC	GAAACACCGGTTGTGTTTAACTCTTTGTGGGATAAATAGCAAGTTAACCT	1	bc
ATGACCAATA	GCAACACCGGTGATAGAAGCTGAGTTAGAAGGGGAGTTAGAGCTAGAAAT	1	bc
CCACCCCGCA	GAAACACCGGTAGAGTGTGGTTAGAGCTAGAAATAGCAAGTTAACCTAAG	1	bc
CTCCCACACC	GAAACACCGGTTGAAAGCGATGGTTTGTGGGGTTAGAGCTAGAAATAGCA	1	bc
GAATTTTCCA	GAAACACCGGTTTTAGTAATTGGTGAGTGGGGTTAGAGCTAGAAATAGCA	1	bc
ATAACGCAAC	GAAACACCGGTGTTCTTTGCTCGAGGGTGGGGTTAGAGCTAGAAATAGCA	1	bc
AACTAGGTAG	GAAACACCGGTACTAGTTACTTACGGGTGGGGTTAGAGCTAGAAATAGCA	1	bc
GAGACATATA	GAAACACCGGTCGTCGTTCGTAGGGGGGGGGTTAGAAGTAGAAATAGCAA	1	bc
AGTTCACCGA	GAAACACCGGTGTGCGGAGATTATGCGTGAGAAATAGCAAGTAACCTAAG	1	bc
AATTCAGCCC	GAAACACCGGTGACAAACGTATGTCAGTGGGGTTAGAGCTAGAAATAGCA	1	bc
GTTATTTACG	GAAACACCGGTGCCCTTTCTGAGACGGTGGGACTAGGCAAGAAAAAACAA	1	bc
CACTCGAACA	GAAACACCGGTTCAAACGGCGTTAGAGCTAGAAATAGCAAGTTAACATAA	1	bc
GCACTCCGCC	GAAACACCGGTAGACATGGGATAGAGCTAGATATAGATAGCTAGTTTAAG	1	bc
AAGCCCGTCA	GAAACACCGGTCCTAGAAGCTGAGTTGGAAGTGGGGATAGAGCTAGAAAT	1	bc
AATAACCAAG	GAAACACCGGTGGCAATTCGATCTGAGTGGGGTTAGAGCTAGAAATAGCA	1	bc
CTTACCTCCA	GAAACACCGGTCCTAGCAGCTCGGTTTGGGGTTAGAGCTAGGAATAGCCA	1	bc
TAAGAAAACA	GAAACACCGGTGGTGTAAGAGTCAGAGATAGCATGTTAATCTAAGGATAG	1	bc
ATGTGCGTAG	GAAACACCGGTCCTAGAAGATGAGCTAGAAGAGGGGTTAGAGGTAGACAT	1	bc
CGGCTAAAAC	GAAACACCGGTTGGCTTTACTCCTTTGTGGGGTTAGAGCTATAAGTAGCA	1	bc
AATTTACCAA	GAAACACCGGTTGTGGGAGACTCGGCGTGGGGTTAATAGCAAATTAACCT	1	bc
CGCTCGTCCT	GAAACACCGGTTCACCCGGCGTTAGAGCTGGAATTAGCAAGTTAACGTAA	1	bc
GATTCATATA	GAAACACCGGTGGCAATTCGATCTGAGAGGGGATAGAGATCGAAATAGCA	1	bc
ATGCTAAACC	GAAACACCGGTTGGATTCGCTGGTTTGTGGGGTTAGAGCCAGAAATAGCA	1	bc
GATCCAGCTT	GAAACACCGGTTTTCGTAAATGGTGAGTGGGGTTAGGCCTGGAATAACCA	1	bc
GACTAAAACC	GAAACACCGGTGATCATAATTAGCTCGTGGGGTTAGAGCTAGAAATAGCA	1	bc
ATTCTTCACC	GAAACACCGGTCGCGAAAATGTGCCGGTGGGGTTAGAGCTAGAAATAGCA	1	bc
CCATCGACCG	GAAACACCGGTTCAACCGGCGGTAGAGCTGGAAATAGCAAGGTAACATAA	1	bc
AGACTAAGTA	GAAACACCGGTACTAGTTAATTACGGGTGGGGTTAGAGCTAGAAATAACA	1	bc
TACACACACC	GAAACACCGGTCTTCTAGGTAGCGCCGGAGGTAGCGAGCTAGCCATAGCC	1	bc
TGAGTCCAAC	GAAACACCGGTTATCGTTACGGATTTGTGGGGTTAGAGCTAGAAATAGCA	1	bc
TGTTCCTAAA	GAAACCCCGGTGAGGACAGAACGTTTTGGGGTTAGAGCTAGAAATAGCCA	1	bc
ATAATATACT	GAAACACCGGTTGTAAGCGATGGTTTGTGTGGTTAGAGCTAGAAAAAGCA	1	bc
CACTAGCACA	GAAACACCGGTTCTACTGGCGTATGTTGTGGGGTTAGAGCTAGAAATAGC	1	bc
GTGTTCGACA	GAAACACCGGTCGGGATAGTGCGACGGATAGCAAGGTAATAGAAGTCTAG	1	bc
AAATAGGCAC	GAAACACAGGTGTTCGTTGCTCGAGGGTGGGGGTAGAGCCAGAAATACCA	1	bc
CCCTGCCCCA	GAAACACCGGTTGTGGGGGACTCGAGCTAGAAGTAGCAACAAGATATCCT	1	bc
ATCTGGGCCA	GAAACACCGGTTGTGGGGGACTCGGTGTGGGAGTAATAGCAAGCTAAGCT	1	bc
GCAGTTAACA	GAAACACCGGTTGGCTTTACTCCTTTGTGGGGTTAGAGCTATAAATAGCA	1	bc
AAATTCTTCA	GAAACACCGGTCTAGTATGTAGGGCGAGGGGTTTAAAGCTGAAATTACCA	1	bc
TAACCAAATT	GAAACACCGGTCGTGAAAGCTAAATTGGGGGGGGGAGTAAGGCTAAGCAT	1	bc
TACTTATACC	GAAACACCGGTCGCGAAACTGTGCCGGTGGGGTTAGAGCTAGAAATAGCA	1	bc
TCGCCAACAC	GAAACACCGGTTGGCTTTAGTCCTTTGTGGGGTTAGAGCTATAAACAGCA	1	bc
ACTTGGCCCA	GAAACACCGGTTGAGGGGGAGTCTGTGGGGGAGATATAGCTAGTTAAAGT	1	bc
ACGTCAGCCG	GAAACACCGGTTTTAGTAAATGGTGAGTGGGGTTAGAGCTAGAAATAGCA	1	bc
AACCACCAAC	GAAACACCGGTGTTCTTTGCTCGCGGGTGGGGTTAGAGCTAGAAATAGCA	1	bc
AGCACATCAA	GAAACACCGGTGAGAACAGAACGTTTTGGGGTTAGAGCTAGAAATAGCAA	1	bc
ATTTAATCAA	GAAACACCGGTGTGAGGAGATTATGCGTGAGAAATAGCAAGTAACCTACG	1	bc
CGACCAATGA	GAAACACCGGTTTGGACTGGAGGGTTGTGGGGTTGAGCCTAAAAATACCA	1	bc
ATACAAGATT	GAAACACCGGTGCGCGCAGATTATGCGTGGGAAAAAGCAAGGAACTTAAA	1	bc
GAACGATATA	GAAACACCGGTCGTCGTTCGTAGGGGTGGGGTTATAGCTAGAAATAGCAA	1	bc
AGACCATCAA	GAAACACCGGTGGGAACCGAACGTTTTAGGGGTAGAGGTAGAAATAGGAA	1	bc
TTAATCCACT	GAAACACCGGTTTCCTTAGTTAACTAGTGGGGTTAGAGCTAGAAATAGCA	1	bc
GCGCCAACCG	GAAACACCGGTTATCGTTACGGATTTGTGGGGTTAGAGCTAGAAATAGCA	1	bc
TTATTCACAC	GAAACACCGGTCGCGTTAATGTGCCGGTGGGGATATTACTCTAAATAGCA	1	bc
GACTTAGTAC	GAAACACCGGTACTGGTTACTTACGGGTGGGGTTAGAGCTAGAAATAGCA	1	bc
ACGACAGGCT	GAAACACCGGTCCTAGAAGCTGAGTTAGAAGTGGGGTTATAGCTAGAAAT	1	bc
AACTCTGCAA	GAAACACCGGTACTAGTTACTTCCGGGTGGGGTTAGAGCTAGAAATAGCA	1	bc
CCGTCGAAAC	GAAACACCGGTTGGCCTTACTCCTTTGTGGGGTTAGAGCTATAAAAAGGA	1	bc
TCTGCAAATT	GAAACACCGGTCTTCCTGGAATCTACGTGGGGTAGAGCTAGTAATACCAA	1	bc
ATCAAAGTCG	GAAACACCGGTCCTAGGAGATTATGTGGGAGAGGGAGTAAGGAAAGAAAT	1	bc
GTGAATGTAA	GAAACACCAGTACTAGTTACTTACGGGTGGGGTTAGAGCTAGAAATAGCA	1	bc
CCACGCCGTT	GAAACACCTGTAGAGTGGGGATAGAGCTAGAAATAGCAAGTTAACCTACG	1	bc
AAACCACTCC	GAAACACCGGTTGTAAGCGATGGTTTGTGGGGTTAGAGCTAGAAATAGCA	1	bc
CCATCACAAC	GAAACACCGGTTGTCTTTACTCCTTTGTGGGGTTAGAGCTATAAATAGCA	1	bc
AGACGGGAAA	GAAACACCGGTGGTGTGGGATCGAGGGTGGGAGTAGAGCTAGAATAAGCA	1	bc
AAATCGCACC	GAAACACCGGTTGAGCAGGGGTTAAAGCGGGAAATAGCAAGTAAACATAA	1	bc
TGATTACAAA	GAAACACCGGTTCTACTGGCGTTAGAGTGGGAATTAGCAAGGAAACCGAA	1	bc
GCCACATACT	GAAACACCGGTGGCCGCCGGAGAGATGGGGGGTTTAGACTTAAAAATAAA	1	bc
ATAAAACGTC	GAAACACCGGTAACAGTTGCTTACGGGTGGGGTTAGAGCTAGAAGTAGCA	1	bc
TCATCAAACC	GAAACACCGGTGGGGTTAGAGCTAGAAATAGCAAGTTAACCTAAGGCTAG	1	bc
TCGCTAAAAT	GAAACACCGGTTGGCTTTACTCCTTTGTGGGGTTAGACCAATAATTACAA	1	bc
ATCTCGCACA	GAAACACCGGTTGAAAGCGATGGTTTTTGGGGGTAAAACTTAGAGTAACC	1	bc
TGAGCAGATA	GAAACACCGGTGTGCTTGGAATCTAAGTTGGCTAGAGCTCCAAATAGTAA	1	bc
TTCGACTCCA	GAAACACCGGTGCGGTTAGAGCTAGAAATAGCAAGTTAACCTAATGCTAG	1	bc
CGACCACAAA	GAAACACCGGTGTTCTTTGCTCGAGGGTGGGGTTAGAGCTAGAAATAGCA	1	bc
AAACCAAGCG	GAAACACCGGTTATCGTTACGGATTTGTGGGGTTAGAGCTAGAAATAGCA	1	bc
GTGTGCACGA	GAAACACCGGTTAGCGGCATGGAAATGGGGGGTTAGCGTTAGGATCATCA	1	bc
TAATCACTAA	GAAACACCGGTTTCAATTCTCTCTGAGTGGGGTTGAGCTAAGAAAAAGCA	1	bc
AGTAGGTCCT	GAAACACCGGTTGTGGGGAACTCGGAGGGGGGGAAATAGCAAGTTAACCT	1	bc
ATGACAGATG	GAAACACCGGTCCTAGAATCTGAGTTGGAAGTGGGGTTAGAGAAAGAAAT	1	bc
ATCAGCGGCG	GAAACACCGGTCCTAGAAGCTGAGTTAGCAGTGGGGTTAGAGCTAGAAAT	1	bc
ACACACCTAC	GAAACACCGGTGACGCGTGGGTTAGAGCTGGGTTTAAGAAGGAAACAGAA	1	bc
TCCGCCAACA	GAAACACAGGTGGGGTTAGAGCTAGAAATAGCAAGTTAACCTAAGGCTAG	1	bc
AGGCCGTAAC	GAAACACCGGTGTTCTTTGCTCGAGGGGGGGGTTAGAGCGAGAAATAGCA	1	bc
CCCTTCCCCC	GAAACACCGGTCGCGTAAATCCGCCGGTGGGGTTAGAGCTAGAAATAGCA	1	bc
CCCCGACGTT	GAAACACCGGTAGTGTCGGGTTCGAGCTAGGAATAGCACGTTAACCTACG	1	bc
ATGCCCGACT	GAAACACCGGTCCTAGAAGCTGAGTTAGAAGGGTGGAGATAGCTATAAAT	1	bc
GTATTATCCC	GAAACACCGGTTTTAGTAAATTGTGAGTGGGTTTAGAGCTAGAAATAGCA	1	bc
GAAACTCTCA	GAAACACCGGTGACGCGAGGGTTAGAGCTAGAAATAGCAAGTTAACCTAA	1	bc
AAGTTCACAA	GAAACACCGGTTGGGTTTACTCCTTTGTGGGGTTAGAGCTATAAATAGCA	1	bc
TCAGAAACGA	GAAACACCGGTGTGCGGAGATTATGCGAGAGAAATAGCACGTAACCTAAG	1	bc
GAATCCCCCT	GAAACACCGGTTTTGCGAGATTGTGAGTGGGGTTTGAGCTAGTAATAGCA	1	bc
TTATTCGCCG	GAAACACCGGTCGCGAAAATGTGCGGGTGGGGTTAGAGCTAGAAATAGCA	1	bc
GTTACAAAAA	GAAACACCGGTGAGCATGATAACGTCCGTGGGGTTAGAGCTAGAAATAGC	1	bc
AGCTACCCCC	GAAACACCGGTGCTATTTGCTGGAGTGGGGGTTTAGAGCGAGATAGAGCA	1	bc
CTCTGACCGG	GAAACACCGGTCGTCGTAGGCTATGCGTGGGAATAGGGCTAGAAACAACA	1	bc
AAGAGGGCCA	GAAACACCGGTTGTAGGGGCCTCGGTGGGGGTGGAATAGCAAGGTAACCT	1	bc
GTCATATCTC	GAAACACCGGTCGTCGTTCGTAGGGGGGGGGTTAGAGCTAGAAATAGCAA	1	bc
ACCACAGTCG	GAAACACCGGAGCTAGAAGCGGAGTGGGGGGGGTAGAACTAAGAATAGAA	1	bc
ATATCAATGA	GAAACACCGGTTTAGTGTGAGGGGGTGGAGGAAGTAACAGCAAGCTTACC	1	bc
CCCTCCCTGC	GAAACACCGGTTCAACCTGCGTTAGAGGTAGTAGTAGTAAGTTAACCTAA	1	bc
GTGGATGTAA	GAAACACCGGTACTATTCACTTACGGGGGGGGTTGGAGCTGGAAATAGCA	1	bc
CCGTCGAGCC	GAAACACCGGTTCAACCGGTGTTAGAGCTAGAAATAGCAAGTTAACCTAC	1	bc
GCATACGCAC	GAAACACCGGTTTTAGTAAATGGTGAGTGGGGTTAGAGCTAGAAATAGCA	1	bc
AGATTACAAA	GAAACACCGGTGCTCATAGTTCGCGCGTGGGGTTAGAGCTAGAAATAGCA	1	bc
AACTGGCACC	GAAACACCGGTTCAACCGGCGTTAGAGCTAGAAATAGCAAGTTAACCTAA	1	bc
ATTGGGGAGA	GAAACACCGGTTGGGGCAGAGCTAGTGATGGCGAGATAGCCTGATACTAG	1	bc
CCCTAGGCCC	GAAACACCGGTTCAACCGGCGTTAGAGCTAGAAATAGCAAGTTAACCTAA	1	bc
GAAAAAGATG	GAAACACCGGTGCCCTTGATAGGACCGTGGGGGTAGAGCTAGAAATAGCA	1	bc
AACCCCCTCA	GAAACACCGGTTTAGTATGGGTGGTTAGGGCTATAGATATCAAATTAGCC	1	bc
AATTGCCACA	GAAACACCGGTTGTGGGGGACTCGGGGTGGGGGTAATAGCAGGTTGACCT	1	bc
ACAAAACTGT	GAAACACCGGTGAGGGGAGATTATGCGTGAGAATAAGCAAGTAAACTAAG	1	bc
GATTCACGAG	GAAACACCGGTTATCGTTCCGGATTTGTGGGGTTAGAGCTAGAAATAGCA	1	bc
ATGCAGCTAC	GAAACACCGGTCCTCTAAGCTGGGGTAGGGGTGGGGTTAGAGCTAGACAT	1	bc
GGGTCAAACC	GAAACACCGGTGATCTTTACGCGTTTGTGGGGTTAGAGCTAGAAATAGCA	1	bc
TTACTATACA	GAAACACCGGTGTGCGGAGATTATGCGTGAGAAATATCAAGTAACCTAAG	1	bc
GACTAAGGAG	GAAACACCGGTTATCGTTACGGATTTGTGGGGTTAGAGCTAGAAATAGCA	1	bc
GCAACAATCT	GAAACACCGGTGACGCGAGGGATAGAGCTAGATATAGCACGGTAACCTAA	1	bc
CGGCGTGTTG	GAAACACCGGTTATCGTTCCGGATTTGTGGGGTTAGAGCTAGAAATAGCA	1	bc
ATGACAGACA	GAAACACCGGTCCTCAAAGCTGAGTTCGAGGGGGGGTTAGAACTAGTAAT	1	bc
TCCACAAGCA	GAAACACCGGTGGTCGTAGAGGAGAGGGTGGGGATAGAACTAAAAATAAG	1	bc
TGACAGTAAT	GAAACACCGGTTCCCGTTGGCTCGTAGTGGGGTTAGAGCTAGAAATAGCA	1	bc
AGGTAACGCG	GAAACACCGGTTATCGTTACTGATTTGTGGGGTTAGAGCTAGAAATAGAC	1	bc
GTGGGCGAGA	GAAACACCGGTGTGGTTAGATCGAGAAATAGCATGTTGATATAAGGCTCG	1	bc
AATGGGCCAC	GAAACACCGGTTGTTGGGAACTCGGTGTGGGAGAAATAGCAAGTTAACCT	1	bc
ATCCCCCCCT	GAAACACCGGTTGTAAGCGATGGTTTGTGGGGTTAGAGCTAGAAATAGCA	1	bc
AATTCCAAAA	GAAACACCGGTGGCAATTCTGTGTGAGTGGGGTTAGAGCTAGAAATAGCA	1	bc
TCACCAAACT	GAAACACCGGTTGGGTTAGAGGTCTAGATAGCAAAGTGACATAAAGATAA	1	bc
CGTCGGGATT	GAAACACCGGTCGTCCTGGGAGAGGTAGAAACAGTAAGTAAAACTATGGC	1	bc
GAAACAGATA	GAAACACCGGTGTACAATGTGGGGTTAGAGGTGGAAAAAGTAAGATAACC	1	bc
TCACCACACA	GAAACACCGGTGGGGTTAGAGCTAGAAATAGCAAGTTAACCTAAGGCTAG	1	bc
CCAGTAACAA	GAAACACCGGTGGGGTTAGAGCTAGAAATAGCAAGTTAACCTAAGGCTAG	1	bc
CGCTTAGCTT	GAAACACCGGTCGTCATAAAGTCTCCGTGGGGTTAAACTTAGAAATACAA	1	bc
AATTTTGTCC	GAAACACCGGCGCCCTTTATGGGACCGTGGTGTTGCAGGTCGGTATTGCA	1	bc
CAACGAGAAT	GAAACACCGGTTTAATCAGTTTCCTAGTGGGGTTAGAGCTAGAAATAGCA	1	bc
CCTCCACGAT	GAAACACCGGTAGAGCGGGGATAGACCTGGTAATAGCAAGTTAACCTAAG	1	bc
ACGGTAGAAA	GAAACACCGGTGAGATGTGCTCCTATGTGGGGTTATAGCTAGAAATAGCA	1	bc
CGGATACCCT	GAAACACCGGTTCGCGTTACTCCTTTGGGGGGTTAGAGGTAAAAATAGGA	1	bc
GGTTCAGCTT	GAAACACCGGTCTTACTGGAAGGGGTGGGGGTAGCGAGTTAAAATAAGGA	1	bc
CCCCTCAACC	GAAACACCGGCGGTGGTGGGTTAGAAGTAGGAATAGCCAGTTAAACTTAG	1	bc
GTATTCTATC	GAAACACCGGTCGCGACAATGTGCCGTTGGGGCTAGAACTAGAAATAGCA	1	bc
TAGTTAAACC	GAAACACCGGTTGGCTTTACTCCTTTTTGGGGTTAGAGCTATAAATAGCA	1	bc
TCTTCCTTCA	GAAACACCGGTGAGAACAGAACGTTTTGGGGTTAGAGCTAGAAATAGCAA	1	bc
CTTACCCTCG	GAAACACCGGTCCTAGAAGGTGATGTAGGAGTGGGGTTAGAGCAAGAAAT	1	bc
GACCTGCTAA	GAGACACCGGTATTAGATACTTACGGGTGGGGTTAGAGCTAGAAATAGCA	1	bc
ATCTGGCCAA	GAAACACCGGTTGTGGGGGACTCGGTGTGGGAGATATAGCAAGTTATCCT	1	bc
AACCTGCTAA	GTAAATTACGAAACACCGGTGTTCTTTGGTCGGGGGTGGGGTTAGAGCTA	1	bc
ATGAAGCAAG	GAAACACCGGTGGTCTTTGAGCTAGAATGGGGATAGAACTAGGAGTAGCG	1	bc
ACGTTACACC	GAAACACCGGTTGGCTTTGCTCCTTTGTGGGGTTAGAGCTATAAATAGCA	1	bc
AAAATGCTAA	GAAACACCGGTTTTGTATCATGGGTTGTGGGTGTAAAGCGAAAATTAGCT	1	bc
ATCTCCCCGC	GAAACCCCGGTGTGCGGAGATTATGCGTGAGAAATAGCAAGTACCCTAAG	1	bc
AAACGAGTTT	GAAACACCGGTGCTAGCGGGTTCGACTTAGGGGATAGAGCTAGAAATAGT	1	bc
GGCTATTAAA	GAAACACCGGTGCTAGCCACTCACTTGTGGGGTTAGAGCTAGAAATAGCA	1	bc
CCTTGGGCCA	GAAACACCGGTAGTGGGGAACTAGGGGTGGGAGTAATAGCAAGTTAACCT	1	bc
TTATTATCAA	GAAACACCGGTGGGGATAGTGCTAGAGTGGGCAAGTTAATCTAAGTCTAG	1	bc
CCAACCTCAA	GAAACACCGGTGAGAACAGGACGTTTTGGGGTTTTAGGAAGAAATTGCCA	1	bc
TCAGCAACCC	GAAACACCGGTGGGGTTAGAGCTAGAAATAGCAAGTTAACCTAAGGCTAG	1	bc
GCATCAGAAA	GAAACACCGGTACTAGTTACTTAAGGGGGGGGTTAGAGCTAGAAATAGCA	1	bc
CGTTCTTCCT	GAAACACCGGTGCGCACAGAACGTTTTGGGGTAGAGCTCTAGATAGAACA	1	bc
AAGACGCGCG	GAAACACCGGTTTTCGTTCCGGATTTGTGGGGTTAGAGCTAGAAATAGCA	1	bc
GAATCAGTAA	GAAACACCGGTTTTAGTAAGTGGTGAGTGGGGTGAGAGCTAGAAATAGCA	1	bc
AATTAAACGA	GAAACACCGGTTTACTTTGTGGGGTTAGTGCTAGAAATAGTAAGATAACC	1	bc
AAGACCCTCC	GAAACACCGGTCCTCGAAGCTGCGTTAGGGGTGGGGTTAGAGATAGAGAT	1	bc
GCGGTCGCGC	GTAACACCGGTTGGCTTTACTCCTTTGTGTGGTTAGCGCTATACATGGCA	1	bc
GCATATGGAA	GAAACACCGGTACTAGTTACTTACGAGTGGGTTTAGAGATAGAAATAGCA	1	bc
CATGCTGTAG	GAAACACCGGTGGCAATTCGATCGGAGTGGGGTTAAAGCTAGAAATAGCA	1	bc
AGATAATAAA	GAAACACCGGTGAGAACAGAACGTTTTGGGGGTAGAGCTAGGAATAGGAA	1	bc
AACCGCTCCC	GAAACACCGGTGACAAAAGTATGCCGGTGGGGTTAGAGCTAGAAATAGCA	1	bc
AGACACCGCC	GAAACACCGGTGTTATTTGCTCGGGGTTGGGGTTAGAAAGTGAAGTTGAA	1	bc
GATCCAGAGT	GAAACACCGGTCTTCCTGGTAGAGCTAGAAATAGCAAGTTAACCTAAGGC	1	bc
CTCTCCTACC	GAAACACCGGTCACGACAATGTGCCGGGGGGGTTAGAGCTAGAAATAGAA	1	bc
TTCATCTACT	GAAACACCGGTCGCGAAAGTGCGCAGGAGGGAGTAGAGCTAGGAAAAGCA	1	bc
TCATCCCACC	GAAACACCGGTGGCGATACGGTGTGAGTGGGGTTAGAGCTAGAAATAGCA	1	bc
AAATAGCAAA	GAAACACCGGTGCTCTTTGCTAGAGGGAGGGGTTAGAGGTAAAAATAGCA	1	bc
AACATGCAAT	GAAACACCGGTTTTCTTAGATAATTCGTGGGGTTAGAGATAGAAATAGAA	1	bc
AAATCACCAG	GAAACACCGGTTTTAGTAAATGGTGAGTGGGGTTAGAGCTAGAAATAGCA	1	bc
GACTCTGTCC	GAAACACCGGTACTAGTTACTTACGGGTGGGGTTAGAGCTAGAAATAGCG	1	bc
CTTTCAGTAA	GAAACACCGGTGAGAACAGAACGTTTTGGGGTTATAGCTATAAATATCAA	1	bc
ACGACAAACA	GAAACACCGGTCCTAGAAGATGAGGTAAAAGCAAGGTAAGAGCTAGATAG	1	bc
TAACTCACGA	GAAACACCGGTTTCGTATGTGGGGTGAGGGGTAGAAAGAGAGAGTTAGCA	1	bc
CGGCGAATCG	GAAACACCGGTTGTCGTTCCGGGTTTGAGGGGTTGGAGCTAGAAGTAGCA	1	bc
AATTGGGACT	GAAACACCGGTTGTGAGGGACTCGTTGTGGGGGAAATAGCAAGTAAACCT	1	bc
TGCTGCTCCG	GAAACACCGGTCTCGGAAATGTGCCGGTGGGTTAGAGATAGAAACAGAAC	1	bc
TCCGCTCACA	GAAACACCGGTGGGGTTTGCGCCAGAAATGGCAAGTTAACCTAAGGCTAG	1	bc
AGGACCGCCT	GAAACACCGGTTCAAGATGCTGAGTTAGAAGGGTGGTTAGAGCAAGAAAT	1	bc
AACAACATGA	GAAACACCGGTTTAGTATGTGGGGTTAGAGCTAGAAATCGCAATTTAACC	1	bc
ATGGGCGTGG	GAAACACCGGTCCTAGAAGCTGAGTTAGCAGGGGGGCTAGAGCTAGATAT	1	bc
AAACCAAAAA	GAAACACCGGTGGGGTAGGAGGGGTAAGAGCAAGATAAACCAAGGCTAGC	1	bc
AACTTAACGC	GAAACACCGGTGTGGATAGATAATGCGTGGGGAATAGCAAGTAACCGAAA	1	bc
AGACAGAAGA	GGAAACCCGGGGTTCGTAGGTCGAGGGTGGGGTTGGAGCTAGAAATAGCA	1	bc
AAACGCCTAA	GAAACACCGGTTTTGTATAATTGGGTGTGGGTGGAAAAGCAAGGTTACCT	1	bc
AAATTAATGA	GAAACACCGGTTTAGTTTGCGAGGTTGGAGCTAGAAATCGCAAATTAACC	1	bc
GTCTCATCCG	GAAACACCGGTTTTAGTAAATGGGGAGTGGGGTTGGAGTTGGAAATTGAA	1	bc
TTAACCCCAC	GAAACACCGGTTGCGATAGTGAGCCGGTGGGGTTAGAGCTAGAAATAGCA	1	bc
GCGACCTTTG	GAAACACCGGTCCTCGAAGCTGGGTTAGAGGTGAGGTTAGGGCTAGACAT	1	bc
TAAAGGGCCA	GAAACACCGGTTGTGGGAGACTCGGTGCGAGAAATATAGCAAGAAAATCT	1	bc
GGGTAGCGCG	GAACCCCGGGGTATCGTTCCGGATTTGTGGGGTTAGAGCTAGAAATAGAA	1	bc
CACTGGGTAA	GAGACACCGGTTGTGGTGAGCTCGGTGTGGGAGAAATAGAAAATTAACCT	1	bc
CCGCTCACCC	GAAACACCGGTTGGCTTTACTCCTTTGTGGGTTAGAGCTATAAATAGCAC	1	bc
TCATTCTCCA	GAAACACCGGTCGTGGAAATGTGCTGGTGGGGTTAGAGCTAGAAATAGCA	1	bc
GATTCAACCC	GAAACACCGGTTATCGTCACGGGTTTGTGGTGCTAGAGAGAGAAATCGCG	1	bc
CCTTGAGCAC	GAAACACCGGTTGGCTTTACTCCTTTGTGGGGGTAGAGCTATAAATAGCT	1	bc
GGAATGCAAC	GAAACACCGGTGATCTTTGCTAGAGGGTGGGGTTAGAGCTAGAAATAGCA	1	bc
GTATTCTCCA	GAAACACCGGTCGCGAAAATGTGCCGGTGGGGTTAGAGCTAGAAATAGCA	1	bc
TCCTTAACCC	GAAACACCGGTTGGCTTTACTCCTTTGTGGGGTTAGAGCTAGAAATAGCA	1	bc
CGCTGATCCC	GAAACACCGGTAAGAAGAATACATTTGTGGGGTTAGAGTAAGATAAAGCA	1	bc
CCAACAAAAT	GAAACACCGGTGGCGTTAAAGTTAAATAGCAAGTTAACCTAAGGCTAGCC	1	bc
TCCAGACGCC	GAAACACCGGTAGAGTTGGGCTAGAGCTAGAAATAGCAAGTTAACCTCAG	1	bc
AAGTCAATGA	GAAACACCGGTGTAGTATGTGTGTGTAGAGGTAGTAATAGCAAGTTAACC	1	bc
GGCGACGAAA	GAAACACCGGTACTCGTTACTTACGGGTTGGGTTATAGCTAGAAATAGCA	1	bc
CCGTAGAAAC	GAAACACCGGTTGGCTTTACTCCTTTGTGGGGTTAGAGCTATAAATAGCA	1	bc
ATGACCATGA	GAAACACCGGTTTTGGAAGGTGAGTTGGGGGGGGGGATAGAGATAGAGAT	1	bc
GAACCAGATT	GAAACACCGGTGTTCCTGGTAGAGCTAGAAATAGAAAGTTAACCTAAGGC	1	bc
TTATTCCTCT	GAAACACCGGTCTTGCTAGGGTTTACGTGGGGTATAGCTAGAAAAACCAA	1	bc
AATTTAGAAA	GAAACACCGGTTGTAAGGGATTGGGTGTGGGGTTAGAGCTAGAAATAGCA	1	bc
ATCTGCCCCC	GAAACACCGGTCGCGTGAGTTTGCGGGTGGGGCTAGCGCGAGAAACTGCA	1	bc
TTATTCTAAC	AGGGCCGAAACACCGGTTTCGATGCTGTAAGGGAGGGGTAGTGCTAGAAA	1	bc
CAAGCAAAGA	GAAACACCGGTGGGGTTAGAGCTGGAGTGGGGTTGGAGATAGAAGTAGCG	1	bc
ATAAACCACG	GAAACACCGGTGTTCTTTGCTCGAGGGGGGGGGTAGAGCTAGTAATAGCA	1	bc
TCCATCACCC	GAAACACCGGTCGCGAACGTGGGCTGGGGGGGATAGAGAGAGAAAGAGCA	1	bc
TAAGCAGAAG	GAAACACCGGTGTTCGTTGCTCGAGGGTGGGGTTAGAGCTAGAAATAGCA	1	bc
AAATAGCTAC	GAAACACCGGTACTATTTGCTCACGGGTGGGGTTAGAGCTAGAAATAGCA	1	bc
CAACCGATCC	GAAACACCGGTTTAACCTGCGGGAGTACTGGTAATAATAGCATGATCACA	1	bc
AGGAACCAAC	GAAACACCGGTGTTCTTTGCTCGAGGGTGGGGTTAGAGCTCGAGATAGCA	1	bc
ACCCTAGCAC	GAAACACCGGTTCACCCGGCGTTAGAGCTAGAAATAGCAAGGTAACATAA	1	bc
GAATCGGACC	GAAACACCGGTGTTCTTTGCTCGAGGGTGGGGTTAGAGCTAGAAATAGCA	1	bc
AAACTAAAGA	GAAACACCGGTTTAGAATGTGGGGTTAGAGGTAGAAATAGCAAGATAACC	1	bc
CATCATGCCC	GAAACACCGGTGGCCTTTATGGGCGCGTGGGGTTAGAGCTAGAAATAGCA	1	bc
GCCTCAGACG	GAAACACCGGTTCAACTCGCGTTAGAGCTAGAATAAGCAAGGAAACCGAA	1	bc
GATTCAGCAA	GAAACACCGGCTTTAATAAATGGTGAGTGGGGTTAGAGCTAGAAATAGCA	1	bc
TTCACCGCCC	GAAACACCGGTCGCGAAAGTGTGCCTTAGAGCTTGGAACTAGAAGTAGCA	1	bc
ATCTCATCCC	GAAACACCGGTCGCGAAAGTGTGCCGGTGGGGTTAGAGCTAGAAATAGCA	1	bc
CTCAATGTCA	GAAACACCGGTACTAGTTACTTACGGGTGGGGTTAGAGCTAGAAATAGCA	1	bc
ATCCAGCACC	GAAACACCGGTGTTCTTTGCTCGAGGGTGGGGTTAGAGCTAGAAGTAGCA	1	bc
AACCTATCTC	GAAACACCGGTGCCAGAGGTATAGCAGTGGGATTTGAGCTATAAACAGTA	1	bc
AGGACCGTAA	GAAACACCTGTCCTAGAAGCTGAGTTGGGGGTGGGGTTAGAGCTAGAAAG	1	bc
CATAATTCAG	GAACACCCGGTGCAATAGAAAAGAGCGAGTGAATAGAGCTATAATCCGAA	1	bc
CCGCGGAAAC	GAAACACCGGTGGTGGTAGGGCTAGCGTGGGGTTGTGACCAGAAAGAGCA	1	bc
AAAAATCCCA	GAAACACCGGTGACGCGTGGAGGGCGGTGGGGTTAGAGCTAGAAATAGCA	1	bc
GAATTCCTCT	GAAACACCGGTGATGCTAGTTAGCTAGTGGGATTAAGGCTGGAAATCGCA	1	bc
TGAGCAAACG	GAAACACCGGTGGGGTTAGAGCTAGAAATGGCAAGTTAACATAAAGCTAG	1	bc
CGAACACTCT	GAAACACCGGTGACGCGAGGGTTAGAGCTGGGAATAGCAAGGTAACCTAA	1	bc
ATGACAAGCG	GAAACACCGGTTATAGAAACGGAGTTGGGGGGGGAGAGAGAGAAATAGAA	1	bc
ATAAAAGTCG	GAAACACCGGTCCTAGAAGCTGGGTTGGGGGGGGGGTTATAGCTAGAACA	1	bc
TAAGTAATAC	GAAACACCGGTGGGGATAGTGCAAAAAATGGCAAGTGATACAAAGGCTAG	1	bc
AGACAAAAAA	GAAACACCGGTGCTAATAGCTCGAGGGTGGGGTTAGAGCTAGAAATAGCA	1	bc
GAACAAGAAG	GAAACACCGGTGTTCTTTGCTCGAGGGTGGGTTAGAGCTAGAAATAGCAA	1	bc
AGACCGCATT	GAAACACCGGTGTTCTTGGATCGAGCGTGGGGTTGAGCCTAAAAAAGGAA	1	bc
GACACGCACC	GAAACACCGGTAAGACAGGCGTTAGAGCGGGAAATAGCAAATTAACCTCA	1	bc
CGCTCTTCCA	GCAACACCGGTGAGCTCAGGATTTGTGGGGGTTTTAGCATGAAAATGCAA	1	bc
CACCGACGTT	GAAACACCGGTGGAGTGGGGTTAGAGCTAGAAATAGCAAGTTAACCTAAG	1	bc
AAGTCACACA	GAAACACCGGGGGCAAATCGCTCTGAATGGGGTTATAACTAGAAGTAGGA	1	bc
CCCTAGCAAA	GAAACACCGGTACAACCGGCGTTAGAGCTAGAAATAGCAAGGTAACCTAA	1	bc
AGACGGGCAA	GAAACACCTGTGTTCTTTGCTCGGGGGTGGGGGTAACACTAAAAATAGCA	1	bc
TGAACCCTAA	GAAACACCGGTGAGGAGAGAACGGTGTGGGGTTTGAGCCTGAAATAACAA	1	bc
AAATGAACCC	GAAACACCGGTTGAGAGAAGCAAGGTGTGGGAGAGATAGCGAGTTAGCAT	1	bc
ATGCCCTTCC	GAAACACCGGTCCTAGACGCTGGGTTAGAGGTGGGGTTAGAGCTAGAAAT	1	bc
CACACTTCTT	GAAACACCGGTTCCCGTTAGTTCGTAGTGGGGGTAGAGCTAGAAATAGCC	1	bc
GAAAAAGTCG	GAAACACCGGTTTTAGAAAATGGCGAGTGGGGTTAGAGCTAGAAATAGCA	1	bc
CATTTACTAC	GAAACACCGGTAGCAATGCAATGTGAGTGGGGGCAGATCTAGAAATAGCT	1	bc
AGACATGAAA	GAAACACCGGTGTTCGTTGTACACGGGAGGGGATAGAGATAGAAATAGCA	1	bc
TGCAAAGTTT	GAAACACCGGTCATCTAGGGATAGCCAGGAGTAGAAAGCTAAAATTAGCC	1	bc
AACCACTCCC	GACACACCGGTGGCAGCCAGCTGTCAGTGGGGTTAGAGCTAGAAATAGCA	1	bc
GGATAGCAAA	GAAACACCGGTGTTCTTTGCTCGAGGGTGGGGTTAGAGCTAGAAATAGCA	1	bc
TTTTCGGATT	GAAACACCGGTGTAACTGGCGTTAGCGCTAGAAATAGCTAGTAAACGCAA	1	bc
GACTACTCCC	GAAACACCGGTTTTGGAAAATGGCGGGTGGGGTTAGAGCTAGAAATAGCA	1	bc
CGTTCAACGC	GAAACACCGGTTGGCTTTGCACCTTTGTGGGGTTGAGGCAGTAATAAGAA	1	bc
CATCCCCTAA	GAAACACCGGTTTAGTATGTGGGGTTAGAGCTAGAAATATCAAATTAACC	1	bc
AGCCACCTCC	GAAACACCGGTGTTCTTTGCTCGCGGGTGGGGTTAGAGCTAGAAATAGCA	1	bc
AATACAGATG	GAAACACCGGTGCCCTTTATGGGACCGTGGGGTTAGAGCTAGAAATCGCA	1	bc
TCAGCCGAAG	GAAACACCGTTCCTAGTAGATCTATAAGTAGCGGGTTAACCTAAAGATAG	1	bc
TGATAACTCC	GAAACTCCGGTGGTGATAGTCCGAGGGTGGGGTTAGAGTTAGAATTAGCA	1	bc
TAGGAAAAAC	GAAACACCGGTGGGGTTAGAGCTAGAAATAGCAAGTTAACCTAAGGCTAG	1	bc
AGGCCGCAAA	GAAACACCGGTGTTCTTTGCTCGAGGGTGGGGTTAGAGCTAGAAATAGCA	1	bc
GACTGTGAAT	GAAACACCGGTACTAGTTACTTACGGGGGGGGTTAGAGCTAGAAATAGCA	1	bc
GATTGTGCAC	GAAACACCGGTACTAGTTACCTACGGGTGGGGGTAGAGCTAGGAATAGCT	1	bc
AAATAATCTA	GAAACACCGGTTGTCGGTCGTTGGGGGGGGGATAGATCTAGAAATAACAA	1	bc
TAATCCTCCC	GAAACACCGGTCGCGGTAATGTTCCAGTGGGGTTAGAGCTAGAAATAGCA	1	bc
TTATCAATCC	GGAACACCGGTTGAGAGAGTTGGTTTGTGGGGTTAGAGTTAGAAAAGGCA	1	bc
AGATATGTAC	GAAACACCGGTGCTCGTTGCTTGCGGGTGGGGTTAGAGCTAGAAATAGCA	1	bc
AACATGCTAG	GAAACACCGGTTTTCGATCATAGGTGGGGGGAGTAGAGCTAGTAATAGGA	1	bc
AATACAGAAG	GAAACACCGGTGCCCTTTATGGGACCGTGGGGTTAGAGCTAGAAATAGCA	1	bc
TAACCACTCC	GAAACACCGGTGACGCGAGGGTTAGAGCTAGAAATAGCAAGTTAACCTAA	1	bc
GCCATATATC	GAAACACCTGTCGTCGTTCGTAGGGGTGGGGTTATAGCTAGAAATAGCAA	1	bc
TTCTTACCGC	GAAACACCGGTGCGCTGAGATTATGCGTGAGATATAGCAAGTAACCTAAG	1	bc
CCTACCGCCG	GAAACACCGGTGCCCTTTATGGGGCCGTGGGGTTAGAGCTAGAAATAGCA	1	bc
ACCAACGTCG	GAAACACCGGTCCTAGAAGCTGAGTTAGTCGAGGGGTTAGAGCTAGAAAC	1	bc
AAGCATGTCG	GAAACACCGGTGCTCTTTATGGGACCGTGGGGTTAGAGATAGAAATAGAA	1	bc
ATGAACCCCG	GAAACACCGGTGTGCTTAGATTATGCGTGAGAAATAGCAAGTAACCTAAG	1	bc
TTCTTATAAA	GAAACACCGGTCGCAACACTATGTCAGTGGGGTTAGAGCTAGAAATAGCA	1	bc
GATTGCGAGA	GAAACACCGGTGGCGATTCGATCTGAGTGGGGTTAGAGCTATAAGTATCA	1	bc
GCATAAACAC	GAAACACCGGTTGGCTTTACTCCTTTGTGGGGTTAGAGCTATAAATAGCA	1	bc
GAAAAAGAAA	GAAACACCGGTGATAGTTACTTAGGGGTGGGGGTAGAGCTAGAAAAAGCA	1	bc
AAACCGCTGG	GAAACACCGGTTTAGGATGTTAGGGTAAGGCTGGAATTAGCAAGTTGACC	1	bc
GCCTATGCAC	GAAACACCGGTACTAGTTACTTACGGGAGGGGTTAGAGCTAGAAATAGCA	1	bc
CTACCATACA	GAAACACCGGTGAGAACAGAACGTTTTTGGGTTCAGAGCTGGAAATACCA	1	bc
AGGACAGTAG	GAAACACCGGTCCTAGAAGCAGAGTTAGAAGTTGGGGTAGAGCTAGGCAT	1	bc
AAACAATAAC	GAAACACCGGTTTAGTATGTGGGGGTAGGGCTATAAATAGCAAGTTAACA	1	bc
TCGGTCATAA	GAAACACCGGTGAGAACAGAACGTTTTGGGGTTAGAGCTAGAAATAGCAA	1	bc
AAGTCAATAG	GAAACACCGGTTATCGATGCGGATTTGTGGGGTTAGAGCTAGAAATAGCA	1	bc
ATGCCACAAC	GAAACACCGGTTGTAAGCGCTGGTTTGTGGGGTTAGAGCTAGAAATAGCA	1	bc
AAGAAGCCAC	GAAACACCGGTTTTCTATACTCCTTTGTGGGGTTAGAGCTAGAAATAGCA	1	bc
CCTTCACCAC	GAAACACCGGTGGGCTTTCGATCTGAGTGGGGTTAGAGCTATAAATAGCA	1	bc
TCCTCTGAAA	GAAACACCGGTGGTAGTTACTTACGGGTGGGGTTAGAAATATAAATAGCA	1	bc
GGGTCAACAG	GAAACACCGGTTAGCGTTACGGCTTTGTGGGGTTAGAGCTAGAAATAGCA	1	bc
AGAAAACATC	GAAACACCGGTGTGCTTGGCTAGAGGGAGGGATTAGAGCTTAACCTAGCA	1	bc
AAGAAAAGCG	GAAACACCGGTTATCGTTACGGGTTTGTGGGGTTAGAGCTAGAAATAGCA	1	bc
TCGTTACTCC	GAAACACCGGTTACGCGAGGACGGTGGTGGGGTTAGAGCTAGAAATAGCA	1	bc
TCTTACTCAC	GAAACACCTGTTGTGGGGATCTCGGTGTGGGGGTAGTAGCAGGTTCACCT	1	bc
GGCTCTTCAT	GAAACACCGGTCCTCGTTAGTTCGTGGTGGGGTTAGAGCTAGAAATAGCA	1	bc
TGCCCCGACT	GAAACACCGGTCTCCCCCGTAGACCTAGATATAGAAAGCTAACCTAAGGC	1	bc
GCGTATGCAC	GAAACACCGGTACTATTTACTTACGGGTGGGGTTAGAGCTAGAAATAGCA	1	bc
CGGACAGTTG	GAAACACCGGTCATGGATGCTGAGTTCGAATTGGGGATCGAGCTAGAAAT	1	bc
AATATTTCCC	GAAACACCGGTCGCGATAATGTGCCGGTGGGGTTAGAGCTAGAAATAGCA	1	bc
CCACGACGAC	GAAACACCGGTAGAGTGGGGGTAGAGCTAGGCATAGCAAGTTAACCTAAG	1	bc
TGAACAACAT	GAAACACCGGTTGGGGTTAGGTAGTAGTGGGGTTAGAGATGGAAATAGAA	1	bc
GAGTTAACCC	GAAACACCGGTTGGCTTTACTCCTTTGTGGGGTTAGAGCTATAAATAGCA	1	bc
TAAACAGAAG	GAAACACCGGTTTACTTAGTTGGAGAGTGGGGTTAGAGCTAGAAATAGCA	1	bc
AAATCGGCAG	GAAACACCGGTTTTAGTAAATGGTGAGTGGGGTTAGAGCTAGAAATAGCA	1	bc
AACCTGCTAG	GAAACACCGGTATTGTGTGATTAGAGGTAGGAATAGCAAGAGAACCTAAG	1	bc
ATACAACAAA	GAAACACCGGTGTGCTTAGATCGAGGGTGAGGAAAAAGATAGAAATAAAG	1	bc
CCCCGGGACC	GAAACACCGGTAGAGTGGGGGTAGAGGTAGGAATAGGAAGTAAATATAAG	1	bc
CGTGCAAAAA	GAAACACCGGTGGGAATAGAACGTGATGGGGCAAGTTATACGAAGGATAA	1	bc
GCATCGCCCC	GAAACACCGGTTCAACCGGCGTTAGAGCTATAATTAGCAAGTTAACCTAA	1	bc
GACACCGACC	GAAACGCCGGTACAACAGGCGTTAGAGCTAGAAATAGCATGTTAATATCA	1	bc
CGCTCAGCCA	GAAACACCGGTGAGAGCAGCACGTTTTGGGGTTAGAGCTAGAAATAGCAA	1	bc
GAATTGCACA	GAAACACCGGTGCAACTAGCTAGCGCGTGGGGTTAGAAATAGAAATTGAA	1	bc
CCCCCGCATA	GAAACACCGGTTCAAACGGTGCTAGAGCTAGGAATAGCAAGATAAACTAA	1	bc
ATGAACCACG	GAAACACCGGTCCTAGAAGCTGAGTTAGAAGTGGGGTTAGAGCTAGAACT	1	bc
TGATTAATCC	GAAACACCGGTGAGAATAGTCAGTTTTGGGGTTAGAGCTAGAAATAGCAA	1	bc
GAATAGAACA	GAAACACCGGTGCAAATAGTGAGAGCGCGAGGTTAGGGAAAGTAATCGAA	1	bc
TACTAAGTAC	GAAACACCGGTACTGGTTACCTACAGGTGGGGTAGAGCTAGAAAAAGCAA	1	bc
GACTTCCCCC	GAAACACCGGTCATCTAAAGGTCCCGGTGGGGATAGAGCTAGAAATAGCA	1	bc
CAACGACAAA	GAAACACCGGTGGCAACTCGTTCTGAGTGGGGTTAGAGCTAGAAATAGCA	1	bc
AGAAAATAAA	GAAACACCGGTGGTCGTTCGTAGGGGTGGGGGTAGAGCTAGTAATAGCAA	1	bc
CCGCTAAATC	GAAACACCGGTTGGCTTTGCTCCTTTGTGGGGTTAGAGCTATAAATAGCA	1	bc
TCAACACACA	GAAACACCGGTGAGCAGAATAATATAGATGGAGATAGCACGTGAACCAGA	1	bc
TCTTGGGTCA	GAAACACCGGTTGTGGGGAACTCGGTGTGGTAGAAATAGCAAGTTAACCT	1	bc
TACTATTTAT	GAAACACCGGTTCTAGTTACTTACGGGTGGGGTTAGAGCTAGAAATAGCA	1	bc
TGTTCAGAAA	GAAACACCGGTCTTCATGGTAGAGCTAGGGGTTGCAAGTTAAACTAACAC	1	bc
TCAACCTTTA	GAAACACCGGTGAGGAGAGGGATAGAGATATAAACAGAAGGTTAACCTAA	1	bc
TCTCCACCCA	GAAACACCGGTTTACTTAGATAACTAGTGGGGTTAGAGCTAGAAATAGCA	1	bc
CCCTAGAACA	GAAACACCGGTTCAACCGGCGTTAGAGCTAGAAATAGCAAGTTAACCTAA	1	bc
AAATCGCACA	GAAACACCGGTTCAACCGGCGTTAAAGCGAGAAATAGCAAGGTAACCTAA	1	bc
AGAAAGCTCT	GAAACACCGGTGTTCTTTGCTCGAGGGCGGGGTTAGAGCTAGAAATAGCA	1	bc
CAACCCCGCC	GAAACACCGGTAGAGTGGGGTTAGAGCTAGAAATAGCAAGTTAACCTAAG	1	bc
AACTCGCAAC	GAAACACCGGTTCAACCGGCGTTAGAGCTGGAGATAGAGAGAGAACCTAA	1	bc
GTCTTAGCCG	GAAACACCGGTTTTAGGAAATTGTGAGTGGGGTTAGAGATAGAAATAGCA	1	bc
ACTCCCTCTC	GAAACACCGGTGACAAACGTATGTCAGTGGGGTTAGAGCTAGAAATAGCA	1	bc
TCCTCAAACC	GAAACACCGGTTGAGATAGAGTTAGAGCTAGAAAGAGCAAGTCAAGCTAG	1	bc
GAACCAAAAG	GAAACACCGGTTATCGTTACGGATTTGTGGGGTTAGAGCTAGAAATAGCA	1	bc
TACTAAACGA	GAAACACCGGTGGGGGTAGTAAAAAAGTGGGTTAGAGCTAGAAATAGCAA	1	bc
CTACCACAAA	GAAACACCGGTGAGAAGAGAACGTTTTGGGGGTAGAGCTAGAAATAGCAA	1	bc
AATCCAATAA	GAAACACCGGTTTAGTATGTGTGGGTGGGGGTGGAAATAGCAAGTTACCT	1	bc
GTGGGCGAGA	GAAACACCGGTGAGATGGAAATAGCAAGTTAACCTAAGGCTAGTCCGTTA	1	bc
CAAAGCGACT	GAAACACCGGTGCCGGCAGGGTTAGAGTTGGGTTAGAGATAGAAATCGAA	1	bc
AGCCCGCAAT	GCAACACCGGTGTTCTTTGCTCGAGGGTGGGGTTAGAGCTAGACATAGCA	1	bc
AATAGGCCCA	GACACACCGGTAGTGGGGAACTCGCTGTGGGAGAAATAGCAAGTTAACCT	1	bc
TTATCCTAAC	GAAACACCGGTGGGGATAGAGCGAGAGATGGGGAAGAAATATAAGGATAA	1	bc
CCGGGAAAAC	GAAACACCGGTGGGGGTAGAGGGGGAAATAGCAAGTAAAAGTAAGGTAAG	1	bc
CCGCCGCATC	GAAACACCGGTTCAGCTGGCGCTAGAGCTAGAAATAGCAAGTTAACCTAA	1	bc
CGACCACCAA	GAAACACCGGTGTGCTTTGCTCGAGGGAGGGGTTAGAGCTCGAAATAGCA	1	bc
ATCTAGCAAC	CAAAACACCGGTGTTCTTTGCTCGAGGGTGGGGTTTGGGCTAGAACTAGC	1	bc
ATAACCCACG	GAAACACCGGTGCTGTTAGAGCTAGTAGTAGGGTGGTAAGAGAAAGATAT	1	bc
CACTCTGAAA	GAAACACCGGTACTAGTTCCTTATTGGTGGGGTTAGAGCTAGAAATAGCC	1	bc
ATGAAGGTAG	GAAACACCGGTCCTAGAAGCTGAGTTAGAAGTGGGGATAGAGCAAGAAAT	1	bc
AGCAAATGGC	GAAAAACCGGTACTCGTCGTGGACGTGGTGGGGTAAGGTTAGGAAAAGGA	1	bc
GGATAGGAAC	GAAACACCGGTGTTCTTTGCTCGAGGGTGGGGTTAGAGCTAGAAATAGCA	1	bc
ATTTATCCCG	GAAACACCGGTGTTCTTTGTTTGACCGTGGGGTTTGAGCTAGAAATAGCA	1	bc
ATCCAGCAAA	GAAACACCGGTGTTCTTTGCTCGTGGGTGGGGATTAGCAAGGAACCAGAG	1	bc
AGTCAGCCAG	GAAACACCGGTGCCCTTTGTGGGACCGTGGGGTTAGAGCTAGAAATAGCA	1	bc
GATCCTGTTT	GAAACACCGGTATTACTGGTATACCTAGAAGGAGAGAGCTAACCTAAGGA	1	bc
GAGTCCGCGG	GAAACACCGGTTTTAGTAAATGGTGATTGGGGTTAGAGCTAGAAATAGCA	1	bc
CAACCCAGAG	GAAACACCGGTTATGTTTGCGGATTTGTGGGGTTAGAGCTAGAAATAGCA	1	bc
ACTCCGTCCC	GAAACACCGGTGCAACACGTACGTCTGGGGGGTTCAGAGTTAGAATAGGC	1	bc
AGACACGAGA	GAAACACCGGTGTGCCTTGCTCTATGGTGAGGTTAGAGCTAGAAATCGCG	1	bc
CCGACGGTTG	GAAACACCGGTCGTAGAAGCTGAGTTAGGAGTGTGGTAAGGGCTAGTAAC	1	bc
TCGACCAAAT	GAAACACCGGTTTACTTAGTTCCCTAGTGGGGTTAGAGCTAGAAATAGCA	1	bc
ACCTGCCGAC	GAAACACCGGTAGAGTGGGGTTAGAGCTAGAAATAGCAAGTTAACCTAAG	1	bc
GAATCAACAC	GAAACACCGGTTTTGGTAATTGGTGAGTGGGGTTAGAGCTGAAACTAGCA	1	bc
GAGTCGGGAG	GAAACACCGGTTCTCGTTACTTATTTTTGGGGTTAGAGCTAGAAATAGCA	1	bc
GACCACCTGA	GAAACACCGGTACTAGTTACTTACGGGTGGGGTTAGAGCTAGAAATAGCA	1	bc
CTGCCAGACT	GAAACACCGGTTGTAAGAGAGCGATTATGGGGGTATAACCATAAAGCGAG	1	bc
TCCCGACGTT	GAAACACCGGTATAGTGGGGTTAGAGCTAGAAATAGCAAGGTAACCTAAG	1	bc
TACCGCAGCC	GAAACACCGGTAGAGTTGGGTTAGAGCTGGAAATAGAAAGTTAACATAAG	1	bc
GACTCAGTCA	GAAACACCGGTACTGGTTACTTACGGGTGGGGTTAGAGCTAGAAATCTCA	1	bc
ACACTCGCAC	GAAACACCGGTTCAACCGGCTTTCGAGCTAGAAATAGCCAGTTAACCTAA	1	bc
GCATCAACAG	GAAACACCGGTTTTAGTAAATGGTGAGTGGGGTTAGAGCTAGAAATCGCA	1	bc
ACGTTACAAC	GAAACACCGGTTGGCTTTGCTCCTTTGTGGGGTTAGAGCTATAAATAGCA	1	bc
ACTCCGTACC	GAAACACCGGTGACAAACGTATGTCAGGGGGGGTAGCACTAGAAATAACA	1	bc
GCATAAGGCG	GAAACACCGGTTGTCGCCGAGGGGGGGGTGGGGTTAGAGCTAGAAATAGA	1	bc
GATACAGTCG	GAAACACCGGTCATCTTGGGAGAGCTGGGAGTATCAAGCTAGCCATAGGC	1	bc
AGATCATCCA	GAAACACCGGTGAGAAGAGAACGTTTTGGGGGTAGAGCTAGAAATAGCAA	1	bc
AATACCACGC	GAAACACCGGTTGTAAGCGATGGTTTGTGGGGTTAGAGCTAGAAATAGCA	1	bc
TAACCAACAA	GAAACACCGGTGGGGTTAGAGCTAGAAATAGCAAGTTAACCTAAGGCTAG	1	bc
AAAACGAAAG	GAAACACCGGTTGTCGGCGATGGTTCGTGGGGTTAGAGCTAGAAGTAGCA	1	bc
CAGTTAGCAA	GAAACACCGGTTGGATTTACTCCTTTGTGGGGTTAGAGCTATAAATAGCA	1	bc
ATCTATGCAA	GAAACACCGGTGCGCGGTGCTTATGCGTGGGGTATGGCCTGGAACCTGAG	1	bc
TCCGAACAAA	GAAACACCGGTGGGGTTAGAGCTAGAAATGGCAAGTTAACCTAAGGATAG	1	bc
TGATCACAAG	GAAACACCGGTGGTCTTTCCTCGTGGGTGGGGTTAGAGCTAGAAATAGCA	1	bc
ATATCCGTCC	GAAACACCGGTCTCGAATACATGCCGGTGGGGTTAGAGCTAGAAATAGCA	1	bc
AAGTTCACAT	GAAACACCGGTTGGCTTTACTCCTTTGTGGGGTTAGAGCTATACATCGCA	1	bc
AGCTAATCAA	GAAACACCGGTGAGCGGAGATAATGCGTGAGAACTAGTTAGCAACCTACG	1	bc
TCGTTAAACA	GAAACACCGGTGGGGTTAGCGCTAGAGAGAGCTAAGTACTCTAAGTCTAA	1	bc
AACAAACCCG	GAAACACCGGTACTAGATACTTACGGGTGGGGTTAGAGCTAGAAATAGCA	1	bc
AAAACCATCT	GAAACACCGGTTCCCTTTCTGGGACCGTTGGGTTAGAGCTAGCAATAGCA	1	bc
AAACATGTAA	GAAACACCGGTTTTGGTTATGTGGGTAGGGCTATAAATAGCGAGATAGCC	1	bc
GGACAACAAT	GAAACACCGGTGTTCTTTGCTCGAGGGTGGGGTTAGAGCTAGAAATAGCA	1	bc
AGTCGGGCAT	GAAACACCGGTTGTGGGGGAATCGGCGTGGGAGAAATAGCGAGTTAACAT	1	bc
GACTAGGAAC	GAAACACCGGTACTAGTGGCGTTAGAGCTGGGATTAGCAAGGTAATAGAA	1	bc
AAAACCATCT	GAAACACCGGTTACGCGAGGCTTAGAGCTAGAAAAATCAAATTAACCTAA	1	bc
GACCCTGTGA	GAAACACCGGTACTGGCTGCTTACGGGTGGGGTTAGGGCTAGAAATAGCA	1	bc
CACCCTGCAA	GAAACACCGGTACCAATTACTTATGAGTGGGGTTAGAGCTAGAAATAGCA	1	bc
ACGTCAACCC	GAAACACCGGTTGGCTTTACTCCTTTGTGGGGTTAGAGCTATAAATAGCA	1	bc
TCAGCAGCCA	GACACACCGGTGGGTTTAGCGCTAGAAATAGCACGTTAACCTCCGGCTAG	1	bc
GAGTAAATCA	GAAACACCGGTTATATTAACGGATTGGTGTGGATAGAGCAATAAATAGCA	1	bc
ACCTCGCAGA	GAAACACCGGTGTAGCAGGAGTAGGAGTGGGAAATAGCGAGTAAACTTAA	1	bc
AGCCAGAAAT	GAAACACCGGTGGTCGCCGTGGAGAGGTGGGGTTTAGAGCTAGAAATAAC	1	bc
TCCTCGTACT	GCTGAAATGACGAAACACCGGTTCCAGTTGGCTAGTAGCGGGGTTAGAGC	1	bc
AGTCAGCCAA	GAAACACCGGTGTTCTTTGATTGAGGGTGGGATTAGAGCTAGAACTAGCA	1	bc
TCCAATGTCT	GAAACACCGGTACTAGTTACTTACGGGTGGGGTTAGAGCTAGAAATAGCA	1	bc
CGCCACCACC	GAAACACCGGGGTTCTTTACCCGGGAGTGGGGTTATAGCTTGAAATAGCA	1	bc
CTGCACTCAC	GAAACACCGGTGGGGTTAGAGCTAGAAATAGGATGTTAACATAAGGATAG	1	bc
TCAGCAATCC	GAAACACCGGTTGGGTTAGTCCTAGAGATGGCAAGATCACCTAATGCTAA	1	bc
AACTAGCCCA	GAAACACCGGTTTGCGGAGATTATGCGTGAGAAATAGCAAGTAACCTGAG	1	bc
ACACAACGCA	GAAACACCGGTAGAGTGGGATTAGAGGTGGGAATAGCAAGATAACCTAAG	1	bc
ACAACTCAAA	GAAACACCGGTGGGCTTTGCGCGAGCGATGGCATATAGCCACAAGTATCG	1	bc
CCGGTAAAAA	GAGACACCGGTGGGGTTAGAGCTATAAATAGCAAGTTAACCTAAGGCTAG	1	bc
CGGCAGCCAC	GAGACACCGGTGTTCCTTGCTCTAGGGTGGGGTTAGAGCTAGAAATAGCA	1	bc
AGCCAGCTAA	GAAACACCGGTGTTATTTGCTCGAGGGTGGGGTTAGAGCTAGAAATAGCA	1	bc
TTCTCAAGCG	GAAACACCGGTTGTCGTTATGGGTTGGTGGGGTTAGAGCTAGAAATAGCA	1	bc
AAACAACACC	GAAACACCGGTGTTATTTGCTGGAGGGTGGGGTTAGAGCTAGAAATAGCA	1	bc
AACAGGGCCA	GAAACACCGGTTGTGGGGAACTCGGTGAGGGGGAAATAGCAAGTTAACCT	1	bc
ACTCCAAAAC	GAAACACCGGTGACAAACGTATGTCAGTGGGGTTAGAGCTAGAAATAGCA	1	bc
CCCTCGATGC	GAAACACCGGTTTAACCGGCGTTAGAGATAGAAATAGCAAGTTAACCTAA	1	bc
ATTTGGGCCT	GAAACACCGGTTGTGAGGAAGTGGTTGTGGGGGTAGAGCTAGAAATAGCA	1	bc
GAGTTAGCAA	GAAACACCGGTTGGCTTTACCTCTTTGTGGGGGTAGAGCTATAAATAGCA	1	bc
CCCCCACACT	GAAACACCGGTTGAACGCGCTGGTTTGTGGGGTTAGAGCTTGAAATAGCA	1	bc
AGTAACGACG	GAAACACCGGTCGTAGAAGCTGAGTTAGAAGGGTAGAGATAGCAATAAAT	1	bc
CCCTGACCAA	GAAACACCGGTAGAGGGAGGTTATAGCTAGAAATAGCAAGTTAACCTAAG	1	bc
GACTCCGCCT	GAAACACCGGTAATCGAAAATGGTGCGTGGGGTTAGAGCTAGAAATAGCA	1	bc
AGGTTATCAT	GAAACACCGGTTGGCGTTACCCCGTTGTGGGGTTAGAGCTAGAAATAGCA	1	bc
ACACTAAAAC	GAAACACCGGTGTGCCTTGCTCGAGGGTGGGGTTAGAGCTAGAAATAGCA	1	bc
ACAATCCTCG	GAAACACCGGTGATGCGAGGGTTAGAGCTGGGAATAGGAAGGTAATATAA	1	bc
TAAACCTCCC	GAAACACCGGTCGCGAGAGTGTGCCGGTGGGGTTAGGGCTAGAAATAGCA	1	bc
GGTTAATTAA	GAAACACCGGTACTAACTACTTATGTTGGGGGTTAGAGTTAGAATTACCA	1	bc
TTAATTTTAC	GAAACACCGGTCGTGAAAATGAGGTGGTGGGGTTAGAGCTAGAAATAGCA	1	bc
GTCTACGCCC	GAAACACCGGTCGCGAAAATGTGCCGGTGGGGTTAGAGCTAGAAATAGCA	1	bc
AATACTCAAG	GAAACACCGGTGCCCTTTATGGGCCCGTGGGGTTAGAGCTAGAAATAGCA	1	bc
AAGTTATCAC	GAAACACCGGTTGCCTTCGCTCCTTTGTGGGGTTAGAGCTATAAATAGCA	1	bc
GCAGCCAACA	GAAACACCGGTGGGGTTAGAGCTAGAAATAGCAAGTTAACCTAAGGCTAG	1	bc
ATATAACAAA	GAAACACCGGTGTGCGGAGATTATGCGTGGGAATTAGCCAGTAACCTAAA	1	bc
CCTTATCAAC	GAAACACCGGTGAGAACAGAACGTTTTGGGGTTAGAGCTAGAAATAGCAA	1	bc
AACATCTCAA	GAAACACCGGTCGCGAAAATGAGGGGGTGGGGGTAGAGCTATAAATAGCA	1	bc
TGTTCATCCT	GAAACACCGGTGTGAACAGAACGTTTTGGGGTTAGAGCTAGATATAGCAA	1	bc
CCGGGGCACC	GAAACACCGGTTCAACCGGCGTTAAAGCTAGTAATAGCAAGTTAACCTAC	1	bc
TTCTTCGAAC	GAAACACCGGTCGCGAAAATGAGTCGGTGGGGTTAGAGCTATAAACAGCA	1	bc
GGACAAAAAC	GAAACACCGGTGTTCTTTGCTCGAGGGTGGGGTTAGAGCTAGAAATAGCA	1	bc
GAATGAAATT	GAAACACCGGTGCTAGTAGTTAGCTAGTGGGGTTAGAGCTAGAAATAGCA	1	bc
GCAGCAACAG	GAAACACCGGTGGGGTTAGAGGTAGAAATAGCAAAGTAATCTAAGGCTAG	1	bc
AGATAAAGAG	GAAACACCGGTTTTCGTTACTGGAGTGTGGGGTTAGAGCTAGAAATAGCA	1	bc
CGCCGCCTTC	GAAACACCGGTAGAGAGGGGTTAGAGCTAGAAATAGCAAGTTAACCTAAG	1	bc
TTAGTATCCT	GAAACACCGGTCGCGAGAGTGTGAGGGTGAGAATAGAGAAGGAAATCGAA	1	bc
GCAACCAGCG	GAAACACCGGTGACGCTAGCGGTAAAGCTAAAAAGAGCAAATAAACCTAA	1	bc
CTGTTCGCAC	GAAACACCGGTCCTCGATACTGCTTTGGGGGGGGAGATCGATCTAGAGCA	1	bc
GACACTGTCA	GAAACACCGGTACTAGTTACTTACGGGTGGGGTTAGAGCTAGAAATAGCA	1	bc
GTGTATGTAG	GAAACACCGGTACTAGTTACTTACGGGTGGGGTTAGAGCTAGAAATAGCA	1	bc
TCCGTTCACA	GAAACACCGGTTGGATTTACTCCTTTGTGGGGTTAGAGCTATAAATAGCA	1	bc
TCAGCCGCCA	GAAACACCGGTGGGGTTAGCGCTAGCACTGGCCAGTTGCCATAAGGCTAG	1	bc
TCGCTAGAAC	GAAACACCGGTTTGCTTGACTCCTTTGGGGGGGTAGAGCTATAAGCAGGA	1	bc
CACCAGCGAC	GAAACACCGGTAGTGTTTGCTTAAAGGTAGAAATAGAGCGATAACTATAA	1	bc
GAACCGGCCC	GAAACACCGGTTTCAGTAGATGGTGAGTGGGGTTAGAGCTAGAAATAGCA	1	bc
CCATCCCACT	GAAACACCGGTGAAACGAGGGTTAGAGCTAGAAATAGCAAGATAACCTAA	1	bc
CGATCAAAAA	GAAACACCGGTGGGGTTAGAACTAGATGTGGCAAGTTAACCTAATGCTAG	1	bc
AGATAACCAA	GAAACACCGGTGTGCTTTGCTCGTGGGGGGGGTAAAGCCAGTAAAAGCCA	1	bc
TCATCAGCAA	GAAACACCGGTGGGGTTAGAGCTAGAAATAGCAAGTTAACCTAAGGCTAG	1	bc
TGAACCTTAA	GAAACACCGGTGACAAGAGGACGATATGTGGAAAGAGCCAGAGAAAGAAA	1	bc
AACTATCTAC	GAAACACCGGTACTAGTTACTTGCGGGTGGGGTTAGAGCTAGAAATAGCA	1	bc
ACGACAACAC	GAAACACCGGTCTGATTAGCTCATTTGTGGGGTTAGAGCTATAAATAGCA	1	bc
GCCTCCGTAA	GAAACACCGGTACTAGTTACTTACGGGTGGGGTTAGAGCTAGAAATAGCA	1	bc
ATGATGGTAG	GAAACACCGGTCATAGAAGCTGAGTTAGAAGGGGGGTTAGAGATAGAAAT	1	bc
GAAGAAGCAG	GAAACACCGGTGCTAGTTAAGTTAGAGTGGGGTTGGAGCTAGAAATAGCA	1	bc
TGATACCACC	GAAACACAGGTCTTCTAAGCTTGCCGGTGGGGTTAGAGCTAGAAATAGCA	1	bc
AGCCAGTCCC	GAGACACCGGTGTTCTTTGCTCGGTGGGGGGGTTAGAGCTAGGAATAGCC	1	bc
CCCGCGCAAA	GAAACACCGGTTGAGTTAGAGAGGGCTTGGGGTTGTAAATAGAAAGATCA	1	bc
GCCTTTGTAC	GAAACACCGGTACTCTTTACTTACGGGTGGGGTTAGAGCTATAAATAGCA	1	bc
TCTCTAGCTT	GAAACACCGGTTGTCCTGGTAGAGTTGGGGGGTTCAAGTTAAAATAAGGC	1	bc
TCATGGCTCT	GAAACACCGGTGACGCGGGAGTTAGAGTGGGAGATAGCGAGATTTCCCAT	1	bc
GGAACATCAA	GAAACACCGGTGAGAACAGAACGTGGTGGGGTTGGAGCTAGAAATAGCAA	1	bc
CTCCCACACC	GAAACACCGGTTCAACCGGCGTTATAGCTGGAAATCGCAAGTTAACCTAA	1	bc
TAATTAATCC	GAAACACCGGTTGAGATAATCAAAAAGTGGTGTAGAGCTAGAAATAGCAA	1	bc
CCTTCACCCC	GAAACACCGGTTCCACCGGCGTTAGAGCTAGAAATAGCAAGTTAACCTAA	1	bc
GAATTATCTG	GAAACACCGGTTTTAGTAAATGGGGAGTGGGGCTAGAGCTAGAAATAGTA	1	bc
GTAGGAAAGA	GAAACACCGGTGGGGTGCGAGCTAGAAGGGGTAGGTTAAGCTATGGCTAG	1	bc
AAAACATGAC	GAAACACCGGTTTAGTATGTGGGGTTAGAGCTAGAAATAGCAAGTTAACC	1	bc
TTAGCAACAC	GAAACACCGGTGGGGTTAGAGCTAGAAATAGCAAGTTAACCTAAGGCCAG	1	bc
AAGTCAGACA	GAAACACCGGTGGCAATTCGTTCTGTGTTGGGTTAGAGCTAGAAATAGCA	1	bc
CAGATAGTAG	GAAACACCGGTTCTAGATACTGAGATAGATGGGTAGTTAGAGTAAGATAA	1	bc
CGGTTAGAAA	GAAACACCGGTGCTCATAGTTAGCTCGTGGGGTTAGAGCTAGAAATAGCA	1	bc
AGATCACAAT	GAAACACCGGATAGAACAGAAGGTTTTGGGGGTAGAGCTGGAAATAGCAA	1	bc
GAGTCGGACC	GAAACACCGGTTTAAGCGGAGGATTAGTGGGGGGAGAGAGAGAGAAAGCG	1	bc
AGGCCGGAAC	GAAACACCGGTGCTCTAAGCTGGGGGGTGGGGTTAGAGCTAGAAATAGCA	1	bc
GCGGCAAGAG	GAAACACCGGTTATCGTTACGGATTTGTGGGGATAGAGCTATAAATAGCG	1	bc
TTCAGCAACA	GAACACCCGGTGGGGTTAGAGCTAGAAATAGCAAGTTAACCTAAGGCTAG	1	bc
AGTTCGCAAC	GAAACACCGGTGTCACTTCGTACTGGGTGGGGTTAGAGCTAGAAATAGCA	1	bc
TCCGCTGTAA	CTAAACACCGGTACTAGTTGCTTACGGGTGGGGTTAGAGCTAGAAATCGC	1	bc
AAAACACATG	GAAACACCGGTTTAGTATGTGGGGTTAGAGCTAGAAATAGCAAGTTAACC	1	bc
AAGCCAAGAG	GAAACACCGGTTATCGTTCCGGATTTGTGGGGTTAGAGCTAGAAATAGCA	1	bc
GACCCCCCCC	GAAACACCGGTAATCTACGGATCTCCGTGGGGTTAGAGCTAGAAATAGCA	1	bc
ATCCCCCCCT	GAAGCACCGGTTGTAAGCGTTGGCTTGTGGGGTTAGAGCTAGAAATAGCA	1	bc
ATGACTGTAA	GAAACAACGGTAATAGTTACTTAGGGGAAGGGGTAGAGATAGAAATCGAA	1	bc
TCAATATTCT	GAAACACCGGTGGGGTGAGGGTTAGAGCTAGAAATAGCAAGTAAAGCTAA	1	bc
GTCTTCACCG	GAAACACCGGTCGCGGAAATGTGCCGGTGGGGTTAGAGCTAGAAATAGCA	1	bc
GGACCGCGCC	GAAACACCGGTGATCTTTACTCGAGGGAGGGAGTAGAGCTAGGATTAGCA	1	bc
ACACACCACC	GAAACACCGGTAGAGTTGGGTTGGAGCTGGAAATAGCAAGATAAACTAAG	1	bc
AACTTCTCAA	GAAACACCGGTCGCGAAAATGTGCCGGTGGGGTTAGAGCTAGAAATAGCA	1	bc
AATTTAGAAA	GAAACACCGGTTGTAGTGGACTCGGAGTGGGGGTAAAAGCAAGAAAAGCT	1	bc
TTTTTATCAC	GCAAGAACGAAACACCGGTGTGGACAGTTAGGGTTTGGGGTTCGAGCAAG	1	bc
ATTCGGGCAT	GAAACACCGGTTGTGGGGAACTCGGTGTGGGAGGAGTAGCAAGTTAACCT	1	bc
CAATAGCACC	GAAACACCGGTTCAACCGGCGTTAGAGCTAGAAATAGCAAGGTAACCTAA	1	bc
TTATGCCCCC	GTAACACCGGTCGAGTGATTGAACCAGTGGGGTTAGAGCTAGAAATAGCA	1	bc
CCCCGAAGAA	GAAACACCGGTAGAGTGGGGTTAGAGCTAGGAATAGTAAGTTAACCTAAG	1	bc
GGCAACTACG	GAAACACCGGTGGCAGCCAGCCACTTGTGGGGTTAGAGCTAGAAATAGCA	1	bc
ACTCATACCA	GAAACACCGGTGCTCGTTACGGGCGCGTGGGGTTAGAGCTAGAAATAGCA	1	bc
AACATCCAAA	GTAACACCGGTGGCAATTCGATCTGAGTGGGGTTAGAGCTAGAAATAGCA	1	bc
CTGATAGTAG	GAAACACAGGTCCTAGAAACTGAGTTAGAAGTGGGGAGAGAGATAGAAAT	1	bc
GGTAAAAAAT	GAAACACCGGTGGAAGCCGAGGAGAGGGGGGGGTTAGAGAGAGAAATAGC	1	bc
GAATCAGAAT	GAAACACCGGTACCAGTTGCTTACGGGAGGGGTTAGAGCTAGAAATAGCA	1	bc
TGCTGCTCTC	GAAACACCGGTCGCGGTACTGGGGGGTAGAGCTAGGAATAGGAAGTTAAC	1	bc
GAATTTGTTA	GAAACACCGGTACTAGTTACTTACGGGTGGGGTTAGAGCTAGACCTAGCA	1	bc
TCCTGCTGCC	GAAACACCGGTCGCGAAAATGTACCGGTGGGGATAGCAAGAGAAATAGAA	1	bc
GACCCTGAAA	GAAACACCGGTACTAGTTACTTACGGGTGGGGTTAGAGCTAGAAATAGCA	1	bc
AAAAACCTGC	GAAACACCGGTATTCTAAATGGGGCCGGAGCTAGAGATAGCAAGATAACC	1	bc
TCCGCCCACC	GAAACACCGGTAGTGTTAGAGCTAGAGATGGCAAGTAAACCTAAGTCTAG	1	bc
TCAGCCCAAC	GAAACACCGGTGTGCTTAGATCTAGAGTTGGCATAGTGCTCTAAATCTCG	1	bc
GAGTCAGACA	GAAACACCGGTTAACGTTACGGATTTGTGGGGTTAGAGCTAGAAATAGCA	1	bc
GAAACAGATG	GAAACACCGGTTTTAGTAAAAGGTGAGTTGGGTTAGAGATAGAAATAGCA	1	bc
TCCATCACCC	GAAACACCGGTCGCCTAAACTTCCCGGTGGGGTTAGAGCTAGAAATAGCA	1	bc
GCAAACCTCA	GAAACACCGGTGATCCGAGGGTTAGAGCGAGAAATAGCCAGGTAACATCG	1	bc
CAACGGCAAC	GAAACACCGGTGTTCTTTGCTCGAGGGTGGGGTTAGAGCTAGAAATAGCA	1	bc
CAATCAACAA	GAAACACCGGTTTTAGTAAATGGTGAGTGGGGTTAGAGCTAGAAATAGCA	1	bc
TCAACAGACT	GAAACACCGGTCTTCATGGTAGAGCTAGAAATAGCAAGTTAAACTAAGGC	1	bc
GAGACCAGCC	GAAACACCGGTTATCGTTACGGCTTTGTTGGGTTAGAGCTAGAAATAGCA	1	bc
CCCAACGGCG	GAAACACCGGTAGAGTGGGGTTAGAGCTAGAAATAGCAAGTTAACCTAAG	1	bc
AAAAAAGGAA	GAAACACCGGTGCCGTTTGTGCTAGCGTGGGCATGGAGACAGAAGGCTCA	1	bc
AGATCAACAA	GAAACACCGGTTAGAAAAGAACGTTTAGGGGTTAGAACTACAAATAGCAA	1	bc
GCCAGTGGAA	GAAACACAGGTAGTAGGTTATTACTAGTGGGGGTAGAGCTAGAAATGGCT	1	bc
GACTCCCGCG	GAAACACCGGTTATCGTTACGGATTTATGGGGTTAGAGCTAGAAATAGCA	1	bc
TGACCGCAAT	GAAGCACCGGTGTTCTTTGCTTGAGGGTGGGGTTAGAGCTAGAAATAGCA	1	bc
CTTTATTCCC	GAACCACCGGTCTCGTTTATGTGCCCGTGGGGTTAGAGATAGAAATTGAA	1	bc
CCGCGCGGTC	GAAACACCGGTCGTCGTTCGTAGGGCGTGGGGTTAGAGCTAGAAATAGCA	1	bc
TTGTTATGCG	GAAACACCGGTTATGGTTATGGATTTGTGGGGTTAGAGCTAGAAATAGCA	1	bc
CCGTTAGCCG	GAAACACCGGTTGTCTTTACTCGTTTGTGGGGTTAGAGCTATAAATAGCA	1	bc
AAACCCGCTA	GAAACACCGGTTTTGTATGTGGCGTTAGGGGTAGAAATAGCAAGTTAACC	1	bc
GACTCTCAAA	GAAACACCGGTACTAGTTACTTACGGGTGGGGTTAGAGCTAGAAATAGCA	1	bc
ACGCGCGTCG	GAAACACCGGTCCAAGAAGCCCAGTTAGGGGTGTGGTTCGAGCTAGAACT	1	bc
AATTCAGAAC	GAAACACCGGTACTAAGTGATGGCGGGTGGGGTTAGAGCTAGAAATAGCA	1	bc
GACTAAATCG	GAAACACCGGTTATCGTTACGGATTCGTGTGGTTAGATATAGACACAGCA	1	bc
GGGACAGGTT	GAAACACCGGTCCTCCTGGTATAGCTAGAAATAGCAAGAAAGCCTAAGTA	1	bc
TTATTATACC	GAAACACCGGTCTCGAAAATGTGCCAATGGGGTTAGAACTAGAAAGAGCG	1	bc
TATTTGGCCC	GAAACACCGGTTGTGGAGAACTCGGGGTGGGAGCAATAGCAAGTTAACCA	1	bc
AAGTAAACAC	GAAACACCGGTTATCGCTACGGACTTGTGGGGTTAGAGCTAGAAATAGCA	1	bc
ATATTAACAC	GAAACACCGGTTGGCTTTACTCCTTTGTGGGGTTAGAGCTATGAATAGCA	1	bc
ACAACGCTAT	GAAACACCGGTGACGCGAGAGTTAGAGCTAGAAATAGCAAGTTAACCTAA	1	bc
TAGTTAACCG	GAAACACCGGTTAGCGGTACTGATTTGTGGGGTTAGAGCTAGAAATAGCA	1	bc
CTTTCCCACA	GAAACACCGGTGGCAATTCGATCTTATAGGGGTTAGAGCTAGAAGTAGCA	1	bc
GACAAATGCG	GAAACACCGGTTACAGACAGGGACTTGTGGGGTTAGAGCTAGAAATAGCA	1	bc
TGCTATGCAA	GAAACACCGGTACTCGTTAGTTACGGGTGGGGATAGAGATAGAAATAGCA	1	bc
ATATTCTCGA	GAAACACCGGTTGCGAAAGTGCGGCGGTGGGGATAGAGATCGAATTAGCA	1	bc
TTCTTATCAA	GAAACACCGGTCGCGAAAATGTGCCGGAGGGGATAGAGCTGGAAATCGAA	1	bc
CGACCGAAAC	GAAACACCGGTGTTCTTTGCTCGAGTTTGGGTTTATATCTATAAATCGCA	1	bc
AACAGCGCAC	AGGGCGGAAAAACCGGTATCGAAGGACTCGCGGGGGGAGAGATAGCAAGA	1	bc
CTATCACATC	GAAACACCGGTTCACCCGGCGATATAGCTAGAAATAGCAAGTTAAGCACG	1	bc
TTATTATCCT	GAAACACCGGTTGCAAAAGATGGCTTGTGGGGTTAGAGCTAGAAATAGCA	1	bc
TGTACATAAA	GAAACACCGGTGAGCACAGAACGATTTAGGGAAAGAGCTAGTAGTAGGAA	1	bc
GTGACAATCG	GAAACACCGGTTAGCGTTACGGTTTTGAGGGGATAGAGCTAGAAATAGCA	1	bc
CCCGGCGGGC	GAAACACCGGTAAAGTGGGTTATAGGATAGTAACAGTAGGCTAGTCTAAG	1	bc
AGGCCTCCAC	GAAACACCGGTGGTCTTTGCCCGAGGGTGTGTTTCGAGCTAGAACTCTCC	1	bc
AGATAACAGA	GAAACACCGGTGTGCGTTGATTATGGGTGGGGTATGGGCTAGAAATAGAA	1	bc
GGTTATTCAA	GAAACACCGGTGCGAACAAAACGCTTTGGGGTTAGAGCTAGAAAAAGCCA	1	bc
AGTCAATAAC	GAAACACCGGTGACAAACGAAGGTCAGTGGGGTTAGAGCTAGAAATAGCA	1	bc
GTCTATGTCT	GGACGGACGAAACACCTGTTCTAGTTACTTGCGTGTGGGGTTAGAGCTAG	1	bc
GTGACAGTTG	GAAACACCGGTCCTCGAAGCTTAGTAAGAAGAGGTTATCCTGCTAGTAGT	1	bc
TTGTCCAGCG	GAAACACCGGTTATCGTTACGGGTTTGTGGGGTTAGAGCTAGAAATAGCA	1	bc
GCCTCGGAAA	GAAACACCGGTTCAACCGGCGTTAGAGCTAGAAATAGCATGCTAACCTAA	1	bc
ATATCAAGCG	GAAACACCGGTTGTAGGCGCTGGTTTGTGGGGTTAGAGATAGAAATAGGA	1	bc
GGCAAGGAAA	GAAACACCGGTACTAGTCACTTACGGGTGGGGTTAGAGCTAGAAATAGCA	1	bc
TAGTTAACCC	GAAACACCGGTTGGCTTTACTCCTTTGTGGGGTTAGAGCTCTAAATAGCA	1	bc
TTATTCCAAA	GAAACACCGGTGGCGATAGTGCGACGGTGGGGTTAGAGCTAGAAATAGCA	1	bc
TAGACCAGCG	GAAACACCTGTTATCGTTACGAATTTGTGGGGTTAGAGCTAGAAATAGCA	1	bc
AAGTAAACAG	GAAACACCGGTTACCTTTACGGGTTTGTGGGGTTAGAGCTAGAAATAGCA	1	bc
GATAAAACCG	GAAACACCGGTTATCGTTATGGATCCGTGGGGTTAGAGCTAGGAATAGCA	1	bc
TCCAACCTCG	GAGACACCGGTGGCGAGAGGGATCAAGCTAGCCATAGCCAGGTAAGCTAT	1	bc
ATGCAGCCAC	GAAACACCGGTGAGCTTTGCGCGTGGGGGTGGTTATAGCAAGATATAGCA	1	bc
CCCTTACTCC	GAAACACCGGTTCAACTAATGCTAGAGTTAGAAATAGCAAGTTAACCTAA	1	bc
CGCTCGTTAA	GAAACACCGGTTAGAACTGTACGTCTTGGGGTTAAAGCTAGAAATAGCCA	1	bc
GCCTAAAAAT	GAAACACCGGTGGTCTTACGATCTGAGTGGGTAATAGATAGAAAAAGCAA	1	bc
TACTATGTCC	GAAACACCGGTACTAGTTACTTACGGGTGGGGTTAGAGCTAGAAATAGCA	1	bc
CAACCCCGCC	GAAACACCGGTTGAGTGGGGTTAGAGCTAGGAATGGCATGTTAACCTAAG	1	bc
GTCTTAGCCC	GAAACACCGGTTTTAGTAAATGGTGATTGGGGTTAGAGCTAGAAATAGCA	1	bc
GAGTAAGTAC	GAAACACCGGTACTAGTTACTTACGGGTGGGGTTAGAGCTAGAAATAGCA	1	bc
TCCTCCCAAT	GAAACACCGGTTTACTTGGTGATCTAGTTAGGTTTAGCCAGTTAATATCA	1	bc
GCAAATGTAA	GAAACACCGGTGCTAGTTAGATGCGGGAGGGGGTAGAGCTAGAAATAGCA	1	bc
GCAAATGCAA	GAAACACCGGTACTAGGTACTTACGGGTGGGGTTAGAGCTAGAAATAGCA	1	bc
CGTTCGTACC	GAAACACCGGTGCGACCAGAACGTTTTGGGGGTAGAGCTAGAGATAGCAA	1	bc
CCGCGAACAT	GAAACACCGGTTGGCGTTATTCCTTTGTGGGGTTAGAGCTATAAATAGCA	1	bc
GACTATAGAT	GAAACACCGGTGGTCGCCGCGGAGAGGGTGGGGTAAGAGTTAGAAATAGC	1	bc
GATATTTCTG	GAAACACCGGTGCGCATGATGAGATCGTGGGATATGAGGTAGAAATAGCA	1	bc
ATGAAATTCG	GAAACACCGGTCAGAGAAGATGAGTTAGAAGTGGGGTAAGAGATATAAAT	1	bc
TCTCTAACAT	GCAACACCGGTCGGCTTTACTCCTTTGTGGGGTTAGAGCTATTAACAGCA	1	bc
TACACTGCCA	GAAACACCGGTACTAGTTACTTCGGGGTGGGGTTAGAGCTAGAAATAGCA	1	bc
CCCTCGGAAA	GAAACACCGGTTCAAGCGGCGTTAGAGCGGGAAGAAGCAAGGTAACATAA	1	bc
ACAAGGGTAT	GAAACACCGGTGACGCGGAACTTAGAGCGGGAGATAGCAAGATATAATAA	1	bc
TGTTTATTAA	GAAACACCGGTGAGAACAGAACGTTTTGGGGTTAGAGCTAGAAATAGCAA	1	bc
GCAATCCTCA	GAAACACCGGTGAGGCGAGCGTTAGAGCTAGAAATAGAAAGGTAACATCA	1	bc
AGCTAGCAAA	GAAACACCGGTGTTCTTTGCTCGAGGGTGGGGTTAGAGCTAGAAATAGCA	1	bc
CGCTCACCGA	GAAACACCGGTGAGAACAGAACGTTTTGGGGTTAGAGCTAGAAATAGCAA	1	bc
ATAAGCGTTT	GAAACACCGGTGCTAGAGGCTTCGAAGTGGGGGTAGAGATAGCAATAGAA	1	bc
AAGACAATCG	GAAACACCGGTCCTAGAAGCTGAGTTAGAAGTGGGGTTAGAGCTAGAAAT	1	bc
GAGTCAGACT	GAAACACCGGTTATCGTTACGGATTTGTGGGGTTAGAGCTAGAAATAGCA	1	bc
AGACGGGAAA	GAAACACCGGTGGTGTTGAACTGGGGGTGGGAGTAGAGCTAGGTTAACCA	1	bc
GGATAGCAAA	GAAACACCGGTGCTCTTTGCTCGAGGGTGGGGTTAGAGCTAGAAATAGCA	1	bc
ATCTTGTCAC	GAAACACCGGTCGCGAAAATGTGCCGGTGGGGGTAGAGGCAAGATTAGCA	1	bc
GAAGCAAACG	GAAACACCGGTGTTGGTAGATGGAGAGTGGGGATAGAGATATAAATAGCA	1	bc
GACAACAAAA	GAAACACCGGTGATCAAAGGTAGCTCGTGGGGTTAGAGCTAGAAATAGCA	1	bc
TTGACAGCCG	GAAACACCGGTCTTAGTAAATGGGTGTTGGGGTTAGACCAAGAAAAGGCA	1	bc
TTTTCAGCTT	GAAACACCGGTCTGCCTGGAAGATCTGGAAGTAACAACTTAACCTACGGC	1	bc
TCATCGCAAC	GAAACACCGGTTAAACCGGCGTTAGAGCTAGACATAGCAAGATAACCTAA	1	bc
ACAACGCACT	GAAACACCGGTACAACGGGAGGGAGAGAGAGAGATAGAAAGATAACATAA	1	bc
GATTATGCAG	GAAACACCGGTACTAGTTACTTACGGGTGGGGCTAGAGCTAGAAATAGCA	1	bc
AGCACATCAT	GAAACACCGGTTCCAGATGTATCGTAGTGGGGTTAGAGCTAGAAATAGCA	1	bc
CATTCTCCCT	GAAACACCGGTGGCCATTCGCTCTTAGTGGGGTTAGAGCTAGAAATAGCA	1	bc
ACTTGGGACA	ACCGGACGCAACCCCGGTTGTGGGGAACTCGGTGTGGGCGATCTAGCAAG	1	bc
GATCCAGCTG	GAAACACCGGTTTTAGTAAATGGTGAGTGGGGTTAGAGCTAGAAATAGCA	1	bc
AGACCCCACC	GAAACACCTGTGCTCTTTGCTGGGGGGTGGGGTTTAAGGCTGGAATTGCA	1	bc
AATACAGGCG	GAAACACCGGTGCCCTTTATGGATCCGTTGGGGTAGAGCCAGGAATAGCA	1	bc
AATCCACCCT	GAAACACCGGTTGTAAGCGATGGGTTGTGGGGGTAGAGCTAGAAATAGCA	1	bc
TTCTATGCAA	GAAACACCGGTCGCGAAAATGTGCGGGTGGGGTTAGAGCTAGAAATAACA	1	bc
AATCCAATGC	GAAACACCGGTTTCGAATGTGGGGTTAGAGCTATAAATCGCAAGTTAACC	1	bc
ACACGGCGAC	GAAACACCGGTGGTATGGGTTCGCGGGTGGGGCTAGAGCTAGAAAGAGCA	1	bc
AAACCATTTA	GAAACACCGGTTTAGACTGTAGGGTTCGAGCTAGAAATAGCAAGTTAACC	1	bc
GAAACCGCAG	GAAACACCGGTTTTCGTAAATGGTGAGTGGGGTTAGAGCTATAAATAGCA	1	bc
GGTTATGCAA	GAAACACCGGTAATAGTTACTTACGGGTGGGGTTAGAGCTAGAAATAGCA	1	bc
CAATGTGTTA	GAAACACCGGTACTAGTTACTTACAGGTGGGGTTAGAGCTAGAAATAGCA	1	bc
AGCAATTCAT	GAAACACCGGTGCCCGTTAGCTCGTGGTGGGGTTAGAGCTAGAAATAGCA	1	bc
AACCAGGGAA	GAAACACCGGTACTAGTTACTTACGGGTGGGGTTAGAGCTAGAAATAGCA	1	bc
TCACCCCGAC	GAAACACCGGTGGAGTGGGGTCAGAGCTTGAAATAGCAAGTTAACCTAAG	1	bc
GAGACTGTCG	GAAACACCGGTTATCGTTACGGATTTGTGGGGTTAGAGCTAGAAATAGCA	1	bc
CAAACGCTCC	GAAACACCGGTTCAACCGGCGTTAGAGCTAGAAATAGCAAGTTAACCTAA	1	bc
TTCTTGGCCG	GAAACACCGGTCGCGAAAAAGTGCCGGTGGGGTTAGAGCTAGAAATAGTA	1	bc
GAATCAGAAT	GAAACACCGGTTTTAGTAAATGATGAGTGGGGTTAGAGCTAGAAATAGCA	1	bc
TCAGAAACCA	GAAACACCGGTGGGGTTAGTGCTAGCGAGGGCATGTTACCCTAGGGCTCG	1	bc
AACTTCTCCG	GAAACACCGGTCGCGAAAATGTGCCGGTGGGGTTAGAGCTAGAAATAGCA	1	bc
ATACAACAAA	GAAACACCGGTGTGCGTTGCTCGTGCGTGAGAATAAAGCTGGAAATAGCA	1	bc
TTCTTAACGC	GAAACACCGGTCGCGAAAATGTGCCGGTGGGGTTAGAGCTAGAAATAGCA	1	bc
GAGTCCAACA	GAAACACCGGTTATAGTTACGTATTTGTGGGGTTAGAGCTAGAAATAGCA	1	bc
GGGTCAAAAG	GAAACACCGGTTATCGTTACGGGATTGTGGGGTTAGAGCTAGAAATAGCA	1	bc
CATCTAACAC	GAAACACCGGTGAGAGTCATTCGTTTGTGGGGGTAGAGCTATAAATAGCA	1	bc
TTAACCGTTT	GAAACACCGGTCATGCTGGGATTAAAGCGGGGTAGAGCAAGAAAAAGTAA	1	bc
TACCATTTAT	GAAACACCGGTACTAGTTACTTCCGGGTGGGGTTAGAGCTAGAAATAGCA	1	bc
GCGACCCTCG	GAAACACCGGTTATCGTTACGGATTTGTGGGGTTAGAGCTAGAAACCTAA	1	bc
AATTAACGAA	GAAACACCGGTGGCAATTCGATCTGAGTGGGGTTAGAGCTAGAAATAGCA	1	bc
CCCTTACCCC	GAAACACCGGTTGGCTTTACTCCTTTGTGGGGTTTAGGCTGTAAATTGCG	1	bc
TACCTAAGCC	GAAACACCGGTAGAGTGGGTTTAGAGGTAGAAATAAGAAATTAACCTAAG	1	bc
GGGACCTCAA	GAAACACCGGTGCGCGCTAGCAGTTTTTGGGGTTAAGCTAGAAAATAGAA	1	bc
CGCTCTGTAA	GAAACACCGGTGCGAGCTACATATGGTTGGGGTTAGACTAAGAAAAAGCA	1	bc
GCCTACCTCA	GAAACACCGGTACCACGTACTTACGGGTGGGGTTAGAGCTAGTAAAAGCA	1	bc
GGATCATCTA	GAAACACCGGTGAGAGCAGAACGTGTTGGGGTTAGAACGATAAATAGCGG	1	bc
TACTTAAGCC	GAAACACCGGTCGCCAAAATGTGTCGGTGGGAGTAAAGCTAGAAAAAGCA	1	bc
ATGCGCGTCC	GAAACACCGGCTCTAGAAGCTGAGTTAGCCTTGGGGTTAGAGCTAGACAT	1	bc
AAAAGAATGA	GAAACACCGGTTTTGTATATGGGGTTGGGGCTGGAAATCGAAAGATAGCA	1	bc
GCCCCACGCT	GTAACACCGGTGGTCGCCGTGGAGAGGGGGGGGTTAGAGCTAGAAATAGA	1	bc
ACACGAAGCA	GAAACACCGGTAGAGTGGGGATAGAAGTAGAAATAGAAAGATAACCTAAG	1	bc
GACAAACTAA	GAAACACCGGTAATCTAAAGATCCACGTGGGGATAGAGCTAGAAATAGCA	1	bc
GAATTAGCTA	GAAACACCGGTTTTAGTAAATGGTGAGTGGGGTTAGAGCTAGAAATAGCA	1	bc
CAGCCCACGA	GAAACACCGGTTTAGTATGCTGGTTTGGAGCTAGAAATAGCAAGTTAACC	1	bc
GCTTCAGAAA	GAAACACCGGTACGAGTAAATCAAGGGAGGGGATAGAGCTATAAATAGAA	1	bc
ATACGAGTTT	GAAACACCGGTCGTAAGCGGTGGGTTGTGGGGTTAGAGCTAGAAATAGCA	1	bc
AAGTAGCAAC	GAAACACCGGTTGTATTTGATCCGGTGTGGGGTTAGAGGTAGATTAAGCA	1	bc
CAATCGAACC	GAAACACCGGTTAAACCGGCGTAAGAGCTAGAAATAGCAAGTTAATCTAA	1	bc
GTATGAGCTG	GAAACACGGGTTTTATTAAATGGTGAGGGGGGTTAAAGCTGGAAAAAGGA	1	bc
AATTACGCAC	GAAACACCGGTGGCGTATATGGGCCGGTGGGGTTAGAGCTAGAAATAGCA	1	bc
AACCAGCTAC	GAAACACCGGTATTCTTTGCTCCCGGGTGGGGATAGAGCTAGAAATATCA	1	bc
ATGCCCGATT	GAAACACCGGTCCTAGAAGCTGAGTTAGAAGTGTGGTTAGAGCTAGAAAT	1	bc
TCGTCAAAAT	GAAACACCGGGTGGCTTTATTGCTTTGGGGGGTTAGAGTAATAATTAGCC	1	bc
TGTGCAGAAA	GAAACACCGGTCTGCCTGGTAGAGCTAGAAATAGCAAGTTAACCTAAGGC	1	bc
TTAATCTTCA	GAAACACCGGTGACGAGAATGTGATAGTTAGAAATAGCAAGGAAACAGAA	1	bc
TCCCCCCCCC	GAAACACCGGTGGGGGTAGAGTTAGAAATAGCAAGATAACCTAAGGCTAG	1	bc
CGCTTATAAA	GAAACACCGGTGAGAATAGAACGTTTTGTGGTTAGAGCTCGAAATAGCAA	1	bc
GTAAACGACG	GACACACCGGTGGCTAGAAATAGGAAGTTAGCCTAAGTCTGGCTCGCTCT	1	bc
CAATTAATCC	GAAACACCGGTTGAGAGGAGCTAGAAGTGGGAATAGTAAAGAAATATCAA	1	bc
CAAATCCGTC	GAAACACCTTAGAGTGTGTTTCGCGCTCGAACTAGCAGATTCACATAAGG	1	bc
GAATTAGATG	GAAACACCGGTTTTAGTAAATGGTGAGGGGGGGTAAAGCTAGAAATTACC	1	bc
ACACCACAAC	GAAACACCGGTGTGCTTAGCTCGAGAGTGGGGTTAGAGCTAGAAATAGCA	1	bc
CCCGCAGCCC	GGAACACCGGTAGAGTGGGGTTAGAGCTAGAAATAGCAAGATAACCTAAG	1	bc
AAGCTCATGC	GAAACACCGGTTTGCTATGTGCCTTTATAGGTATAAATATCAAATTAACC	1	bc
AGAAAGTAAA	GAAACACCGGTGTTCATGGCTCGATGGTGGGGTTAGAGCTAGAAATAGCA	1	bc
CACTGGCGCC	GAAACACCGGTAGAATGGTAGAGCTAGAAATAGCAAGTTAACCGAAGGCT	1	bc
ACGTTACAAT	GAAACACCGGTTGGCTTTACTCCTTTGTGGGGTTAGAGCTATAAATAGCA	1	bc
AGCCCGCCCC	GAAACACCGGTGTTCTTTGCTCGTGGGTGGGGATAGAGCTATAACTAGCA	1	bc
AGTTAGGAAC	GAAACACCGGTTGTGGGGGACTCGGGGTGGGAGAAATAGCAAGTTAACCA	1	bc
AAACAATAAC	GAAACACCGGTTTAGTATGTGGGGTTAGAGCTAGAAATAGCAAATTAACC	1	bc
TCCCGAAGCC	GAAACACCGGTAGTGAGGGGTTAGAGCTAGAAATAGCAAGTTAACCTAAG	1	bc
ATGAATGTAA	GAAACACCGGTCCTAGATACTTACGTTGGGGGGTAGAACCTGAAATAAGA	1	bc
CATTGAGCAC	GAAACACCGGTGGCGATTAGATCTGGGTGGGGTTAGAGCTAGAAATAGCA	1	bc
AAACCCTTAC	GAAACACCGGTTTCGAACGAGGGATTAGAAGTAGAACTAGCACGATAACC	1	bc
CAGATAACAG	GAAACACCGGTTGGTTTTACTCCTTTGTGGGGTTAGAGCTAGAAATAGCA	1	bc
CGCTCGACCT	GAAACACTGGTGAGGACAGAACGTGTTGTGGTTAGAGCTAGAAATAGCAA	1	bc
TGACTATGTC	GAAACACCGGTACTCGTTACTTACGGGTGGGGTTAGAGCTAGAAATAGCG	1	bc
GGATCAAATT	GAAACACCGGTCTTCCTAGTAGAGCTAGGAGTATCAAGCTAACATAAGCC	1	bc
TCCTCCTACC	GAAACACCGGTTGCAAAAATGTGCCGGCGGGGGTAGAACTTGAAATAACA	1	bc
ACGACAGACG	GAAACACCGGTCCTAGAAGCTGGGTTAGAAGTGGGGTTAGAGCTAGAAAT	1	bc
GAAACAGTCT	GAAACACCGGTGACGCGAGGGTTAGAGCTAGAAATAGCAAGTTAACCTAA	1	bc
ACCAACCCCC	GAAACACCGGTGACGCTAGCGTTATAGCGGGGATTAGCAAGTAAATCGAA	1	bc
ATCTTCCCCT	GAAACACCGGTTGTGAACGAGGGCTGGTGGGGTTAGAGCTAGAAATAGCA	1	bc
CTACCTCGCT	GAAACACCGGTTGTAAGCGATTGTTTGTGGGGTTAGAGCTAGAAATAGCA	1	bc
CGGCGGGTTG	GAAACACCGGTTATCGTTACGGATTTGTGGGGTTAGAGCTAGAAATTGCC	1	bc
ATGACAGAAG	GAAACACCGGTCCTAGAAGATGAGTTAGAAGTGGGGTTAGCGATAGAAAT	1	bc
AGACCGCACA	GAAACACCGGTGTTCTTTGCGCGGGGGTGGGGTTAGAGATAGAAATAGCA	1	bc
AGCTAGCAAA	GAAACTCCGGTGTTCCGTGATTGAGGGTGGGGATAGAGCTAGAAATAGCA	1	bc
GCGTCGGAGA	GAAACACCGGTGAGATGCCTCAAATAGCGAGAGAGCTAGAGATAGCTAGT	1	bc
GCCCCCAGCC	GAAACACCGGTTGTGTTTGCTTAGTGCTAGAAATAGCACGTTAACCTAAG	1	bc
TCAGCCATCA	GAAACACCGGTGGGGTTAGAGCTAGCAATAGCAAGTTAACCTAAGGCTCG	1	bc
TGAACGCTAT	GAAACACCGGTGATGCTTGGGTTAGAGCTGGGTTTAGCATGTTAACCTCA	1	bc
AGTCAGCCAA	GCAACACCGGTGTTCTTTGCTCGAGGGTGGGGTTAGAGGTAGGAATAGCA	1	bc
GCCTCGGAAC	GAAACACCGGAGCAACCGGCGTTAGAGCTAGAAATAGCAAGTTAACCTAA	1	bc
CCTTCAGCAC	GAAACACCGGTGACAACTGTACGTTTGTGGGGTTAGAGTTAGAAATACCA	1	bc
ACCACGGACC	GAAACACCGGTTCAACTGACGTTAGAGCGGGGATTAACCAAGAAACCTAA	1	bc
AATCGGCCAT	GAAACACCGGTTGTGGGCGATTGTTTGTGGGAGTAGAGCTAGGAATAGCA	1	bc
AATCCACAAG	GAAACACCGGTGCCCTTTATGGGATTGTGGGGTTAGAGCTAGAAATAGCA	1	bc
AGATCAGACT	GAAACACCGGTGTTCTTTGCTCGAGGGTGGGGTTAGAGCTAGAAATAGCA	1	bc
GACTCACACG	GAAACACCGGTTTTAGCAGCTGGTGAGGGGGGGTTGGGCTTAAAATAGCA	1	bc
AAACAAAAAA	GAAACACCGGTGTTATTTGCTCGAGGGTGGGGTTAGAGCTAGAAATAGCA	1	bc
GAATAGGACG	GAAACACCGGTTTTCTTAGCTGGTGAGTGGGGTTAGAGCTAGAAATAGCA	1	bc
TGATCAACAA	GAAACACCGGTGAGGATAGAACGTTTTGGGGTTAGAGCTAGAAATAGTAA	1	bc
AGACTATGCA	GAAACACCGGTACTAGTTACTTACGGGTGGGGTTAGAGCTAGAAATAGCA	1	bc
ATTTCACACA	GAAACACCGGTGGCAATTCGTTCTGAGTTGGGTTAGAGCTAGAAATAGCA	1	bc
CATAACCACC	GAAACACCGGTGGCCTTTCTATCTGAGTGGGGTTAGAGCTAGAAATAGCA	1	bc
AATAATGATA	GAAACACCGGTGAACTTTCAGGGAACGTGGGGTTAGAGCTAGAAATAGAA	1	bc
CGATAATAAA	GAAACACCGGTGAGAACAGAACGTTTTGGGGTTAGAGCTAGAAATAGCAA	1	bc
GGGCAGCAAA	GATACACCGGTGTTCTTTGCTCGAGGGGGGGGTTAGAGCTAGAAATAGAA	1	bc
TGTTCATCCT	GAAACACCGGTGAGCACAGAACGTTCTTGGGGTAGAGCTAGAAATAGCAA	1	bc
AAAATCTTGA	GCAACACCGGTGAGCATTATAACGTTAGAGGTGTTAAGAGTAAAAAAAGC	1	bc
GACTCTAGCA	GAAACACCGGTTATCGTTACGTATTTGTGGGGTTAGAGCTAGAAATAGCA	1	bc
TAAACAATCT	GAAACACCGGTAGGGGAAGAGTTGTAATAGGGATATAAAGCTAAGGCAAG	1	bc
ATTAGGGTCA	GAAACACCGGTCGTGGAGGCTGCGTTGGGGGTGGAGTTATAGGTTTAACT	1	bc
CAGTCACTTG	GAAACACCGGTCATCGTTCGGTATTTGTGGGGTTAGAGCTAGAAATAGCA	1	bc
CGTTACCAAG	GAAACACCGGTGGCAAGTAATAGCAAGTTGAGTTAAAGCTGGTCCGAGAT	1	bc
TTCTTCCAAC	GAAACACCGGTTGCGAATATTTGTCGGTGGGGTTAGAGCTAGAAATAGCA	1	bc
TCAGCCCACA	GAAACACCGGTGGGGTTAGAGCTAGAAATCGCGAGTTAACCTAAGGCTCG	1	bc
ATAAACCACT	GAAACACCGGTTGTAAGAGATGAGTTGTGGGGTTAAACCTGAAATTAGCA	1	bc
CACTTACACC	GAAACACCGGTTCAATTGGCGTTAGAGCTGGATAAAGCATGTTAACCTCA	1	bc
AGATCACAAG	GAAACACCGGTGTTATTTGCTCGTGGGTGGGGTTAGAGCTAGAAATAGCA	1	bc
ACAGCACAAC	GAAACACCGGTGGGGTTAGAGCTAGAAGTGGCAAGTTAACCTAAGGCTAG	1	bc
GCGTTAAGAG	GAAACACCGGTTGGCTTTACTCCTTTGTGGGGTTAGAGCTAGAAACAGCA	1	bc
TCCGTTAATA	GAAACACCGGTTGGATTTACTCCTTTGTGGGGTTAGAGCTATAAATAGCA	1	bc
GATCCAGTTA	GAAACACCGGTCTTCGTTAATTATAGGTGGGGATATAGCAAGATATAGTA	1	bc
GTGTAAGCGA	GAAACACCGGTGTGCTGAGATTAGGCGTGGGAAATAGCAAGTAACCTAAG	1	bc
TTCTCCCCGA	GAAACACCGGTGTGCGGAGGTTATGGGTGGGGATTAGCAAGGAACCTAAG	1	bc
CTGACCGATG	GAAACACCGGTCCTAGAAGCTGAGTTAGGAGTGGGGTTAGATCTAGAAAT	1	bc
GACTCAAAAC	ACGGAAGAAACACCGGTTCAACCGGGGAGCGAGCTAGAAAGAGCAAGGAA	1	bc
ACGATAACCG	GAAACACCGGTTGGATTTACTCCTTTGTGGGGTTAGAGCTATAAATAGCA	1	bc
CCGCGAACAT	GAAACACCGGTTGGCTTGACTCCTTTGTGGGGTTAGAGCTATAAATAGCA	1	bc
AGTCCGCAAA	GAAACACCGGTGAGATCAGATCGTTTGGGGGTTAAGGGTTGGAATAGCCA	1	bc
TAACGAGATT	GAAACACCGGTCCTACTGGTATAGCTAGGGGTATCAAGCTAGCCAAAGGA	1	bc
CGTCCGCAAC	GAAACACCGGTGGCCATTCGATGTGGGTGGGGTTAGAGCTAGAAATAGCA	1	bc
AGTTAATCAG	GAAACACCGGTGAGCACAGAGCGTTTGGGGGTTCGAACTAGAAATAGCAA	1	bc
GTCCGCCGTA	GAAACACCGGTAGAGTGGGGTTAGAGCTAGAAATAGCAAGTTAACCTAAG	1	bc
TCATCCTCAA	GAAACACCGGTGGGGACAGTGCGACTTGGGGGTTGAGATACGAATAACAA	1	bc
CCTTGCCGCA	GAAACACCGGTTGAGGGGGGCTAGAGCTAGGAGTAGCAAGATAATCTACG	1	bc
AACCACTCAA	GAAACACCGGTAATCTAAGGATGTCCGGGGGGATAGAGCTAGAAATAGCA	1	bc
TCAATATTCT	GAAACACCGGTGACGCGAGGGTTAGAGCTAGAAATCGCAAGTTACCCTAA	1	bc
TACTCTTTCA	GAAACACCGGTACTCGTTACTTACGGGTGGGGTTAGAGCTAGAAATAGCA	1	bc
GGTTAATCCA	GAAACACCGGTGAGAACAGCACGTTTTGGGGTTAGAGCTAGAAATAGCAA	1	bc
TACTCTGTCA	GAAACACCGGTACTAGTTACTTACGGGTGGGGTTAGAGCTAGAAATAGCA	1	bc
GGCTACGAAA	GAAACACCGGTACTAGTCACTTACGTGTGGGGTTAGAGCTAGAAATAGCA	1	bc
TCGTTCACCC	GAAACACCGGTTGGGTATATTCCCTTGTGGGGTTAGAGCTATAAATAGCA	1	bc
GACTATAAAC	GAAACACCGGTACTCGTTACTTACGGGTGGGGTTAGAGCTAGAAATAGCA	1	bc
CTGTCCGCAA	GAAACACCGGTGAGAACAGAACGGTTTTGGGTTAGAGCTAGAAATACCAA	1	bc
AGAAATATAT	GAAACACCGGTCGTCGTTCGTAGGGGTGGGGTTAGAGCTAGAAATAGCAA	1	bc
GTCTCTGTCA	GAAACACCGGTACTAGGTACTTACGGGTGGGGTTAGAGCTAGAAATAGCA	1	bc
TCCGCCACAA	GAAACACCGGTGGGGTTAGAGCTAGAAATAGCAAGTTAACCTAAGGCTAG	1	bc
GTCTCAGCGG	GAAACACCGGTTTTAGTAGATGATGCGTGGGGTTTAAGCTATAAATAGCG	1	bc
GATTAAAGAG	GAAACACCGGTTATAGTTACGGATTTGTGGGGTTAGAGCTAGAAATAGCA	1	bc
ATGTCAGAAG	GAAACACCGGTCCTAGAAGGTGAGGTAGAAGTGGGGTTAGAGCAAGAAAT	1	bc
TGCTCATCCA	GAAACACCGGTGAGAACAGAACGATTTGGGGCTAGAGCTAGTAATAGCAA	1	bc
AGTAAATCAA	GAAACACCGGTGCGAATTGATCGTTTTGGGGGTAGAGCTTAGAAAAAGAA	1	bc
ATCTAATTAA	GAAACACCGGTACTCGTTGATTACGCGTGGGGTTAGAGCTAGAAATAACA	1	bc
TCAGCAACCG	GAAACACCGGTGTTGTTAGATGGAGAGTGGGGATAGAGCTAGAAAGAGCA	1	bc
GGTTTAGAAA	GAAACACCGGTACTAGTTACATCCGGGTGGGGTTAGAGCTAGAATTAGCA	1	bc
AGTCCGCCAC	GAAACACCGGTGATCTTTGCACGATGTTGGGTTTAGAGCTAGAAATACCA	1	bc
CCATCAACAT	GAAACACCGGTTTTCTTAATTGGTTAGTGGGGTTAGAGCTAGAAATAGCA	1	bc
CACCGAGGCC	GAAACACCGGTGGAGGGGGGTTAGAACTAGAAATAGAACGATAACCTAAG	1	bc
CCGTGCACAA	GAAACACCGGTTAGCTTTCCTCCTTTGTGGTGGTAGAACTATAAATAGCA	1	bc
CTCTTAACGC	GAACCACCGGTGTGCTTTACTTCTTCGTGTGGTTAAGCAAGTAAAATGCG	1	bc
AGACCGATTA	GAAACACCGGTTTAGGATGGGGGGGTAGGGCTTAGGATAGCAAAGTAACC	1	bc
ACACGAAGCC	GAAACACCGGTGGAGTGGGGTTAGAGCTAGAAATAGAGAGATAACCTACG	1	bc
ACAGCGAAAC	GAAACACCGGTGGGGTTAGCGCGAGAGATAGCATGGTGCCCGAAGGCTCG	1	bc
TGGACTGTCT	GAAACACCGGTCCCCGTTGCCGAGTTGGAAGTGTGGTTCTAGCTATAACA	1	bc
CGATCGCAAC	GAAACACCGATGTTCTTTGCTCGTGGGTGGGGTTGGAGCTTGAAATACCA	1	bc
TCCGCTGAAA	GAAACACCGGTTGTGTTAGAGCTAGAAATAGCAAGTTAACCTAAGGCTAG	1	bc
TAATAACAGT	GAAACACCGGTTTACGTAGTTAACTAGTGGGGTTAGAGCTAGAACTAGCA	1	bc
CATAGCGCCC	GAAACACCGGTAGCGTGGAGGTAGGCGTGGGGATAGCACGACAACCTGCA	1	bc
ATCAACCAGT	GAAACACCGGTGCCCTTTATGGGACCGTGGGGTTAGAGCTAGAAATAGCA	1	bc
GCCTTACATC	GAAACACCGGTGCAACCTACGGTAGAGCATGAAATGGTAAGTTAAAGTAA	1	bc
GATAATGCAA	GAAACACCGGTACTAGTTACGTGCGGGTGGGGTTAGAGCTAGAAATAGCA	1	bc
CACTCAACAA	GAAACACCGGTGTGAACAGATCGTTCTGGGGTTAGAGCTAGTAATAGCCA	1	bc
GACTCTTTAC	GAAACACCGGTACTAGTTACTTACGGGTGTGGTTAGAGCTAGAAATAGCA	1	bc
CAATCGAACC	GAAACACCGGTTCAACCGGCGTTAGAGCTAGGAATAGCAAGTTAACCTAA	1	bc
GACAAATCAC	GAAACACCGGTAAGAAAAGGATGTTTTGGGGTTAGAGCTAGAAATAGCAA	1	bc
CAAAGACCCC	GAAACACCGGTTGAGGGAGATTAGAGGTAGGATTAGAAAGATAACCTAAA	1	bc
GCAGCAGACG	GAAACACCGGTTGGGGTAGATGGAGAGATGGGATGTAGCTCGAAGGATAG	1	bc
AGCAAGCTCC	GAAACACCTGTGATCTATGCTCGCCGGTGGGGATAGAGCTAGAAATAGCA	1	bc
AGATTAAAAC	GAAACACCGGTGCTCATAGTTAGCTCGTGGGGTTAGAGCTAGAAATAGCA	1	bc
AAGTATGTCA	GAAACACCGGTCCTAGAAGCTGAGTTAGAAGTGGGGTTAGAGCTAGAAAT	1	bc
GAATCCCTCG	GAAACACCGGTTTTAGGAGAGGGAGAGTGGGAATAGAGCTAGAAATAGCA	1	bc
AAGGACGAGG	GAAACACCGGTGCGATTCATGGAGCGGGTGGGGTTAAGGCTAGAAAAACA	1	bc
CATCTACAAC	GAAACACCGGTGGCGAATCGCTCTGAGTGGGATTATAACTTAAAATAACA	1	bc
GACTAGCTAC	GAAACACCGGTATTAGTTACTTACGGGTGGGGTTAGAGCTAGAAATAGCA	1	bc
GTCTATGTCC	GAAACACCGGTACTGGTTACTTACGGGTGGGGTTAGAGCTAGAAAGAGCA	1	bc
GTATTCTACA	GAAACACCGGTCGCGAAGATGTGCTGGAGGTGGTAGAGCCAGGAAAAGCA	1	bc
GCCTCACGCA	GAAACACCGGTTCAACCTGCGTTATAGCTAGGGGTTGCAAGTTGACCCAA	1	bc
ATGAAAGTGG	GAAACACCGGTCCTAGAAGCTGAGTTAGAAGAGGGGTTAGAGATAGAAAT	1	bc
ACCTCACAGC	GAAACACCGGTTCAACGGGCGTCTTTTGTGGGGTTAGAGCTAGAAATAGC	1	bc
GGACAGAAAA	GAAACACCGGTGTTCTTTGTTAGAGGGTGGGGTTAGAGCTAGAAATAGCA	1	bc
CACTATTCAA	GAAACACCGGTACTAGTTACTTACGGGTGGGTTTACAGCTAGTAGTACCA	1	bc
GTATACTACG	GAAACACCGGTCGCGGATAGGCGCCGGTGGGGTTAGAGCTAGAAATAGCA	1	bc
ACAACGCAAA	GAAACACCGGTGGTCTTTGCTCGAGGGTGGGGTTAGAGATAGAAATAGCA	1	bc
TAATTAATCC	GAAACACCGGTTGAGATAATCAAAATGTGGGGTAGAGATAGAAATAGCAA	1	bc
AATCCTGCCT	GAAACACCGGTGCCCTTCATGGGACCGGGGGGATCTAGCTAGAACTAGCT	1	bc
GGGCAGAAAC	GAAACACCGGTTATCGTTACGGATTTGTGGGGTTAGAGCTAGAAATAGCA	1	bc
CGTTCCTCCC	GAAACACCGGTGAGCTCAGAACGTTTTGGGGGTAGAGCTAGAAATCGCAA	1	bc
AGATAGCCAA	GAAACACCGGTGTTCTTTGATTGAGGGTGGGATTAGAGCTAGAATAACCA	1	bc
CCTCTAACAT	GAAACACCGGTTGTCTTTACTCCGTTGTGGGGTTAGAGCTATAGATAGTT	1	bc
TATAACCAAG	GAAACACCGGTTTACTTAGTTAACTAGTGGGGTTAGAGCTAGAAATAGCA	1	bc
ATGACAGCAG	GAAACACCGGTGCTAGAAGATGAGTTTGGGGTGGGGTCAGAGATAGACAT	1	bc
AAATTACTAC	GAAACACCGGTGTAGTTAACTCGAGGAGGGGTAGACATATAAAATTAGCA	1	bc
TTCGTCTAGC	GAAACACCGGTCGCGATAGAGCGCCGGTGGGGTTAGAGCTGGAAAGCGCA	1	bc
AACTTCTCAC	GAAACACCGGTCGCGAAAATGTGCCGGTGGGGGTAGAGCTAGAAATAGCA	1	bc
TTCTTAAACA	GAAACACCGGTCGCGAAAATGTGCCGGTGGGGTTAGAGCTAGAAATAGCA	1	bc
AATAGGGTCG	GAAACACCGGTCCTAGAAACTGAGTTAGAAGTGAGGTTAGAGCTAGAAAT	1	bc
ATTAAAGCCA	GAAACACCGGTGCCCTTTATGGGACCGTGGGGATAGAGCTAGAAATAGCA	1	bc
GTCTTATCTC	GAAACACCGGTGGGCAAGAAATCGCTGGGGGGGTAAGAGTAAAAATAGGA	1	bc
GAATAAGCGA	GAAACACCGGTTTTAGGAGATGGTGAGTGAGAATAGAGCTAGAAATAAAA	1	bc
GTCTACGTCA	GAAACACCGGTCCTAGTTACTTACTGATGGGGGTAGTTCTAGCTATAGCT	1	bc
ATATACCCGC	GAAACACCGGTGTGCGGAGATTATGCGTGAGAAATAGCAAGTAACCTAAG	1	bc
AGCAACTAGG	GAGACACCGGTGTGAGGCGATTATTTGTGAGATTTGTGAAGTAACCTGAG	1	bc
TGAACAGTTG	GAAACACCGGTGAGGCGAGGTGTAGAGCTGGAAAAAACAAGATAATATCA	1	bc
TCATCACTCG	GAAACACCGGTTATCCGAGGGGAGTTGTGGGGTTAGAGCTAGAAATAGCA	1	bc
ATGACAGACT	GAAACACCGGTTGTAGAAGATGAGTTAGGGGGGGGGTTATAGAAAGAAAT	1	bc
TAAACCTCCT	GGATGGACGAAACACAGGCTTACTTAGTTAACTAGTGGGGTTAGAGCTAG	1	bc
TTTTCAGCTT	GAAACACCGGTCTTCCTGGTCGAGCTGGCACTAGCGAGTTAACCAAAGCC	1	bc
ACGCTCATCA	GAAACACCGGTGAGAACAGAACGTTTTGGGGTTAGATCTAGAAATAGCAA	1	bc
CCCCCCCCAA	GAAACACCGGTAGGGAGGGGATAGATCTGGGAATAGCAAGGTAACCTCAG	1	bc
AAAACCCTGG	GAAACACCGGTTTAGTAAGTGGGGTAAGAGCTAGAAATAGCAAATTAAAC	1	bc
CCATCATAAA	GACACACCGGTGAGAACAGAACGATTTAGGGTTAGAGTTCGCAATAGAAG	1	bc
AAACGCATTG	GAAACACCGGCTTACGATGTGGGGTTTGAGCTTGAAATAGCAAGGTAACC	1	bc
GGTCCAGTAT	GAAACACCGGTCATCTTGGTAGAGCTAGAAATAGCAAGTTAACCTAAGGC	1	bc
TTTTCCTCAA	GAAACACCGGTCGGGAAAGTGCGCTGGGGGGGTTAGAGTTAGAAAAACCA	1	bc
GGCAAAGTAA	GAAACACCGGTACTAGTTACTTACGGGTGGGGATAGAGATAGAAACAGAA	1	bc
CGTATATAAA	GAAACACCGGTGAGAACAGAACGGTTTGGGGCTGGAGCTAGAAATAGCAA	1	bc
GAATTATCCC	GCAACACCGGTCGCGAAAATGAGCCGGTGGGGTTAGAGCTAGAAATAGCA	1	bc
GTGGCCGCCC	GAAACACAGGTCCGAGTAGCGGTAGAGAGGGCATAATAACATAAAGCTAG	1	bc
GCCCACCGCT	GAAACACCGGTGGTCGCCGTGGAGAGGGTGGGGTTAGAGCTAGAAATATA	1	bc
CTGCTACCCC	GAAACACCGGTTGGCTTTACTCCTTTGTGGGGTTAGAGCTATAAATAGCA	1	bc
CTTTCCCAAG	GAAACACCGGTGGCAATTCGATCTGAGTGGGGTTAGAGCTAGAAATAGCA	1	bc
ATAATGTAAA	GAAACACCGGTCGTCGTTCGTAGGGGTTGGGTTAGAGCTATAGATAGCAA	1	bc
AAGCCAGTAG	GAAACACCTGTTATCGTTGCGGGTTTATGGGGTTAGAGCTCGAAATAGCA	1	bc
CTCTACCCGC	GAAACACCGGTGTGCGGCGCTTCTGCGTGGGAAATAGCACGTAACCTAAG	1	bc
ACACGCCGCA	GAAACACCGGTAGAGTGGAGGTAGGGGTAGAAATAGAAAGAGAACCTAAG	1	bc
AGTTCGCAAC	GAAACACCGGTCTCCATTGCATCTGCGTGGGGTTAGAGCTAGAAATGTCA	1	bc
ATGACCTCCA	GAAACACCGGTCCTAGAAGCTGATTTAGGGGTGGGGTTAGAGCTATAAAT	1	bc
AACCGCAGGC	GAAACACCGGTTTAGTAGATCCGGGTAGAGGTAGAAATATCAAATTAACC	1	bc
TTTAACGTCC	GAAACACCGGTCCTAGAAGCTGAGTTAGAAGTGGGGTTAGAGCTAGAAAT	1	bc
CAGCCCCGCG	GAAACACCGGCTATCGATACGGATTTGAGGGAATAGAGCTCGAAAATGAA	1	bc
CCCGCAAAAC	GAAACACCGGTGGGGTTAGAGCTAGAAATAGCAAGTTAACCTAAGGCTAG	1	bc
CCCTAGGATC	GAAACACCGGTTCAACCGGCGTTAGAGCTAGGAATAGCAAGTTAACCTAA	1	bc
CCCTCAAAAA	GAAACACCGGTTCAGCCAGAGTTAGAGCTAGCAATATCAAGTAAGGCTAG	1	bc
ACTAACGTCG	GAAACACCGGTGACCCTTATAGGTCCGTGGGGTTAGTGTTAGAATTAGCA	1	bc
ACGTGAACAA	GAAACACCGGTTGTCGGTACCTCTTTGTGGGGGTAGAGGTAAGATTACCT	1	bc
GTCTTCAGCC	GGAACACCGGTCGCGAAAATGTACGGGTGGGGTTAGAGCTAGAAATAGCA	1	bc
CAACCCCGCC	GAAACACCGGTAGAGTGGGGTTAGAGCTAGAATTAGCAAGTTAACCTAAG	1	bc
AAACGCGTGT	GAAACACCGGTTTAGTATGTGGGGTTAGAGCTTGAAATAGCAAGTTAACC	1	bc
AGACCCGTCC	GAAACACCGGTTCTAGAAGGTGAGTTAGGCGTGGGGTTAGAGCTAGAAAT	1	bc
TGTTCGCATT	GAAACACCGGTCTTACTGGCAGAGCTAGTAGTGGCAAGTTAACATAAGGC	1	bc
ATAAAACATC	GAAACACCTGTGTTCTTTGCTCGAGGGTGGTGTTAGAGCTAGAAATAGCA	1	bc
GGATCAGATT	GAAACACCGGTCTTAGTAGAAGGGGAGGGGGTAGAAAGTTAAAAATAGCA	1	bc
AACAAGTCGG	GAAACACCGGTTTCAGTCAGTGGTGAGTGGGGTTAGAGCTAGAAATAGCA	1	bc
GAGTAATTAG	GAAACACCGGTTATCGTTACGTATTTGTGGGGTTAGAGCTAGAAATAGCA	1	bc
AGACTGTATC	GAAACACCGGTGTTCTTTGCTCGAGGGGGGGTTGAGAGCGAGAATTAACA	1	bc
CCCTAGGACG	GAAACACCGGTTCAACCTGCGTTAAAGCTAGGTATAGCAAGGTAACCGAA	1	bc
GTCCATCCAT	GAAACACCGGTACTAGTCACTTACGGGTGGGGTTAGGGCTAGAAATAGCA	1	bc
AACTGGGACA	GAAACACCGGTTGTAGGGAACTCGGTGTGGGGGTAAAAGCAAGAAAAGCA	1	bc
AAGTAACACA	GAAACACCGGTTATCGTTACGGATTTGTGGTGTTAGAGCTAGAAATAGCA	1	bc
ATGAACGAAC	GAAACACCGGTGCTCGTTGCTCGAGGGGGGGTAGAGGGCGAGTAGAGGTA	1	bc
CCCCGACGAA	GAAACACCGGTAGAGTGGGGTTAGAGCTAGAAATAGCAAGATAACCTAAG	1	bc
TCAACAATCG	GAAACCCAGGTGACGCTACGGTTAGAGCGGGGATTAGCAAGGTAATCTAA	1	bc
TACTTTTCAC	GAAACACCGGTCCTGAAAACGTGCCGGTGGGGTTAGAGCTAGAAATAGCA	1	bc
GAGTGAGCCA	GAAACACCGGGTTTCGTTATTGATGTGTGGGGTTAGCGCTAGAAAAAGCA	1	bc
ATACCAACCC	GAAACACCGGTTGGCATCGCTGGTTTGTGGGGTTAGAGCTATAAATAGCA	1	bc
TCGAGCGTTT	GAAACACCGGTGACGAGAGGGATAGAGCGAGAAATAAAAAGGAAACCGAA	1	bc
