CCTTCCCCAC	GAAACACCGGTGGCGATTCTATCTGAGTTGGGTTAGAGCTAGAAATAGCA	1	bc
ATGAATGTCT	GAAACACCGGTCCGAGAAGTTGTCTTAGGGCTAAAAATAGCAATCTATCC	1	bc
AAACCGCCAC	GAAACACCGGTGTTCTTGGTGGGGTTAGGGGTAGAAATAGCGAGTTAGCC	1	bc
ACCTACGGCC	GAAACACCGGTAGTATGTATTCACGGGTGGGGTTAGAGCTAGAAATAGCA	1	bc
TTCCTACACC	GAAACACCGGTTGCGAGAGTGGGCTGGTGGGGTTAGAGCTAGAAATATCA	1	bc
ACACAACGCT	GAAACACCGGTAGAATGGGTTGATGGGTGGGGTTAGAGCTAGAAATAGCA	1	bc
GTATTACCGA	GAAACACCGGTGAGCGTGGTATAGTCGGGGGAGATAGAGAGAGAAATAGG	1	bc
CTGTAAACGC	GAAACACCGGTTGGCTTTACTCGTGTGAGGGGTTGAACCAGTAACTTGAC	1	bc
AATCCGTAAA	GAAACACCGGTGACAAACGGATGTCAGTGGCGTTAGAGCTAGAAATAGCA	1	bc
CGACTAACCC	GAAACACCGGTTGTCTTGGCGGCTTTATGGGTATAAATAGCAAATTAACC	1	bc
AATAAAAACG	GAAACACCGGTGCCCTTTATGGGACCGTTGGGTTAGAGCTAGAAATAGCA	1	bc
AAATATGTGA	GAAACACCGGTACTAGCTACTTACGGGCGGGGTTAGAGATAGTAATAGAA	1	bc
GAAACCTATA	GAAACACCGGTGGGGTTAGTGCTAGAATTGGCATGTTAACCTAAGGCTCG	1	bc
TTCGCTTACT	GAAACACCGGTTCCCGTTAGCTCGTAAGTGGGGTTAAAGCTAGAAATAGC	1	bc
ATACATCACG	GAAACACCGGTGCCCTTTATGGGACCGTGGGGTTAGAGCTAGAAATAGCA	1	bc
AATCAGCAAA	GAAACACCGGTGTCCTTGGGGTCTGTAGTGGTATAGATCGCAAGTTAACC	1	bc
ACAAAACACT	GAAACACCGGTGTTCCTAGAGATAGAAAGAGCACGTAAGGATAAGCCTAG	1	bc
AACCCACCCC	GAAACACCGGTAACATACGGATGTCCGTGGGGTTAGAGCTAGCAATAGCA	1	bc
AGACAAAGAT	GAAACACCGGTGGTGTTAGCGCTAGGGGGGGGTGGTTGACAGAAGGCGAG	1	bc
GACTCCGCCC	GAAACACCGGTTTCGGTAAATGGCGAGTGGGGTTAGAGCTAGAAATAGCA	1	bc
GCACGAAATT	GAAACACCTGTGGGAGTAGAGCTAGAAAGAGCAAGTTAACCTAAGGCTAG	1	bc
ATGTCGCACC	GAAACACCTGTCCTAGCGGCTGGGTTTGAGGTGGTAATAGTAGGTTAACC	1	bc
AATCTAACAG	GAAACACCGGGGTGCGGAGATTATGCGTGAGAAATAGCAAGTAACCTAAG	1	bc
GTGTCCGCCG	GAAACACCGGTCTTAGTAACTGCTAGGTGTGGTAAGTTAACGTAAGACCA	1	bc
GGGGGCTACA	GAAACACCGGTGAGAGGGGTTAGATCTAGGGATTACAAGTAGACCTAGGG	1	bc
CGTTCCTCCC	GAAACACCGGGGTTAGAGCTAGAAATAGCAAGTTAACCTAAGGATAGTCC	1	bc
AACACGCAAG	GAAACACCGGTGTTAGATCAATGTTCGTGGGGTTAGAGCTAGAAATAGCA	1	bc
GAGGGGGAGG	GAAACACCGGTGAGTGGGGATAGAGCTAGAAATAGCAAGTTAACCTAAGG	1	bc
ATGATCGCAT	GCAACACCGGTCCTAGATGCTAGGTTAGAGCTATTGATATCAAGTTAACC	1	bc
GTGGCAGATT	GAAACACCGGTGTTCGTGGATAGAGCTAGGGGTAGCACGTTAACCTAAGA	1	bc
AAATGAATAC	GAAACACCGGTTGCTAGAAATAGCAAGTTAACCTAAGGCTAGTCCGTTAT	1	bc
AGATCGCCAC	GAAACACCGGGGTTATATGTACAAATAGCAGGTTAACCTAAGAAATATCA	1	bc
GTTTGCGAAA	GAAACACCGGTGAGTGCGGATAGATCTGGGGATAGCAAGTTAACTAGAGG	1	bc
ATCAAAAGCA	GAAACACCGGTGGGGGTAGATCTTGATATAGAAATATAACCTAAGGTAAG	1	bc
GCATTGCACC	GAAACACCGGTGCACATGATAAAGTCCGAGGTGATAGAGCTAGAGATCGA	1	bc
ATGACAGACA	GAAACACCGGTCCTAGAAGCTGGGTTAGAGCTAGAAATAGAAAGTTAACC	1	bc
GAGTGAAGCA	GAAACACCGGTAGTCGGTATGGATGGGTGGGGTTAGAGCTAGAAATAGCA	1	bc
CGCTCTTCAC	GAAACACCGGTTCCAGCGGGGATTGAGCTAGTAATAGAAAGCTAACCTGT	1	bc
GATTCCCACC	GAAACACCGGTGACATTTAGATCTGAGTGGGGTTAGAGCTAGAAATAGCA	1	bc
CCTCCTGGTT	GAAACACCGGTTGTCTTTACTCCTTCGTGGGGTTAGAGCTATAAATAGCA	1	bc
CGACCGCCAA	GAAACACCGGTGTTATTGGTGGGGTTAGAGCTTGTAATAGCAAGTAAACC	1	bc
CCCACAAGCC	GAAACACCGGTGGGGTTAGTGCTAGAAATAGCAAGTAAACCTAAGGCTAG	1	bc
AACCCCTCCC	GCAACACCGGTGACCAACGTATGTCAGTGGGGTTAGAGCTAGAAATAGCA	1	bc
AGACAGCCCG	GAAACACCGGTTTTCTTAGAGGGGTTAGTGCTGGTAATAGCAGGATGACC	1	bc
ATCTAAGCTT	GAAACACCGGTGTGCGGAGATTATGCGTGAGAAATAGCAAGTTACCTCAG	1	bc
AACCCGTCAG	GAAACACCGGTGACAGTAGAGCTAGAGAGGGCTTAGAGCCAGAAATATCG	1	bc
GTCTAAGCAA	GAAACACCGGTGTGCGGAGATTATGCGTGAGAAATAGCAAGTAACCTAAG	1	bc
CTCCCGGTCC	GAAACACCGGTTCAAGCTAGAAATAGCATGTTAACCTAAGGCTAGGCTGT	1	bc
AGATCGGAAG	GAACCACCGGTGTTCGTGGTGGGGTTAGGGGGTTAAAGAGCAAGTTAGCC	1	bc
GGAACATACT	GAAACACCGGTGAGCATTAGCTCGTGAGGGTAGAGCTAGAAATAGCAAGT	1	bc
GTAGCATCAA	GAAACACCGGTGAGATTCGTATGACAGTGGGGTTAGAGCTAGAAATAGCA	1	bc
ATTTCAGACA	GAAACACCGGTGGCAAATGGATCTGTGGTGGGGTTAAGGTAGGAATAACA	1	bc
GAAACACACT	GAAACACCGGTTTACTTAGTTAACTAGTGGGGTTAGAGCTAGAAATAGCA	1	bc
TCCCCCCACC	GAAACACCGGTTTACTTGGTTCACTGGTGGGGTTAGAGCTAGAAATAGCA	1	bc
AATACTTCCC	GAAACACCGGTGACCAACGTATGTCAGTGGGGTTAGAGCTAGAACTAGCA	1	bc
GCACTAAAAC	GAAACACCGGTACAAAGAGTCAACGGGTGGGGTTAGAGCTAGAAATAGCA	1	bc
GGAATTATAA	GAAACACCGGTGGGGTTAGAGCTAGAAATAGCAAGTTAACCTAAGGCTAG	1	bc
CAGCCAATGA	GAAACACCGGTTTAGTATGCTCGGTTGTAGGTTTAGATCTCAAGTTAGCC	1	bc
AATAATCAAC	GAAACACCGGTGTTCTTTATGGGACGGTGGGGTTAGAGCTAGAAATAGCA	1	bc
AAGAAAACCC	GAAACACCGGTAATCTAAACACCACTGTGGGGATAGAGCTAGAAATAGCA	1	bc
GGTCAAGAAT	GAAACACCGGTATTACTGGAATACGTGGGGTAGAGCTAGAAAAAGCAAGT	1	bc
CCGGTTGTTG	GAAACACCGGTTGGCTTTACTCCTTTGTGGGGTTAGAGCTATAAATAGCA	1	bc
GTGTGCGCAA	GAAACACCGGTGAGAGGGGATAGAGTTTGGGGTTAGAGCTTAACCTAGCA	1	bc
GGATCATAAA	GAAACACCGGGGTTCTTAGTGGACTAGTGGGGTTAAAGCTAGAAATAGCC	1	bc
GATGATGCCA	GAAACACCGGTGCTCGTTGTTAGAGCGTGGGGTTAGAGCTAGACCTAGCA	1	bc
AATTTAGCCC	GAAACACCGGTTCGCTTTACTCCTTTGTGGGGTTAGAGCTATAAATAGCA	1	bc
ACGCTAATAC	GAAACACCGGTTTGCTTTACTCGTGTGTGGGGTTAAAACATTAAATAGAC	1	bc
TCAGCAAGCT	GAAACACCGGTGGGGTTAGAGCTAGAAATAGCAAGTTAACCTAAGGCTAG	1	bc
CACTCACGCA	GCGGAACACCCGGTGGCAATTCGATTTTAGGGGGGTTTTAGCCAGAAATA	1	bc
ATTTCACACA	GAAACACCGGTGGCAATTCCTTCTTCGTGGGGTTGGTGCTAGAAATAGCA	1	bc
GCAAAGAGAT	GAAACACCGGTGGGGTTAGAGCTAGAAATAGGAAGTTAATAGAAGGATAG	1	bc
GGATCAACAA	GAAACACCGGGGTTAGAGCTAGACATAGCAAGTTAAACTAAGGCTAGTCC	1	bc
AAATTATAAC	GAAACACCGTTGATAATAGTTAGGTCGTGGGGTTAGAGCTAGAAATAGCA	1	bc
GACTTCTACC	GAAACACCGGTCGCGAAAATGTGCCGGTTGGGTTATAGCTAGAAATAGCA	1	bc
CAACGAGATT	GAAACACCGGTGCTAGCTGTTTCGAAGTGGGGTTAGAGCTAGGAATAGCA	1	bc
GAAGCCGAGA	GAAACACCGGTTTAGGAGGGTAGGGCGAGGGGTTAGAGCTTGAAATAGGA	1	bc
TAATGCGAAA	GAAACACCGGTGATAATAGTTAGAGCTAGGGATAGCAGGTTGACATAGCG	1	bc
GGCGCTTCGT	GAAACACCGGTGAGTGGGGTTAGAGATAGAAATAGCAAGTTAACCTAAGG	1	bc
ATGCCAGTAG	GAAACACCGGTTTAAAATGTATGGTTGGGGGTACTAATAATAGGATGTCC	1	bc
GCCTTAAGAA	GAAACACCGGTGGGGTTAGATCTCGCGATAGCATGTTGACCTAAAGATCG	1	bc
CAACGAGATT	GAAACACCTGTGCTAGCGGTTTCGAAGTGGGGTTAGAGCTAGAAATAGCA	1	bc
GGAAATTCAA	GAAACACCGGTTCTCGTTAGCTCGTGGGGGTAGAGCAGGAAATAGCAAGT	1	bc
TGATTAGATT	GAAACACCGGTTTTCCTGATATCCGAGGGGGGGAGCTAGAAATAGAACGT	1	bc
GGTCCCTCAC	GAAACACCGGTGACAAACGTATGTCAGTGGGGTTAGAGCTAGAAATAGCA	1	bc
AAACCGCCAC	GAAACACCGGTGATCTTGGTGTGGTTAGAGGTAGAAATAGCGAGATAGCC	1	bc
TTCTCCGCGA	GAAACACCGGTGTGCGGAGGTTATTCGTGCGAAATAGCGCGTAACCTAAG	1	bc
TACAACCACT	GAAACACCGGTTTACTTAGTTAACTAGTGGGGTTAGAGCTAGAAATAGCA	1	bc
CATTAACCAC	GAAACACCGGTGGCAATTCGATCTGAGTGGGGTTAGATCTAGAAATAGCA	1	bc
CGATTCACAC	GAAACACCGGTTGGCTTTAATCGCTTGTGAGGTTAAAGCTGTAACTTGCA	1	bc
TCACCATAAC	GAAACACCGGTGACAAACGTATGTCAGTGGGGTTATTGCTAGAAATAGCA	1	bc
GATTTGTCAA	GAAACACCGGTGGTGGTGAAGTTAGAGTGGGCGAGTTAACCTGTTACTCT	1	bc
ATACCCCTCG	GAAACACCGGTTCAACATGCTTGGTTAGTGGGTTTAGAGCTAGGATTACC	1	bc
ACAGCCGAGA	GAAACACCGGTGGGGTTAGCGATAGAAAGAGATAGCAAGTATAAGGATAG	1	bc
GGCAAATACG	GAAACACCGGTGGCAGGGGTTAGAGCTAGAAATAGCAAGTTAACCTAAGG	1	bc
TGTTTCGCCC	GAAACACCGGTCGCGAAAATGTGCCGGTGGGGATAGAGCTAGAAATAGCA	1	bc
AGGACCGCCT	GAAACACCGGTCCCAGAAGCTGGGTTGGGGGTAGAAATATCGAATTAACC	1	bc
TGAACATACT	GAAACACCGGTTCCCGTTAGCTCGGGGGGGGAGAGCTAGAAATAGCAAGT	1	bc
ATATAAATGA	GAAACACCGGTTTGCGGAGAAGATGAGTGGGAATAAGCATGTATATAAAG	1	bc
GTGTTCGCGA	GAAACACCGGTGAGTGTGGTTAGATCTAGGGATAGCAAGTTAACCTAAGG	1	bc
CTGTCCCTCC	GAAACACCGGTCCTACCGGCTGGTTTAGTGCTAGACTTAGCAAGTTAACC	1	bc
AATTAACAAC	GAAACACCGGTGGCAATTAGATCTGAGTGGGGTTAGAGCTAGAAATAGCA	1	bc
AGATAATCAC	GAAACACCGGGGTTCTATCTAGAAATAGCAGGTTAACCTAAGACTAGTCC	1	bc
AAGACGGAAG	GAAACACCGGTCCTAGAAGCGGGGGTAGAGGTAGAAATAGCAGGATAACC	1	bc
ATTTCCCACA	GAAACACCGGTGGCACTTCGATCTGAGGGGGGTTAGATATAGACATAGCC	1	bc
TTCTTCTAGA	GAAACACCGGTGAGATGCCTCACCGGTGGGTTAGAGCTAGAAATAGCAAG	1	bc
GCATTAAGCA	GAAACACCGGTACTAATAGTTCACTGGTGGGGTTAGAGCTAGAAATAGCA	1	bc
AAAAAATTCA	GAAACACCGGTTGCGTATGGGGAGTTGGGGGGAGAAATAGACAGATAGCA	1	bc
GTCTACCCGC	GAAACACCGGCGAGCAAAGGTTATGCGTGCGAAGTAGCAAGCGATATAAG	1	bc
GCCATAAACA	GAAACACCGGTGGGGATAGAGATAGAGATGGCATGTTAATCGAAGGATAG	1	bc
GAGTGTGAAA	GAAACACCGGTGCGTGTGGTTAGAGCTAGAAATAGCAAGTTAACCTAAGG	1	bc
TTTTTACAAC	GAAACACCGGTGGCAATTCGATTTGAGTGGGGTTAGAGCTAGAACTAGTA	1	bc
GGGGGCCACC	GAAACACCGGTGTGTGTGGTTAGAGCGAGGGATAGCAAGTTAAACTAAGA	1	bc
AAGACAGCCG	GAAACACCGGTCCTAGAAGCTGGGTTAGAGCTAGAAATAGCAAGTTAACC	1	bc
GAAGGCGTGA	GAAACGCCGGTGATTGGGACTTAAGCTAGAAATAGCAACTTAACCTAAGG	1	bc
GACACACGCT	GAAACACCGGTGGGAGTAGAGCTTGAAATAGCACATTCCCCTAAGGCTCG	1	bc
AATCCCTCGA	GAAACACCGGTTAAGAACGGATGGCAGTGGGGTTAGAGCTAGAAATAGCA	1	bc
AGCAAATCGA	GAAACACCGGTTCGCGGTGACTCGTGGGGAGAGAGATAGAAATAGCAAGG	1	bc
ACCGTTAATA	GAAACACCGGTTGGCTTTACTCCTTTGTGGGGTTAGAGCTATAAATAGCA	1	bc
GGATAGGAAG	GAGACACCGGTGTTCTTGGTGGGGGTAGAGCTAGGAATAGCAAGTGAACA	1	bc
AGATAGTTAA	GAAACACCGGTGTTATTGGTGGGGTTAGAGGTTGAAATAGCAAGTTAACC	1	bc
GAGGACGAGC	GAAACACCGGTGAGTGGGGTTAGAGCTAGAAATAGCAAGTTAACCTAAGG	1	bc
ACACAGAAAA	GAAACACCGGTGTTGTTGGTGGGGTTAGAGCTAGATATAGCAAGTTCACC	1	bc
GTGTGCTACA	GAAACACCGGTGAGAGTAAATAGAGCTAGGGATAGCAAGTTAACATAAGG	1	bc
CTAATAACTC	GAAACACCGGTGGGCTTTGCGCTTGTGAGGGCTTGTTACCCTAAATCTCG	1	bc
AGACAGGATT	GAAACACCGGTGTTCTTGGTTGGGCCGTGGGGTTAAAGTGGAAATTAACA	1	bc
TCCATAATCT	GAAACACCGGTGGGGATAGAGCTAGAGAGGGGAAGTTATCCTAAGGCTAG	1	bc
TGCACTAAAT	GAAACACCGGTTGGCGTAAAGTTGGAGATATCAAGCTAGCATTAGGCAGT	1	bc
AAAATAGCAG	GAAACACCGGTTTTAGTAAATGGTGAGTGGTGTTAGAGCTAGAAATAGCA	1	bc
GTGTGCGCGC	GAAACACCGGTGGGTTGGACTACATTGTGGAATTAGAGGTAAAAGTAAGA	1	bc
AAATAACAAA	GAAACACCGGTGGCAATTCCTTCTGAGTGGGGTTAGAGCTAGAAATAGCA	1	bc
AACAAGATCT	GAAACACCGGTGTGGTTAGAGCTAGAGATAGCAAGGTGATCTAAGGCTCA	1	bc
TGTTCGGAAA	GAAACACCGGTTCACGCTAGAAATAGGAGGTTGAACTAAGGATAGTACGC	1	bc
ATCTCACACC	GAAACACCGGTTGAAAGCGAGGGTTTGTGGGGTTAGAGATAGAAAGAGAA	1	bc
AACATGCTAG	GAAACACCGGTTTTGTATGATGGGTTAGAGCTAGAAATAGCGAGATAACC	1	bc
CATTCAGACG	GAAACACCGGTCCTAGAAGCTTCTTTGGGGGTTGAAATCGAGAGATAGCA	1	bc
CTGTTCGCAC	GAAACACCGGTTGTCTTTACTCCTTTGTGGGGTTAGAGCTATAAATAGCA	1	bc
GATTGCGAGA	GAAACACCGGTGAGTGGTGTTAGAGCTAGAAATACCAAGTTAACCTAATG	1	bc
AGGAGGGACA	GAAACACCGGTCCTAGAAGCTGCGGTATGGCTAGAAAGAGAAAATTAACA	1	bc
CCGTTACAAA	GAAACACCGGTGGCCTTTACTACTTTGTGGGGTTAAAGCTCTAAATAGCC	1	bc
CGGCGGGTTG	GAAACACCGGTCGTCACTCGTAGGTCTTGGGGTTGGGGCTGGAAATGGCA	1	bc
TAAACTGCCT	GAAACACCGGTTGACGTTAGCTCGTGGGGGGAGAGCTAGAAATAGCAAGA	1	bc
ACACCCCTCC	GTAACACCGGTATAATGGATCCACTGTTGGGGTTAGAGCTGGAAATAGCA	1	bc
TAATTCAAAC	GAAACACCGGTGCTAATAGTTAGCTCGTGGGGTTAGAGCTAGAAATCGCA	1	bc
TAAGCCCTTT	GAAACACCGGTGACGCGAGGGTTAGAGCTTGAATTAGCAAATTAACCTCA	1	bc
TAAATATTTC	GAAACACCGGTTGGCATGATCTAGAAATGGCAAGTTGATCTAAGTATAAT	1	bc
AAATAATGAC	GAAACACCGGTGCCCTTTATGGGACCGTGGGGTTAGAGCTAGAAATAGCA	1	bc
GAGCGCTAGC	GAAACACCGGTGAGTAGGTTTAGAGCTAGAAATAGCAAGTGACCCTACGG	1	bc
TCAACTAGCT	GAAACACCGGAGGGGGTAGAGCTAGAAATAGCAAGGTAATCTAAGGCTAG	1	bc
GTCATAGACA	GAAACACCGGTGGGGTTAGAGCTAGAAATAGCAAGTTAACCTAAGGCTAG	1	bc
GTGATCGTCC	GAAACACCGGTCCTAGAAGCTGGGTTATAGCTAGAAATAGCAATTTAACC	1	bc
GTAGGAGACA	GAAACACCGGTGAGAAGGGATAGAGCGTGGGATAACAAGTTAAACTAAGA	1	bc
GCCCCAACAA	GAAACACCGGTGGTGATAGAGCTAGAAATGGCATGTTAACCGAAAGATAG	1	bc
GTAAGATGCC	GAAACACCGGTAGAATGGACCCACGGGGGGTGTTAGAGCTAGAAATAGCA	1	bc
TAAATCTTCC	GAAACACCGGTTCCCTTTCTCTCGTCGTGGGAGAGCTATCAATAGCTATT	1	bc
AGGCCGCACC	GAAACACCGGTGTTATTGGTGGAGTTAGAGCTAGTAATAGCAAGTTAACC	1	bc
TGGCCCGATG	GAAACACCGGTCTTACAAGCAGCGGTGAGAGATAGATAGAAAAAGCAAAT	1	bc
AGTCCATCTT	GACACACCGGTCTTCCTGGAATCCGTGTGGTAGTGCTGGAAATAGCAAGT	1	bc
GAATCTTCCT	GAGACACCGGTTTTCGTTAATTGGGAGTGGGGTTAGAGCTAGAAATAGCA	1	bc
AAGTTAACAA	GAAACACCGGTTGGCTTTACTCCTTTGTGGGGGTAAGACTATGAATAGCC	1	bc
GCCTCAAGCA	GAAACACCGGTGAGGATAGAGCTAGAAATAGCAAGATCACCTAAGACTAG	1	bc
ATTAGATATA	GAAACACCGGTGGGGTTAGAGCTGGAGAGAGCAAGTTAACATAATGCTAT	1	bc
TTCCAACAGT	GAAACACCGGTGTGCGGAGATTATGCGTGGGAAATAGCAAGTAACCTAAG	1	bc
GCCACAAACA	GAAACACCGGTGGGGTTAGAGCTAGAAATAGCAAGTTAACCTAAGGCTAG	1	bc
GGCGCTGCCT	GAAACACCGGTTCCCGTTAGCTCGTGGGGTTAGAGCTAGAAATAGCAAGT	1	bc
CCGTCGAAAC	GAAACACCGGTTGGATTTACTTCTTTTAGGCGTTGGATTAATACATAACA	1	bc
CCCACCCACA	GAAACACCGGTTCAACCAGCGTTTCAGGTAGGATTAGAAATATAAACAAC	1	bc
GGCACTTCAA	GAAACACCGGTACCAGTTAGCTCGGGGGGGTAGAGCTAGTAATAGCAAGA	1	bc
AGAACGGTCC	GAAACACCGGTGCTCGTAGTGGGGGTTAGGGTTAGAATCGCCAATTAACC	1	bc
GTATAAAAGA	GAAACACCGGTGTTCGGAGATAATTCGTGAGAAATAGCAAGTAACCTAAG	1	bc
AAATCCGTCG	GAAACACCGGTGGGAGTAGCGCTAGAAGTGGTAAGAAAAGCAAGGGATAG	1	bc
TAAATAACAT	GAAACACCGGTTTAGTTAATTAAATAGTGGGGTTGAAGCTGGAAACGTAA	1	bc
GAAAGGTCTA	GAAACACCTGTGGGGGTGAAGCTAGAAAGGGCGAGTTAACCAAAGAATAG	1	bc
AGATCATTAA	GAAACACCGGGGTTAGAGCTAGAAATAGCAAGTTAACCTAAAGATAGACC	1	bc
AACTACGTCA	GAAACACCGGTACTAGTAACTTAAGGGTGGGGTTAGAGATAGAAATAGCA	1	bc
GAACAGCAAA	GAAACACCGGTGTTATTAGTGAGGTTAGAGGGATAGAGAGAAAATTAACC	1	bc
ATGCAGGAAC	GAAACACCGGTCTTCTTGGCGGGGGTAAAGCCAGGAATAACCAGTTAAAC	1	bc
TGTTAAGAAT	GAAACACCGGTCTTCCTGGAATCCGTGTGGTAGAGCTAGAAATATCAAGT	1	bc
CCCTTACCGA	GAAACACCGGTGTGCTGAGCTTATTCGTGGGGTATAGCATGTAACCTACG	1	bc
GGTATATCTA	GAGACACCGGTGGGCGTTGGACGGTTTGGGGTTAGAGCTAGAAATAGCAA	1	bc
TTCTCCAGTT	GAAACACCGGTCTTGCGGGAATGCGGGTGGTAGAGCTAGAAATAACAAGT	1	bc
TCCCCAGGTT	GAAACACCGGTCTTCCTGGAATCCGTGGGGTAGAGCTAAATAGCAAGTTA	1	bc
AATACAGATC	GAAACACCGGTGACAAACGTATGTCAGTGGGGTTAGAGCTGGAAATGGCA	1	bc
GGGGGCGAAC	GAAACACCGGTGATCTTGGTTAGAGCTAGAGGTAGCAAGTTAACCTAAGG	1	bc
AGTAAAGTCG	GAAACACCGGTGCCCTTGATGTGACCGTGGGGTTAGAGCTAGAAATATCA	1	bc
CGGCAGACAC	GAAACACCGGTGTTCTTGGTGGGGTTAGAGCTAGAAATAGCAAGTTAACC	1	bc
CTACTGAAAC	GGAACACCGGTGGTGTTGGTGAGGTTAGGGCTAGAAATAGGAAGTTGAAC	1	bc
TCATTCCTAA	GAAACACCGGTGATAATAGTTCGCTCGTAGGGTTAGAAATAGAAATAGAA	1	bc
ATGCAGCAAG	GAAACACCTGTGCTCGTTGCTGGGTTAGGGGTTGAAAGCGAGAGATAACC	1	bc
TGCACTGATT	GAAACACCGGTTCCCGTTAGATCGTGGGGTTAGAGCTAGAAATAGAAAGT	1	bc
GAGCGCTCGA	GAAACACCGGTGAGTGGGGTTAGAGCTAGAAATAGCAAGTTAACCTAAGG	1	bc
AATTCATCCG	GAAACACCGGTGTTAGTAGATGGTGAGTGGGGTTAGAGCTAGAAATAGCA	1	bc
AGACCACGAC	GAAACACCGGTGATCTTGGTGGAGTTAGAGGTAGAAATAGAAAGTTAACC	1	bc
TTCTACCCGT	GAAACACCGGTCTGCGGAGATTATGCGTGAGAAATAGCAAGTAACCTAAG	1	bc
GCGTGCGCGA	GAAACACCGGTGAGTGTGGCTAGAGCTAGAAATAGCAAGTTAAACTAAGG	1	bc
AGACACCACG	GAAACACCGGTGCTCGTGGCTGGGGTAGGGGTAGAAATAACAAAGTAACC	1	bc
AACATGCTAG	GAAACACCGGTTTTCGATCATAGGTGGGGTTAGAGCTAGAAATAGCAAGT	1	bc
ACCAAACGGT	GAAACACCGGTGGGGGGAGAGCGAGAGATAGCAAGTTAACCTAAGGTAAG	1	bc
AACCTCCTGA	GAAACACCGGTTTGCGATGATGGGTCGTGGGAAGAAACATCTAATTTACC	1	bc
AAACCAGTGG	GACACACCGGTTTAGTATGTGGGGTTAGGGCTAGAAATAGCGAGTTAACC	1	bc
GTAGCCGACA	GAAACACCGGTTAGTGGGGTTAGAGCTAGAGATAGCAAGTTAACCTAAGG	1	bc
AGTCGAGCAG	GAAACACCGGTGACAAACGGATGTCAGTGGGGTTAGAGCTAGAAATAGCA	1	bc
TCATGCATCC	GAAACACCGGTAGAATGGAACCACAAGTGGGGTTAGAGCTAGAAAGAGAA	1	bc
AAAACCATCT	GAAACACCGGTTTCGCGTGGGGTAGAGCTAGAAATGGCAAGTTAACCTAA	1	bc
CAATGAAATA	GAAACACCGGTGCTAGTGGTTACTTCGTGGGGATAGAGCTAGAAATAGCA	1	bc
AATCAACAAC	GAAACACCGGTGTTCTTGGTGTGGTTGGGGCTATAGATATCAAGTTAACC	1	bc
ATCCCATCCC	GAAACACCGGTCACGAACGTGTGTCGGTGGGGTTAGAGCTAGAAATAGCA	1	bc
TATACACTCT	GAAACACCGATAATCTAAGAATCTCCGTGGGGATAGAGCTAGAAAAAGCA	1	bc
AACTATCCCG	GAAACACCGGTGCGCGGAGATTATGCGTGAGAAATAGCATGTAACCTAAG	1	bc
ATGAAAGCGG	GAAACACCGGTGCCAGAAGCTGAGGCAGGGGTAAAAACAAGTAACCTAAG	1	bc
GCATCAGAAG	GAAACACCGGTTTTGGTAGATGGAGAGAGGGGATGTTAATCGAAATCGCG	1	bc
AGACCGTCCC	GAAACACCGGTGTTCTTGGTGGGGTTGGGGCTAGAAATAGCAAGTTAACC	1	bc
GCGGGAGAGC	GAAACACCGGTGAGTGGGGTTAGAGCTAGAAATAGGAAGTTAACCTAAAG	1	bc
ACTGCACAAA	GAAACACCGGTGGCAATTCGATCTGAATGGGGTTAGAGATAGAAATAGCA	1	bc
GATTAACTCA	GAAACACCGGTTGTCTTACGATCTGAGTGGGGTTAGATCTAGAAATAGCA	1	bc
GATCCAACCC	GAAACACCGGTGGGGTTCGAGCTTGAAATAGCTAGTTAACATAAGGATCG	1	bc
TTAATCGTCC	GAAACACCGGTCCTAGTAGTTGGGAAAGAGCTAGAAGTAAGAAATTGACC	1	bc
GTCATTTCTT	GAAACACCGGTTGGGGTTGAGTTGTAGATGGGATGTTACTAGAAGGCGAG	1	bc
CCAAGCTACA	GAAACACCGGTGGGATGATAGAGAGAAAAATAGCGTGAACATATGAGTAG	1	bc
GAATAACCCC	GAAACACCGGTTTTCGTAGATGGTGGGGCTAGAATTAGAAATATCATCTT	1	bc
ATACAGTATC	GAAACACCTGTGTTCTCGGTGGGGTAAGAGTTGGAATTAGCAGGTTAACT	1	bc
GTGTAAGAGA	GAAACACCGGTGAGCGGAGATAGAGCTAGAGATATCAAGATAAACTTAGG	1	bc
TTCCAAAAGC	GAAACACCGGTGGGGTTAGAGCTAGAAATAGCAAGTTAACCTAAGGCTAG	1	bc
CGTACAGATG	GAAACACCGGTCTGCCTGGAATTCGTGGGGGAAAGCTAGACATAGGAAGT	1	bc
CAGTAATATA	GAAACACCGGTGGGGTTAGAGCTAGAAATAGCAAGTTAACCTAAGGCTAG	1	bc
TACTGCGGCC	GAAACACCGGTTGAGGGGATCCACGGGTGGGGGAAGGGTTAAAATAAGCA	1	bc
AGACCTTACC	GAAACACCGGTTCCCGTTGGCTCGTGGGGTGAGTGCTGGTAGTAGCAGCA	1	bc
AGATCAGACG	GAAACACCGGTTTTAAAAGATGGTTTGTGGGGTTCGAGCTAAAAATAGCA	1	bc
GACCGTCGAC	GAAACACCGGTAATAAATACCTACGGGTGGGGTTAGAGCTAGAAATAGCA	1	bc
CCAGCCGCCC	GAAACACCGGTAGAATGGATCCACGGGTGGGGTTAGGGCTAGAAATAGCA	1	bc
AGATCACACA	GAAACACCGGTGAGAACAGATCGTTTTGGGGTTAGAGCTAGAAATAGCAA	1	bc
CCAGCCGCCC	GAAACACCGGTAGAGTGGATCCACGGGTGGGGTTAAGCCTAGAAATAGCA	1	bc
TGACCAATTT	GAAACACCGGTTTTCCTTGGATCCGTGTGGTAGTGCTGGAAAAACCTAGT	1	bc
TCCAAATCCT	GAAACACCGGTGGCGTTAGAGCTAGAGATAGCAAGTTAACCTAAGTCTAC	1	bc
TTGACCCTAG	GAAACACCGGTCCTAGAAGCTGGGTTAGGGCTAGAAATATCAAGTTAACC	1	bc
AAATCAGTAG	GAAACACCGGTTTTAGATCATGGTGCGTGGTGTTAGAGCTAGAAATAGCA	1	bc
TTCTTGGCAA	GAAACACCGGTTGTGGGGGACTCGAGGTGGAAGAAATAAGTAGTTAACAG	1	bc
GTGGCCTCGA	GAAACACCGGTGAGCTGCCTCAAGTGCTGGAAATAGCAAGTTAACCTGAG	1	bc
TAATCCCTCA	GAAACACCGGTGAAGCGAGGGTTAGAGATAGATATCGCAAGTTCCCATAG	1	bc
GATGGCGCGA	GAAACACCGGTGAGTGGGGTTAGAGCTAGAAATAGCAAGCTAACCTAAGG	1	bc
CCGAAAACCC	GAAACACCGGTTGGCTGAACTCCTATGTGAGGTTAGAGCTATAAAGATCA	1	bc
TGTTCATACA	GAAACACCGGTTCCAGTTAGATCTGAGTGGGGTTGGGACCAGAAAAAGCA	1	bc
ATCTCCTTCC	GAAACACCGGTCCTAGAAGCTGGGTTAGAGGTATAAATAGCAAGTTAACC	1	bc
TCACTAATCT	GAAGCACCGGTGGGTTTAGCTCTAGAAATTGCGTGATCAACTTGGTCTAG	1	bc
CACTAGCAAC	GAAACACCGGTTCAAGATAGAAATAGCAAGTTAACCTAAGGATAGTCAGT	1	bc
TGGACAAGCT	GAAACACCGGTTATCGTTAGGTCGTGGTGGGGTAGCTAGAAGTAACAAGT	1	bc
TATCTACCCC	GAAACACCGGTGATCTAAGATTATGCGTGAGAAATAGCAAGTAACCTAAG	1	bc
TACTATTAAG	GAAACACCGGTACTAGGGGCTTACGGGAGGGGTTAGAGCTAGAAATAGCA	1	bc
ATGACTGTAA	GAAACACCGGTCCTAGAAGCTGGGTTAGGGCTAGAAAGAGCGAAATAACC	1	bc
