TAATTAATCC	GAAACACCGGTTGAGATAATCAAAAAGTGGGGTAGAGCTAGAAATAGCAA	5	bc
GAGTCAAGCG	GAAACACCGGTTATCGTTACGGATTTGTGGGGTTAGAGCTGGAAATAGCA	3	bc
CCCCCGAACA	GAAACACCGGTTCAACCGGCGTGGGGTTAGAGCTAGAAATAGCAAGTTAA	2	bc
AACATGCTAG	GAAACACCGGTTTTCGATCATAGGTCGTGGGGTTAGAGCTAGAAATAGCA	2	bc
AAACCCCAAA	GAAACACCGGTTTAGTTAGGAGGGAAGTGGGGATAGAGCTAGAAACAGCA	1	bc
AAGTGAGTCA	GAAACACCGGTTGTAGAAGACGCGGTGGGGGAGGAATAGCAAGGTAACCC	1	bc
ACCTAGCACA	GAAACACCGGTACAAGTGGCGTGGGGGTGGGGCTAGAAATAGAAAGTTAA	1	bc
ATAAGCAAAA	GAAACACCGGTGGGGTTAGAGCTAGAAATAGCAAGGTAACATAAGGCTAG	1	bc
GATTGCGAGA	GAAACACCGGTGTTATGCCTCAATGGGGGTTAGAGCTAGAAATAGCAAGT	1	bc
TAATTAATCC	GAAACACTGGTTGAGATAATCAAAAAGTGGGGTAGAGCTAGAAATAGCAA	1	bc
GAGCAAATAC	GAAACACCGGTGGCAGCAGGCCATTTGTGGGATAAAGCAAGGAAACAAAA	1	bc
ATGACCGTCG	GAAACACCGGTTCTAGAAGCGGAGTTGGGGGGGGTAGTGCTAGAATTAGC	1	bc
ATACTATAAC	GAAACACCGGTGAGCATGATAACGTCGGTGGGGTTAGAGCTGGAATTAGC	1	bc
GAAATCTTCC	GAAACACCGGTAATCTAAAGATCCCCGTTTGGACAGGGCTTGACATAGCA	1	bc
AGGACCTACG	GAAACACCGGTGCCAGCAGCCCACTTGTGGGGTTAGAGCTAGAAATAGCA	1	bc
CTGCTATTTA	GAAACACCGGTCGGCGTGCGCAAGGCGTGGGGTGAGAGCTTGAAATAGCA	1	bc
TACACCTACT	GAAACACCGGTTTCCTTAGTTAACTAGTGGGGTTAGAGCTAGAAATAGCA	1	bc
GTACTGTAAA	GAAACACCGGTGAGCATGATAACGTCGGTGGGGTTAGAGCTAGAAATAGC	1	bc
GAAATCTAAT	GAAACACCGGTGAACATAATAAAGTACGGGGGTTTAGAGTTAGAAATAGA	1	bc
GCATTCAGCA	GAAACACCTGTGCTAATAGTTAGCTCGTGGGGTTAGAGCTAGAAATAGCA	1	bc
GCCTCAAACC	GAAACACCGGTTCAACCGTCGTGAGGTTAGAGCTAGAAATAGCAAGTTAA	1	bc
CCTTGAGCAA	GAAACACCGGTTGTGGGGAACTCGGTGTGGGAGAGATAGCCAGTTAACCT	1	bc
GAACTAAATT	GAAACACCGGTGCTCCTAGATTGCTCGTGGGGTAAGGCTTAGAATAGCAA	1	bc
AAACCCCACA	GAAACACCGGTTTAGAATGGTGGTTTGTGGGGGTAGAGCTAGATTTAGCA	1	bc
CAACGCGAAA	GAAACACCGGTGGGGTTAGAGCTAGAAATAGCAAGTTAACCTAAGGCTAG	1	bc
CCACACCAAC	GAAACAACGGTAGAATGGATCCACGGGTGGGGTTAGAGCTAGAAATAGCA	1	bc
GGAACTTATT	GAAACACCGGTTCGCATGATCACGTAGGGGGGATAGAGCGAAAGATAACA	1	bc
CGCACTTCAC	GAAACACCGGTTCCCGTTAGCCCGTTGTGGGGTTAGAGCTAGAAATATCA	1	bc
ACTGCAACAA	GAAACACCGGTGGGGTTAGAGCTAGAAATAGCATGTTAACCTAAGGCTAG	1	bc
CAACGCGAGA	GAAACACCGGTGCAATCGGTTTCGTTGTAGGGATAGAGAGATAAATAACA	1	bc
TTCTTCTCCC	GAAACACCGGTCGCGAGAATGTGCCGGTGGGAATTGGGCTAGAAACAGCA	1	bc
TAATTAATCC	GAAACACCGGTTGAGATTATCAAAAAGTGGGGTAGAGCTAGAAATAGCAA	1	bc
CACTCGGTCA	GAAACACCGGTACAACTGACGTGGGGGTAGGGCTAGAAATAGAAAGATAA	1	bc
GGATATCAAC	GAAACACCGGTGTTCTTTGCTCGAGGGTGGGGTTAGAGCTAGAAATAGCA	1	bc
GAAAAATACC	GAAACACCGGTGATCTAGAGAACGCCCGGGGGGTTAGAGCTAGAAATAGC	1	bc
GCAGACGACG	GAAACACCGGTGGCAGCCAGGCAAGAGTGGGGTTAGAGATAGAAATAGCG	1	bc
ATATAACAGC	GAAACACCGGTGTGCGGAGATTATGCGTGGGAAATAGCAAGGAACCTAAA	1	bc
CCCTCTGACA	GAAACACCGGTTCAACCGGCGTGGGGTTAGGACTAGAAATAGCACGTTAA	1	bc
GACACATCCT	CTAAACACCGGTTACCGTTAGCTCGTAGTGGGTTTAGAGCTAGAAATAGC	1	bc
GTACAACACA	GAAACACCTGTTGTAAGCGATAGCTTGTGGGGGTAGAGCTAGAAATAGCA	1	bc
GTGTGATAGA	GAAACACCGGTGAGATGACTCAAGTGGGGTTAGAGCTAGAAATAGCAAGT	1	bc
AATTGAACAC	GAAACACCGGTTGAGGTAATCTAGGTGTGGGGGAGAGCGAGAAATAACAA	1	bc
AAAAACATGC	GAAACACCGGTTTAGTATGGAGGGAAGTGGGGTTAGAGCTAGAAATAGCA	1	bc
GACTCGCCCC	GAAACACCGGTTCAACCGGCTTGGGGGTGGAGCTAGAAATAGCAAGTTAA	1	bc
ATGACAATTT	GAAACACCGGTGAGCATGATAACGTCCGGGGGGTTGGAGCTAGAAATAGC	1	bc
CCCTCACCGC	GAAACACCGGTTTACCGAGCGTGTGGTTGGAGCTTGGCAAGGCACCTTAG	1	bc
CACCGTGCGT	GAAACACCGAGGCTATTTGTTTCGACGTGGGGTTAGCGGTAGAAAGAGCA	1	bc
GACTGAGAAA	GAAACACCGGTACTAGTTACTTACGGGTGGGGTTAGAGCTAGAAATAGCA	1	bc
TACTCCCAAA	GAAACACCGGTTTACTTAGTTAACTAGTGGGGTTAGAGCTAGAAATAGCA	1	bc
AATTTATTAA	GAAACACCTGTACTAGTTACTTACGGGTGGGGTTAGAGCTAGAAATAGCA	1	bc
AACTCAGTAA	GAAACACCGGTAATAGATACTTACGGGTGGGGTTAGAGCTAGAAATAGCA	1	bc
ATCACACAGA	GAAACACCGGTGTGCGGAGATTATGAGTGAGAAATAGCAAGTAACCTAAG	1	bc
ATACTAAGAT	GAAACACCGGTGGTAAGCGATAGCTTGTGGGGTTAGAGCTAGAAATAGCA	1	bc
GAGTCAAGCG	GAAACACCGGTTATCGTTACGGATTTGTGGGGTTAGAGCTAGAAATAGCA	1	bc
AAATCTGTAA	GAAACACCGGTACTAGTTGCTTACGTGTGGGGTTAGAGCTAGAAATAGCA	1	bc
CATTGAGCTT	GAAACACCGGTTCTCGCGGTTTCGGTGTGGGGGTAGAGCTAGAAATAGCT	1	bc
CTGGGGGCTG	GAAACACCGGTGAGATGCCTCAAGTGGGGTTAGAGCTAGAAATAGCAAGT	1	bc
ATAACAGTCT	GAAACACCGGTTGTAAGCGATGGTTTGTGGGGTTAGAGCTAGAAATAGCA	1	bc
GCAAAACACT	GAAACACCGGTGGTCGCCGTGGAGAGGTGGGGTTAGAGCTCGAAATAGAA	1	bc
GACTCGCACA	GAAACACCGGTTCAACCTACGTGGGGTTGGGGCTAGAAATAGCAAGTTAA	1	bc
GAATTCCAAT	GAAACACCGGTGCTCATAGTTAGCTCGTGGGGTTAGAGCTAGAAATAGCA	1	bc
ATAAACCCAG	GAAACACCGGTTTACTTAGTTAACTAGTGGGGTTAGATCTAGAGATTGCA	1	bc
AACACGTCCT	GAAACACCGGTTCCCGATAACTCGTAGTGGGAGTAGTAGTAAGAATAGCT	1	bc
AGGCAACTAA	GAAACACCGGTGGCAGCCAGCCACTTGTGGGGTTAGAGCTAGAAATAGCA	1	bc
GCATCAACAA	GAAACACCGGTTTTAGTAGATGGAGAGAGGGCATAGTGATCTAAAGCGAG	1	bc
TATTCCCCAA	GAAACACCGGTTTACTTAGTTAACTAGGGGGGTTAGAGCTAGAAATGGCA	1	bc
ATGAAAGCGG	GAAACACCGGTGTGCGGAGAATATGCGAGGGAAACAGCAAGTAAGATAGT	1	bc
TTCTTCCCCC	GAAACACCGGTTGCAAGCGTTGGCTTGTGGGGTTAGAGCTAGAAATAGCA	1	bc
AACCTGCTAG	GAAACACCGGTTTTCTATGATGGGACGTGGGGTTAGAGCTAGAAATAGCA	1	bc
AACTACGTGA	GAAACACCGGTACTGGTTGCTTACGTGGGGCTAGAGAGATCAAGATAACA	1	bc
TCACCACACA	GAAACACCGGTGGGGATAGAGCTAGAAATAGCAAGTTAACCTAAGTCTAG	1	bc
CTCTGAGCTA	GAAACACCGGTGCGCGGAGATTATGAGTGGGAAATAACCAGGAACCTACA	1	bc
CGCTAATCCA	GAAACACCGGTGCTAGGAATCCAAGGTTGAGCTAAGACTAGTCAGTTATC	1	bc
AATTGCGTCA	GAAACACCGGTTGTGGGAGCCTCGGTGTGGGAGAAATAGCAAGTTAACCT	1	bc
CAACACTACG	GAAACACCGGTGCTAGCGGGCCACTTGTGGGGTTAGAGCTAGAAATAGCA	1	bc
GAACCAGACT	GAAACACCGGTCCTGCTGGAGTCTACGAGGGCAAGAGATATAAAGAGCAA	1	bc
CATCCATAAT	GAAACACCGGTGACAAACGCATGTCAGCGTGGTGCGAGCTCGAAATAGCC	1	bc
ATGCCAACCT	GAAACACCGGTTGTAAGCGCTGGTTTGTGGGGTTAGAGCTAGAAATAGCA	1	bc
TAATATAAAA	GAAACACCTGTGGGGTTAGAGCTAGAAATAGCAAGTTAACCTAAGTCTAG	1	bc
AACCGAGCTT	GAAACACCGGTGTGAGGAGTTTATGCGTGAGGATAAAGAAAGAAATAAAG	1	bc
CCACGGCATT	GAAACACCGGGGGGGGTGGGAGCTAGGAGTAGCAAGAGCTACTAAGGGTA	1	bc
CCCTCGCCAA	GAAACACCGGTTCAACCAGCGTGGGGTTAGATCTAGACATAACAAATTAA	1	bc
AACCGATGAC	GAAACACCGGTGACAAACGTATGTCAGTGGGGTTAGAGCTAGAAATAGCA	1	bc
ATGACCGTCG	GAAACACCGGTCCTAGAGGCTGAGTTGTGGGGTTAGAGCTAGAAATAGCA	1	bc
TAAGCAAACT	GAAACACCGGTGCTAGCGGAGCTAGAGAGGGGATAGAGATAGAAAGCGCA	1	bc
GCATTACAAC	GAAACACCGGTGCTAATAGTTAGCTCGTGGGGTTAGAGCTAGAAATAGCC	1	bc
CCCTGACGCA	GAAACACCGGTAGGAAGGATTTATGAGTGGGGTTAGAGCTAGAAATAGCA	1	bc
AAATCTCAAT	GAAACACCGGTACTAGTTACTTACGGGTGGGGTTAGAGCTAGAAATAGCA	1	bc
AATATCTCAA	GAAACACCGGTTCCCTTTATTTGACCGTGGGGTTAGAGCTAGAAATAGCA	1	bc
GGGCGCGTGG	GAAACACCGGTGATCTTTCGGCTGGCGTGGGGATAGAGCTAGAAATAGCA	1	bc
TTTTGCGCCC	GAAACACCGGTTGTGGAAAAGTCGGTGTGGGGGAAATGGTAAAAAAAGCA	1	bc
AAATCAGTAA	GAAACACCGGTACTAGTTACTTACGGGTGGGGTTAGAGCTAGAGATAGCA	1	bc
AAGTAAAGCG	GAAACACCGGTGGGCGTTAGAGATACGAGTGGCAAGTTAACAACATAAGA	1	bc
TTCTTCCAAC	GAAACACCGGTGGCGATTGCTCGCGGGTTGGGTTAGAGCTAGAAATAGCA	1	bc
TAAGCAGATT	GAAACACCGGTGCGAGTGGTTCTGAAGAGGGCATAGTGCTAGAAATAGCA	1	bc
ATGACAGTCG	GAAACACCGGTGCCAGTTGGTTCGTAGGGGGGGTAGAGCTTAGAATAGCA	1	bc
TCATCGACAA	GAAACACCGGTGGGGGTGGAGCTAGTGAGGGCGAGTTAACCTAATGCTCG	1	bc
ATCCAACACA	GAAACACCGGTTGTAAGCGATGGTTTGCGGGGTTAGAGCTAGAAATAGCA	1	bc
ACATCGCACA	GAAACACCGGTTGAAGGGGACTCGGTGTGGGGGTAGTAGCAAGATAACCA	1	bc
AACATGCTAG	GAAACACCGGTTGTCAGCGATGGGTTGTGGGGTTAGAGCTAGAAATAGCA	1	bc
AATACCTAAG	GAAACACCGGTGGCAGACGTCTACTTGGGGGGGTAGAGGCTGGAAATGCC	1	bc
TGTGAGCGAG	GAAACACCGGTGGGATGCCTCAAGTGGGGTTAGAGCTAGAAATAGCAAGT	1	bc
CCCAATCACT	GAAACACCGGTGAGCATGATAACGTTAGAGCGAGAAATAGCAAGTTAACC	1	bc
AAATCGCACT	GAAACCCCGGTTCCACCGGCGTTGGGGTGGAGCTAGAAATAGCAATATTA	1	bc
CTCCGAGCTG	GAAACACCGGTCGTCGGTCGTTGTGCGTGGGGATAGAGCTAGAACTAGCG	1	bc
GGCACTTACA	GAAACACCGGTTAGTGGGGTTACATATAGGGATTAGATCTTGAAATAGGA	1	bc
GTCTACCCAA	GAAACACCGGTACTAGGTACTTACGGGTGGGGTTAGAGCTATAAATTGGA	1	bc
ATCTAACATG	GAAACACCGGTCTGCGGTCGTGGGGTTATAGCTATAAATAGCAACCTAAC	1	bc
TGACAATGTA	GAAACACCGGTACTGGTTACTTACGGGTGGGGTTAGAGCTAGAAATAGAA	1	bc
TCCCTCCTCC	GAAACACCGGTAGAGTGGATCCACGGGTGGGGTTAGAGCTAGAAATAGCA	1	bc
CCATCGCATT	GAAACACCGGTTCAAGAGGCGTGGGGTTGGGGCTAGAACTAGAAAGAGGA	1	bc
GTAAGAGAGA	GAAACACCGGTGAGCATGATAACGTCCGTGGGGTTAGAGCTAGAAATAGC	1	bc
AGCCAGCCAA	GAAACACCGGTGTTCTTTGCTCGAGGGTGGGGATAGAGCTAGAACTAGCA	1	bc
TCAACATATA	GAAACAACGGTGAGCATAGTGCTAGAAATGGCGATATAACTAGAAGTTGG	1	bc
CCGTGGCAGA	GAAACACCGGTTCAACCGGCGTGGGGTGAGAGATAGAAATAGAAAGTTAA	1	bc
ATATCAGAAT	GAAACACCGGTTGTAAGCGATGGCTTGTGGGGTTAGAGCTAGAAATAGCA	1	bc
GCACTATCTC	GAAACACCGGTGATCATGATAACGTCCGTGGGGTTAGAGCTAGAACTCGC	1	bc
AAATCACACA	GAAACACCGGTTGTAAGCGATGGTGTGTGGGGTTAGAGCTAGAAATAGCA	1	bc
TAACCACATT	GAAACACCGGTTTTCTTGGATTCGTGGTGGAGAGATAGATATAACTAGCA	1	bc
TCCCGCGGTT	GAAACACCGGTCTTCCTGGAATCCGTGGGGTAGAGCTAGAAATAGCAAGT	1	bc
CTTCCCAAAC	GAAACACCGGTGGCAATTCGATCTGAGTGGGGTTAGAGCTAGAAATAGCA	1	bc
AAATCGGCCA	GAAGCACCGGTTGTGGGGGACTCGGAGTGGGCGAAATAGCATGTTAACCC	1	bc
GCAGCAACCA	GAAACACCGGTTTGAGTAAATGGAGAGAGAGGATAGAAATATAAAGAGAA	1	bc
CACCTCAGCC	GAAACACCGGTAGAATGGATCCACGGGTGGGGTTAGAGCTAGAAATAGCA	1	bc
GGCTCTTCCC	GAAACACCGGTTCCCGTTACTTCGTAGTGGGGTTAGAGCTAGAAATAGCA	1	bc
AGCCAGTAAG	GAAACACCGGTGGTCTCTGCTCGAGGGTGGGGTTAGAGCTAGAAATAGCA	1	bc
AATTCATTCC	GAAACACCGGTGACAAACGTATGTCAGTGGGGTTAGAGCTATAAATAGCA	1	bc
GAAAGCGAGA	GAAACACCGGTGATCTTTGTAAGAGGGTGGGGTTAAAACTAGAAATAGCA	1	bc
ATACTATTTA	GAAACACCGGTGTAGATGGTAACGTTCGAGCTGGTAGTGCTAGGTATAGC	1	bc
ATAACCGTAT	GAAACACCGGTTTATTTAGCTAACTAGTGGGGGTAGAGCTAGAAATAGCC	1	bc
AACCCTTCCC	GAAACACCGGTGACCAACGTATGTCAGTGGGGATAGAGCTATAAATCGCA	1	bc
GTGGTCTATA	GAAACACCGGTGAGAGGCGTTAGATGGGGTTATAGCTAGATATAGCAAGG	1	bc
CTATCTAACC	GAAACACCGGTGTGCGGAGATTATGCGTGAGAAATAGCAAGTAACCTAAG	1	bc
GATATATACG	GAAACACCGGTGAGCATGATAACGCCGGTGGGGTTAGAGCTAGAAATAGC	1	bc
GAGTCTGTAC	GAAACACCGGTACTGGTTACTTAAGGGTGGGGTTAGAGCTAGAAATCAAA	1	bc
CCAACCCACG	GAAACACCGGTAGAATGAATTCACGGGTGGGGTTGGTGCTAGAAATAGCA	1	bc
TTATCATCCT	GAAACACCGGTTTTAGTAAATGGTGTGTGGGGTTAGAGCTAGAAATAGCA	1	bc
GACTCTTCAC	GAAACACCGGTACCAGTTACTTGTCAGTGGGGTTAGAGCTAGAAATAGCA	1	bc
GGCTATTTCG	GAAACACCGGTGGCAGTCAGCTACTTGTGGGGTTAGAGCTAGAAATAGCA	1	bc
ATGACCGTCG	GAAACACCGGTCCTAGAAGCTGAGTTGTAGGGTTAGAGCTAGAAATAGCA	1	bc
ACATCCATGC	GAAACACCGGTTTAGTATGGAGGGAAGTGGGGTTAGAGCTATAAATAGCA	1	bc
AATGCAAAAC	GAAACACAGGTGACAAACGAATGTCAGATGGGTTAGAGCTAGAAAGAGCA	1	bc
TAAGGAAAGA	GAAACACCGGTGGGGTTAGAGTTAGAAATAGGAAGTTAACATAAGGCTAG	1	bc
TCGTTCATCC	GAAACACCGGTGAGCATGATAACGTCTGTGGGGATAGAGCTAGAAATAGC	1	bc
GCGGGCGTGT	GAAACACCGGTGAGATGCCTAAAGTGGGGCTAGAGCTAGCAATAGCAAGT	1	bc
GAATAACAAC	GAAACACCGGTGCTAATAGTTAGCTCGTGGGGTTAGAGCTAGAAATAGCA	1	bc
GAGTCCGACC	GAAACACCGGTTCAAGCTGGGTGGGGCAAGATTTCCTAATAGTAGGCTAA	1	bc
AGTACATCCT	GAAACACCGGTTACCGTTATCTCGTAGTGGGGTTAGAGCTAGAAGTAGCA	1	bc
AACTAACCCG	GAAACACCGGTGTGCGGAGATTATGAGTGGGATAAAGCAAGGAAACAGAG	1	bc
ATAAACACAA	GAAACACCGGTTTACTTAGTTAACTAGTGGGGTTAGAGCTATAAATAGCA	1	bc
CCTAACGACG	GAAACACCGGTGCTAGCGGTTTCGAAGTGGGGTTAGAGCTAGAAATAGCA	1	bc
GGAGACTACC	GAAACACCGGTGGCAGCCAGCCACTTGTTGGGTTAGAGCTAGAAATAGCA	1	bc
AAATGGGTCA	GAAACACCGGTTGTGGGGAACTAGGTGTGGGAGAGAGAGCAAGTTAACCT	1	bc
AAATCCCTCA	GAAACACCGGTGACAAACGTATGTCAGTGGGGTTAGAGCTAGAAATAGCA	1	bc
TATCCCTCCC	GAAACACCGGTGACAAACGTATGTCGGTGGGGTTAGAGCTAGAAATAGCA	1	bc
ATACCAGTTG	GATACACATGTTGTAAGCGATGGTTTGTGGGGTGAGAGCTAGAGATAGCA	1	bc
ATAGAAAAAA	GAAACACCGGTGTGCGGAGATTATGCGTGAGAAATAGCAAGTAACCTAAG	1	bc
AAATATGCAA	GAAACACCGGTACTAGGGAATTACGAGTGGGGGTAGAACTAGAAATAGCA	1	bc
AGACTACAAA	GAAACACCGGTGTTCTTTGCTCGAGGGTGGGGTTAGAGCTAGAAATAGCA	1	bc
TCAATCTTTT	GCAACACCGGTGACCCTATTACCGGGTTAGAGCTAGAAATAGCAAGTTAA	1	bc
AGCAACCCCA	GAAACACCGGTGGGAGCCGGCCATTTGTGGGGATAGAGATAGAAATAGAG	1	bc
AACATGCTAG	GAAACACCGGTGGCAGATAATCACTCGTGGGGTTGGAGCTAGAAATAGCA	1	bc
TGTACCCATT	GAAACACCGGTTTACTTAGTTAATTAGTGGGGTTAGACTTAGAAATAGAA	1	bc
CTCACGCACA	GAAACACCGGTTCAACTAGCGTGGGGTTGGAGCTGAGAAAATAAAGCTAA	1	bc
TGCACATAGT	GAAACACCGGTTTTCGTTGAATCGTCGTGGGGAGAGAGATATAAATAGCT	1	bc
TAATTAATCC	GAAACACCGGTTGAGATAATCAAAAAGTTGGGTAGAGCTAGAAATAGCAA	1	bc
AATTCGCTAA	GAAACCCCGGTGGCAATTCGATCTGAGTGGGGTTAGAGCTAGAAATAGCA	1	bc
TCCTTACTCC	GAAACACCGGTTCAACTGGTGTGGGGTTAGAGCTAGAAATAGCATGTCAA	1	bc
ACCATGAAAA	GAAACACCGGTACTAGTTACTTACGGGTGGGGTTAGAGCTATAAATAGCA	1	bc
AAACCACCAT	GAAACACCGGTTTAATTAGTTAACTAGTGGGGTTAGAGCTAGAAATAGCA	1	bc
ACATCCGTGA	GAAACACCGGTTCAACAGGCGTGGGGTTAGATCGAGAAATAACAAGTTAA	1	bc
CAACCATTAT	GAAACACCGGTGACAAACGTATGTCAGTGGGGTTAGAGCTAGAAATAGCA	1	bc
AAAATCTTTA	GAAACACCGGTTTAGAATGGAGGGAAAGTGGGGTTAGAGCTAGAAATAGC	1	bc
TGCTTTTCCC	GAAACACCGGTTCCCGTTAGCTCGTTGTGGGGTTAGAGCTAGAAATAGCA	1	bc
GCAAAAAAAA	GAAACACCGGTGGGGTTAGAGCTAGAAATAGCAAGTTAACCTAAGGCTAG	1	bc
AAAATGTTAA	GAAACACCGGTGATCGTTCTTACGTCGGGGGGGTTGGGGCTGAAATAGGA	1	bc
GTCTTTTATA	GAAACACCGGTACTAGTTACTTACGGGTGGGGTTAGAGCTAGAAATAGCA	1	bc
CCATCACACA	GAAACACCGGTTCGGTTAGCGCTATATGTGGCGTTATAACCTGAAGCTGG	1	bc
TCTCGCACCC	GAAACACCGGTTCAGCTGGCGTTGTGTTAGAGCTATAAATAGCAAGCTAA	1	bc
AAATTAATGA	GAAACACCGGTTTTCTTTGGAGGGAAGTGGAGATAGAGCTAGAAACAGTA	1	bc
GGCACCTCGA	GAAACACCGGTTCCCGGTAGCTCGTAGTGGGGTTAGAGATAGAAACAGCA	1	bc
AATTGCACGA	GAAACACCGGTTGAGGGGAACTCGGTGTTGGTGGAATAGCAAGGTAACCT	1	bc
AAATATGTGA	GAAACACCGGTACTGGGTACTTATGGGTGGGGTTAGAGCTAGAAATTGCA	1	bc
ACATCACAGA	GAAACACCGGTGGGGGGAGACTATGCGAGAGAAATAGCAAGTAACGTAAG	1	bc
CTCTAAGCGT	GAAACACCGGTGCGAGCAGATTCTGCGTGAGAATAAGCAAGGAACTAGAG	1	bc
TCATTAATCC	GAAACACCGGTGGGGTTAGTCATAGAAAGGGCAAGATCACCTAATACTAG	1	bc
TGATCAGTTC	GAAACACCGGTTTTGATAGAATATAAGTGGGGTAGAGCTAGAAAAAGGAA	1	bc
CCTTCGGCAC	GAAACACCGGTTGAGGGGACGTCGTTTGTGGGGAAATAGCTAGATAAACT	1	bc
TCATCAATCA	GAAACACCGGTGGGGTTAGTGCTAGAAATAGGAAGATAACGTAATGCTAG	1	bc
TCCTCAAAGA	GAAACACCGGTGGGGTTAGAGTTAGAAATAGCAAGATCACCTAAGGCTAG	1	bc
TAGTTAATCC	GAAACACCGGTGGAGATAATCAAAAAGAGGGGTAGAGATAGAAATAGCAA	1	bc
GAGTCCGTCA	GAAGCACCGGTACTAGTTACTTACGGGAGGGGTTAGAGCTAGAAATAGCA	1	bc
ATCACACTGA	GAAACCCCGGTACTCGGAGCTGATGGCAGATTAACAACAAGTCCCCTAGG	1	bc
ACCTCGCAAA	GAAACACCGGTTGAAGCGGAGTGGGGGTAGGGGTAGAGGTAGCAAGATAA	1	bc
ACAGCACTAA	GAAACACCGGTGGGGTTAGAGCTAGAAGTTGCAAGTTAAAATAAGCATAG	1	bc
GACTCGGAAC	GAAACACCGGTTCTACCGGCGTGGGGTTAGAGCTAGAAATAGCAAGATCA	1	bc
ATGACAGGCA	GAAACACCGGTGTGAGAAGATGATAGAAATAGCATGGCAACTTACCTCAG	1	bc
AAGTCGACCA	GAAACACCGGTTGTGGGGAACTCTGTGGGGGAGAAATAGCAAGTTAACCT	1	bc
GACTAGCAAA	GAAACACCGATACTAGTTACTTAAGGGTGGGGTTAGAGCTAGAAATAGCA	1	bc
ATGAACTTCC	GAAACACCGGTTCTCGTTAGCTAGTAGTGGGGTTAGAACTAGAAATAGCA	1	bc
TATTCCCCAT	GAAACACCGGTTGACTTAGTTAACTAGTGGGGGTAGAGCTAAAATAAGCA	1	bc
AAAACCGCAT	GAAACACCGGTGTACTTAGTTGAATCGTGGGGTTAGAGCTAGAAATAGCA	1	bc
ATCCCCCCCT	GAAACACCGGTCGAGAGCGATGGATTGTGGGGTTGGCCCTAGAAATAGCA	1	bc
AATACCGCAC	GAAACACCGGTGACAAAAGTATGGCAGTGGGGTTAGAGCTAGAAATAGCA	1	bc
GCGTTATTAA	GAAACACCGGTTGTCTTTACTAGGTGGTGGGGTTAGAGCTAAAAATAGAA	1	bc
CGTTGGGTAA	GAAACACCGGTCGTCGGTCGCAGGGTGTGGGGGTAGTGCTAGAAATAGCA	1	bc
GATATAACCA	GAAACACCGGTGCTCATTGTTAGCTCGTGTGGTTAGAGCTAGAAATAGCA	1	bc
CATCCCGTAG	GAAACACCGGTGGCAAACGTATGTCAGTGGGGTTAGAGCTAGAAATAGCA	1	bc
AAACCCTCGC	GAAACACCGGTGTCAAACGTAGGTAAGTGGGGTTAGAGCTAGAAATAGCA	1	bc
AACATGCTCG	GAAACACCGGTTTTCGATCATAGGTCGTGGGGTTAGAGCTAGAAATAGCA	1	bc
TCCAGGTCAA	GAAACACCGGTTCCCGTTAACTCGTAGTGGGGTTAGAGCTAGAAATAGCA	1	bc
ATACCAACGA	GAAACACCGGTGTGCGGAGATTATGAGTGAGAAATAGAGCGTAACATAAG	1	bc
TACTCGCAAT	GAAACACCGGTTCAATCGGCGTGGGGGTAGGGCTAGAAATAGCAAGATAA	1	bc
GAGAAAAAAA	GAAACACCGGTGATCATGATAACGCCGGGGGGGCTAGAGCTAGAAAAACC	1	bc
TCAACGGACA	GAAACCCCGTTGTGCGTAGATTATGCGTGAGCAATAGCAAGTAACCTAAG	1	bc
GCAGGAGAAA	GAAACACCGGTGGGGTTAGAGCTAGAAATAAAACGTTAACCAAAGGCTAG	1	bc
ACGACAAACG	GAAACACCGGTGGTGGTAGATCTGGAGATGGCATGGTGCCATAAAGAGAA	1	bc
TCCTTGAACC	GAAACACCGGTTAAGATTATGAGGGATTGGAGCTAGACATAAAAAGTTAA	1	bc
AATTTAACAA	GAAACACCGGTGATAATAGTTAGCTCGTGGGGTTAGAGCTAGAAATAGCA	1	bc
GAACGAAAAT	GAAACACCGGTGCTAATAGTTAGCTCGTGGGGTTAGAGATAGAAATAGCA	1	bc
CTATGACATA	GAAACACCGGTGCGCGGGGTTTCTGCGTGGGGATAGAGCTAGAACCTGCA	1	bc
CCGTGACGAC	GAAACACCGGTTGGCTTTATTCCTGTGTGGGGTTAGAGCTAGAAATAGCA	1	bc
GTGTTCAACC	GAAACACCGGTTAGCTGCCTCAAGTGGGGGTATAGCTAGAAATACCAAGT	1	bc
TCAGCCACCC	GAAACACCGGTGGGGTTAGAGCTAGGAATAGCAAGTTACCCTAAGGCTAG	1	bc
ATACACCACC	GAAACACCGGTAATCAACGGTTCCTCGTGGGGATAGAGCTAGAAATAGCA	1	bc
CATTCACTCC	GAAACACCGGCGGCAATTCTATCTGAGTGGGGTTAGAGCTAGAATTGCCA	1	bc
ATAAGCAAAA	GAAACACCGGTGGGGTTAGAGCTAGAAATAGCAAGTTAACCTAAGGCTAA	1	bc
GCCACGCAAA	GAAACACCGGTTCAGCCGGAGTGGGAATAGGGCAAGTAATAGCAGGTTAA	1	bc
AAATTGGGCC	GACACACCGGTTGTGGGGAACTCGGTGTGTGAGAAATAGCAAGTTAACCT	1	bc
GGTTGCTACA	GAAACACCTGTGGCAGCCAGCCACGTGTGGGGGTAGAGCTAGGAATAGCA	1	bc
ACAGAAAACT	GAAACACCGGTGGGGTTCGAGCTAGAAATAGCAAGTTAACCTAAGGCTAG	1	bc
TCAGCACACC	GAAACACCGGTGGGGTTAGAGCTAGAAATAGCAAGTTAACCTAAGGCTAG	1	bc
GTGTGAACAC	GAAACACCGGTTAGCTTTCTCACGTGGGGTTAGTGCTAGTAATAGCAGGT	1	bc
AATATGTATA	GAAACACCGGTTGGGGGGAACTCGGTGTGGGAGAAATAGCAAGTGAACCT	1	bc
CAATAACAAC	GAAACACCGGTGGTAATTGGATCTGAGTGGGGCTAGAGCTAAAAATTGCA	1	bc
TCACCAAATT	GAAACACCGGTGTGGTTAGAGCTAGACATAGCATGTTAACCTAACGCTAG	1	bc
TAAACACGCG	GAAACACCGGTTATGGGAGCGCGGTCGGGGGGTTAGAGCTAGAAATAACA	1	bc
TAACCCATCC	GAAACACCGGTGAAGCGAGGACGGTGGTGGGGTTAGAGATATAAATAGCA	1	bc
GCCAAACATA	GAAACACCGGTGTGCATAGATTATGCGTGGGGGCTAGCAAGTGACCTAAG	1	bc
GATTCAGTAA	GAAACACCGGTACTAGTTACTTATGGGTGGGGTTAGAGCTAGAAATAGCA	1	bc
TTCTACCTGT	GAAACACCGGTGAGGCGAGGTTATTCGTGGGGTATAACCTGGAAATAGCG	1	bc
GACAACCTAC	GAAACACCGGTATTCTAAAGTTACCCGTGGGGTTAGAGCTAGAAATAGCA	1	bc
GTATAGGACA	GAAACCCCGGTTAAACAGGCGTGGGGATAGAGATAGAAATAGAAAGTAAA	1	bc
TGGACTCACT	GAAACACCGGTTCCCGTTAGCTCGTAGGGGGGTTAGAGCTAGAAATAGCA	1	bc
GAATCAGCCT	GAAACACCGGTGACAAACGTATGTCAGTGGGGTTAGAGCTAGAAATAGCA	1	bc
GTGATAAATG	GAAACACCGGTGAGCATGATAACGTCCGTGGGGTTATAGCTAGAAATATC	1	bc
GCATTAAACC	GAAACACCGGTGCTACTAGTTAGCTCGGGGGGTTAAAGCTAAAAATAAGA	1	bc
AAACTATAAC	GAAACACCGGTGACAAACGTATGTAAGTGGGGATAGAGCTAGAAATAGCA	1	bc
GAATATCTAT	GAAACACCGGTACTCGTTACTTACGGGTGGGGTTAGAGCTAGAAATAGCA	1	bc
AAACGAGTGT	GAAACACCGGTGCTAGCGGTTTCGAAGTGGGGTTAGAGCTAGAAATAGCA	1	bc
AAACTCAAAA	GAAACACCGGTGCTGATAGTTAGCTCGTGGGTAGAGAGCTCGAGATAACA	1	bc
TTTTTTCTAT	GAAACACCGGTGTGCGGAGATTATGCGTGAGAAATAGAAAGTAACCTAAG	1	bc
TCAGCACACC	GAAACACCGGTGGGGTTAGAGCTTGTAATAGCATGTTAACCTAAGGCTAG	1	bc
TAAACAGACT	GAAACACCGGTTTAATTAGTTAACTAGTGGGGTTAGAGCTAGAAATAGCA	1	bc
CAATCAGACT	GAAACACCGGTGCTAGCGGTGTCGAAGGTGGGATAGAGCTATAAATAACA	1	bc
ATCTAGCAAC	GAAACACCGGTGTGCTTTGATCATGCGTTGGGATTAGCAAGGAAACTAAG	1	bc
CCAACCCCCC	GAAACACCGGTGGCGTTCAGTCGGTTGTGGGGTTAGAGCTAGAAATAGCA	1	bc
GCCTTACACA	GAAACACCGGTTCACCCAGCGAGGGGTTAGAAATAGAAATAGAAAGCTAA	1	bc
ATGACCGTCG	GAAACACCGGTTGGGTTAGAGCTAGAAATAGCATGTTAACCTAAGTCTAG	1	bc
GTCATCTACA	GAAACACCGGTGAGTAGGATAAACCCGGTGGGGTAAGACTTAGAAATAGT	1	bc
TAACGCGTCT	GAAACACCGGTGCCGCGAGGACGGTGGTGGGGTTAGAGCTAGAAATAGCA	1	bc
GCCTCTAAAA	GAAACACCGGTACTATTTACTTTCGGGAGGGCTTAGAGCTCTAAATCTCA	1	bc
ATAAAAGACG	GAAACACCGGTTGTAAGCGATGGATTGTGGGGTTAGAGCTAGAAATAGCA	1	bc
AATTAATTAA	GAAACACCGGTGACAAACGTATGTCAGTGGGGTTAGAGCTAGAAATAGCA	1	bc
AAATGGGTCA	GAAACACCGGTTGTGGGGAACTAGGGGTGGAGAAATAGCAAGTTAAACTA	1	bc
TGCACCTAAG	GAAACACCGGTGGCAGCCGGCCTCTTGTGGGGTTAGAGCTAGAAATAGCA	1	bc
TACTAACCGC	GAAACACCGGTGTGCGTAGATTATGCGTGAGAAATAGCAAGTAACCTAAG	1	bc
CATCCAGATA	GAAACACCGGTGGGGTAGAGATAGAAATAGCAAGATAACCTAAGGCTAGT	1	bc
TCCCTCCTCC	GAAACACCGGTTGAGATGATCCAAAAGTGGGGTTGGGCTTGGAATAGCCA	1	bc
AAATTAACAC	GAAACACCGGTGCTAATTGTTAGCTTGTGGGGTTAGAGCTAGAAATCGCA	1	bc
GCATTCTCTC	GAAACACCGGTGGCGATGATAAGGACGGTGGGGTTAGAGCTGAAATTGGA	1	bc
ATAATTTACG	GAAACACCGGTGACCATGATGAGGCCGGGGGGGTAAGACTAGAAATAGGC	1	bc
CACCCGCATT	GAAACACCGGTGCAACCGGCGTGGGGTTAGAGCTAGAAATAGCAATTTAA	1	bc
AATTTGCCCC	GAAACACCGGTTGCGGGGAACTCGGTGTGGGAGAAATAGCAAGTTAACCT	1	bc
AAAGAAAAAG	GAAACACCGGTGGTGTTAGAGCTAGAAATAGCAAGTTAACCTAAGGCTAG	1	bc
TATAACCCCT	GAAACACCGGTTTACTTAGTTAACTAGTGGGGTTAGAGCTAGAAATAGCA	1	bc
GGCATCTATA	GAAACACCGGTGAGCATCATCACGTCCGTGGGTTTAGAGCTAGAAATAGC	1	bc
CTGCGGGCCT	GAAACACCGGTCGCCGTTCGCAGGTCGTTGGGTTAGAGCTAGAAATAGCA	1	bc
AAAATCTTTA	GAAACACCGGTGGAGATGATAACGTCAGAGCTGTTAGAGCTAGAAATAGC	1	bc
AACACTACAG	GAAACACCGGTTCCCGATAACTAGTAGTGGGGTTAGAGCTAGAAATAGCA	1	bc
TTAGTAAACA	GAAACACCGGTGAGAATGATAACTAACATGGGAATATAACTAGAGATAGC	1	bc
GCAAATGTCT	GAAACACCGGTACCACTTACTTACGGGTGGGGGTAGAGCTAGAAATTGCA	1	bc
CCACCGAACA	GAAACACCGGTTCAACAGGCGTGGGGTTAGGGCTAGAAATAGCAAGATAA	1	bc
CCCATCTACA	GAAACACCGGTTCAACTGGCGTGGGGTTAGGGCTAGAAATAGCAAGTTAA	1	bc
ATAACCGTCT	GAAACACCGGTCCTAGAAGCTGAGTTGGGGCTATAGAGATAGAGATAGCA	1	bc
ATGACCTACA	GAAACACCGGTGAGCATGATAACGTCCGTTGGGTTAGTGCTAGAAATAGC	1	bc
TCATTAATAA	GAAACACCGGTGGGGTTAGAGCTAGAAATAGCAAGTTAACCTAAGGCTAG	1	bc
ATCCAACCCT	GAAACACCGGTGGGAGGCGATGGTTTGTGGGGATAGAGCTAGAAATAGCA	1	bc
TCAACCAAAC	GAAACAACGGTGTAGTTAGTTATCGAGAGGGGATAGAGCTAGAAAGAGAA	1	bc
GGCTTCAACA	GAAACACCGGTGGCAGTCGTCCACTTGTGGGGTTAGAGCTAGAAATAGCA	1	bc
ACTCCAACAA	GAAACACCGGTGACAAACGTACGTCAGTGGGGTTAGAGCTCGAAATAGCA	1	bc
GATTTAACAC	GAAACACCGGTGCTAATCGTTAGCTCGTTGGGTTAGAGCTAGCAATCGCA	1	bc
GTACAGTAAA	GAAACACCGGTGAGCATGATAACGTCCGGGGGGTTAGAGCTAGAAATAGC	1	bc
CGTCGAGATG	GAAACACCGGTCGTCGTTCGAACGGCGTGGGGTTAGAGCTAGAAATAGCA	1	bc
ACAAATGTCT	GAAACACGGGTGTGCTTGATGGGTTTGGGGGGTTAGAGCTTAAAATAGCA	1	bc
AATACACACA	GAAACACCGGTGGCAATTGGATCTGAGTGGGGTTAGAGCTAGAAATAGCA	1	bc
CCAAAAAACT	GAAACACCGGTGCTAGCGGTTTCGAAGGGGGGTTAGAGCTAGAAATAGCA	1	bc
GACAACCCCC	GAAACACCGGTAATCTAAAGATCCCCGTTGGGATAGAGCTAGAAATAGCA	1	bc
CAACTAGAAA	GAAACACCGGTGATAGCGGCTTACGAGTGGGGTTAGAGCTAGAAATAGCA	1	bc
GTGGGCTCGC	GAAACACCGGTGAGATGCCTCAAGTGGGGTTAGAGCTAGAAATAGCAAGT	1	bc
TTCTCGCCCC	GAAACACCGGTTCAAAAGGTGTGGGGTTAGAGCTAGAAATAGCAAGTTAA	1	bc
CGTACCTAAA	GAAACACCGGTGGCAGCTAGCCATTTGTGGGGTTAGAGCTAGAAATAGCA	1	bc
CCTCCACGCC	GAAACACCGGTAGAATGTCTCTCTGGGTGGGGTTAGAGCTAGAAATAGCA	1	bc
ATTACCTCCG	GAAACACCGGTCCTAGAAGCTTGTCGTTGGGGGTTAGGAATGGCAAGTTA	1	bc
TGGACAGTTT	GAAACACCGGTCTTCCTGGAATCTACGTGGGGGAGAGATAGAAATAGCAA	1	bc
GAAAACTACA	GAAACACCGGTGAGCATGAGAACGTCCGTGGGGTTAGTGTTAGAAATACC	1	bc
TCACCTGTCT	GAAACACCGGTGACGCGAGGTCGGGGGTGGGGTTAGAGCTAGAAATAGCA	1	bc
ATAACTCACG	GAAACACCGGTTGTATGCATTGGATTGTGGGGTTAGAGCTAGAAATAGCA	1	bc
GTCGAACAGA	GAAACACCGGTGAGCTGCGTCAAGGGGGGAGAGAGAGCGAGATAGCAAGG	1	bc
GCGGTAACAA	GAAACACCGGTGGGATTCATCCCTTTGTGGGGTTAGAGCTATAAATAGCA	1	bc
CTACCAGTCG	GAAACACCGGTGCTATCGGTTTCGAAGGGGGGTTAGAGCTAGAAATAGCA	1	bc
GAAACAATCT	GAAACACCGGTGGCCCCCGGGGTGAGGTGGGGGTAGAGCTAGAAATAGCA	1	bc
TTGGGTTCCT	GAAACACCGGTTCCCGTTAACTCGTAGTTGGGTTAGAGCTAGAAGTAGCG	1	bc
ACAGCACAAT	GAAACACCGGTGGGGATAGAGCTAGAGATGGCATATTGCCAGAAGGATCA	1	bc
TTATCCCACT	GAAACACCGGTTGTGAGAGTTTGCTAGTGGGGTTAGAGCTAGAAATAGCA	1	bc
CCTCGCGGTT	GAAACACAGGTAGAATTGATCTATGGGGGGGGTTATAGCTAGATATAGCA	1	bc
CCTTGCGCCA	GAAACACCGGTTGTGGGGGACTAGGGGTGGGAGTAATAGCAAGATAACCT	1	bc
CAATGAGAGC	GCAACACCGGTACTAGCGGTTTCGAGGTGGGGTTAGAGCTAGAAATAGCA	1	bc
TCCTCGGAAA	GAAACACCGGTGGTGGGAAAGTTGGTGTGGGAAAAATAGCATAAGAATCA	1	bc
TGTAAATAAT	GAAACACCGGTTCCCTTAGACTCGTAGTGGGGATAGAGCTAGAAATAGCA	1	bc
GACTCAGTTT	GAAACACCGGTACTCCTGGAATCCACGTGGGGTAGAGCTAGGAATAAGAA	1	bc
AAAAAGCAAT	GAAACACCGGTGTACTTAGCTAAATGGTGGGGTTAGAGCTAGAAATAGCA	1	bc
TCAGCCAACG	GAAACACGGGTGGGTATAGAGCTAGAAATCAAGAGTTCACCTAGGGCTAG	1	bc
TGCACAGTTG	GAAACACCGGTTTTCGTGCAAAGTACGTGGGGTCGGGCTAGAAATAGGAA	1	bc
AATGGTGCAC	CTAAACACCGGTTGTGGGGAACTCGGCGTGGGAGAAATAGCAAGTTAACC	1	bc
TAATACGAAA	GAAACACCGGTACTAGTTACTTACGGGTGGGGTTAGAGCTAGAAATAGCA	1	bc
GACCCTGTAC	GAAACACCGGTACTAGTTACTTACGGGTGGGGTTAGAGCTAGAAATAGCA	1	bc
TCAAAACAAC	GAAACACCGGTGGGGTTAGAGCTAGAAATAGCAAGTTAACCTAAGGCTAG	1	bc
AGACGGGTTC	GAAACACCGGTGTTCTTTGCTCGAGGGTGGGGTTAGAGCTAGAAATAGCA	1	bc
GGCAAATATA	GAAACACCGGTGGCCGCCCGTAACTTGTGGGGTTAGGGCTAGAAATATCA	1	bc
CGCATATCAT	GAAACACCGGTTCGCGTTACTTCTTAGTGGGGTTAGAGCTATAAATAGCA	1	bc
AAATCAATCC	CTAAACACCGGTTGAGATAGTAAAACAGTGGGGTTAGGGTAGAAAACAGA	1	bc
GACTCCCACA	GAAACACCGGTAGTCTTTCGATCTCCGTGGGGATAGAGATAGAAATAGCA	1	bc
GAGGCATCGA	GAAACACCGGTGACAAACGTATGTAAGTGGGGTTAGAGCAAGAAATAGCA	1	bc
TCATCACTCC	GAAACACCGGTGACGCGAGGCCGGTGGTGGGGTTAGAGCTAGAAATGGCA	1	bc
GACAACCTCC	GAAACACCGGTAATCTAAAGATCCCAGTGGGGACAGTGCTAGAAATAGCA	1	bc
ATGACCGTCG	GAAACACCGGTCCTAGAAGCTGAGTTTGTGGGGTTAGAGCTAGAAATAGC	1	bc
TAATCAAACC	GAAACACCGGTGGGGTTAGAGCTAGAAATAGCAAGTTAAACTAAGGCTAG	1	bc
CATCTTACCG	GAAACACCGGTGTGCGGTGATTATGCGTGAGAAATAGCAAGTAACCTAAG	1	bc
GAGTCAAGCG	GAAACACCGGTTGGGGGAAGAGGTAAAAATTGGAAGTAAAAATAAGGCTT	1	bc
AAATTGAGCC	GAAACACCGGTTGTAGGAAACTCGGTGTGGGTGAAGTGGTAGGTTAACCT	1	bc
ATGCCACCCC	GAAACACCGGTTGTCAGTGATGGTTTGTGGGGTTAGAGCTAGAAATAGCA	1	bc
GAATTATATC	GAAACACCGGTGAGCATGATAACGACGGTGGGGATAGATAGAGAAATAGC	1	bc
GCAATATCTC	GAAACACCGGTGAGCATGATAACGTCCGTGGGGTTAGGGCTAGAAATAGC	1	bc
TCCAGCCTCC	GAAACACCGGTAGAGTGAGTCCACGGGCTGGGATAGAGCAATTAACCTCA	1	bc
TCATCAAACC	GAAACACCGGTGGAGCTAGAGCCAGTAATAGCAAGTTAACCTAAACTTAC	1	bc
ATTCCACCAT	GAAACACCGGTTGTCAGCGTTTGTTTGTGGGGTTAGAGCTAGAAATAGCA	1	bc
TATCTAATCG	GAAACACCGGTGTGCGGCGATTATGCGTGAGAAATAGCAAGTAAACTAAG	1	bc
GTCAAATAGA	GAAACACCGGTGAGCGGGATATCGTCGGGGGGGTTAGAGCTAGAAATAGC	1	bc
GAATCAGTAA	GAAACACCGGTTCTAGTGGCTTCGGGGTGGGGTTAGAGCTAGAAATAGCA	1	bc
ACCTCGCTCT	GAAACACCGGTGTTGGGAGGTCGGTGGTGGGGTTAGAGCTAGAAATAGCA	1	bc
AAAATTGGGC	GCAACACAGGTTGTGGGGAACTCGGTGTGGGAGAAATAGCAAGTTAACCT	1	bc
CAATGAGCAT	GAAACACCGGTTCTGGCGGTTTCTGGGTGGGGTTAGAGCTAGAAATAGCA	1	bc
AAACAAGTGA	GAAACACCGGTGCAGGCTGGTTCGGAGTGTGGTTGAAGCTGGAAGTTAAA	1	bc
ATAAAACAGA	GAAACACCGGTGTGCGGAGATTATGCGTGAGAAATAGCAAGTAAACTAAG	1	bc
TAACAGCAAT	GAAACACCGGTTTACTTAGCTAACTAGTGGGGTTAGAGCTAGAAATAGCA	1	bc
TTAAACCAGT	GAAACACCGGTTTACTGAGTTAACTAGTGGGGTTAGAGCTATAAATAGCA	1	bc
GATGGCGACG	GAAACACCGGTGCCATTCATCGAGCGGGGGGGGTGCTACTAAAAATAAGA	1	bc
ATAAAACACG	GAAACACCGGTTGTAAGCGGTGGCTTGTGTGGTTAGAGCTAGAAATAGCA	1	bc
GATTCAGCAA	GAAACACCGGTTTTAGGAAATGGTGAGGGGGGTAAATGTAAGAAAAACCA	1	bc
CATTTCGCAC	GAAACACCGGTTGTGGAGAAGTCGGGGTGGGATAAATAGTAAAATAACCA	1	bc
CGTCCGCATC	GAAACACCGGTGGGGCAGGCGTAGATATAGGGGGTTGACCTAAGAATAGC	1	bc
CGTAACCACG	GAAACACCGGTGGCAGCCAGCCATTTGTGGGGTTAGAGCTAGAAATAGCA	1	bc
GACAAGCTCC	GAAACACCGGTTAACTAGGCGTGGGGTTGGAGCTAGAAATAGCAATATAA	1	bc
AAACAAAAAC	GAAACACCGGTGTTCTTTGCTCGAGGGAGGGGTTAGTGCTAGAAATAGCA	1	bc
TCCGCAAGCC	GAAACACCGGTAGGCTGGGGGCTAGAGCTGGGATAGAGATATAAATCTAA	1	bc
CGACAGGTCA	GAAACACCGGTAGTCTATGGAAGAGCGTGGGGTTAGAGCTAGAAATAGCA	1	bc
GATCCAGAAT	GAAACACAGGTATTCGTGGAATCCGCGTGGGGTTAGAGCAAGAAAAGCAA	1	bc
ATTTAACAAA	GAAACACCGGTGTGCGGTGATTATGCGTGGGAATAAGGCAGTAAATTAAG	1	bc
ACCTCGCTCA	GAAACACCGGTTCAACCGGCGTGTGGTTAGAGCTAGAAATAGCAAGTTAA	1	bc
TCAACCAACA	GAAACACCGGTGGGGTTAGAGCTAGAAATAGCAAGTTAACCTAAGGCTAG	1	bc
GTCAACTATA	GAAACACCGGTGAGCATGATAACGTCCGTGGGGTTAGAGCTAGAAATAGC	1	bc
GAGTAAGTAC	GAAACACCGGTTGCAGCCAGCCAGGTGTGGGGTTAAAGCTAGAAAAAGCT	1	bc
TAAACATATC	GAAACACCGGTTAAAATGGTAACTTCTGTGGGGTTAGAGCTAGAAATAGC	1	bc
AGTCAGCGAG	GAAACACCGGTGAGATGCCTCAAGTGGTGGGAGAGCTAGAAATAACAACT	1	bc
AATTCCCACA	GAAACACCGGTGGCAATTCGATCGGAGTGGGGTTAGAGCTAGAAATAGCA	1	bc
CATTCCCTCA	GAAACACCGGTGACACTTCGATCTTAGTGGGGTTAGAGCTAGGAATACCA	1	bc
AATATAGCTA	GAAACACCGGTTGGTATGAACACGGCCGTGGAGATATAGCTAGAAATACC	1	bc
AGATTGCTAC	GAAACACCGGTGTTCTTTGCTCGAGGGTGGGGTTAGAGCTAGAAATAGCA	1	bc
TTAACCGACT	GAAACACCGGTTTTATTAGTTAAGTTGGAGGTTCATATCTCAAATTGACA	1	bc
AAAAAAGGAC	GAAACACCGGTGCTCTTTATTAGATCGTGGGGTTAGAGCTAGAAATAGCA	1	bc
CAAAGGGCTT	GAAACACCGGTGCTAGCGGATTCGAAGTGGGGTTAGAGCTAGAAATAGCA	1	bc
GAAATAGACA	GAAACACCGGTGAGCATGATAACGGCGGTGGGGTTAGAGCTAGAAATAGC	1	bc
TAAACACACG	GAAACACCGGTTTTCCTAGCTAACTAGTGGGGTTAGAGCTAGAAATAGCA	1	bc
TCAGGAGATA	GAAACACCGGTGGGGTTAGAGCTAGAAATAGCATGTTAACCTAAGGCTAG	1	bc
AAATGGCCAC	GAAACACCGGTGTTCGTTGCTTGGGGGTGGGGTTAGAGCTAGCAATAGCA	1	bc
GTGACTGTAA	GAAACACCGGTACTAGTAGCTTACGAGTGGGGTTAGAACAGGAAAAAGCA	1	bc
CAAAGACTTT	GAAACACCGGTGATACGAGGACCGTAGAGGTAGTAGAGGTAGGATAACCA	1	bc
GACTCTGCCT	GAAACACCGGTTCCCGTTAGCGCGGAGTGGGGTTAGAGCTAGAAATATCA	1	bc
TCCACGCACT	GAAACACCGGTTCAACCGGCGAGGGGTTAGAGATAGAAATAGCAAGTTAG	1	bc
TCCTCCTAAC	GAAACACCGGTCGCGATAGTGAGAGAAAGAGCGTGTTAACCGAAGTATAC	1	bc
GAAACTTCCT	GAAACACCGGTTCCCGTTAACTGGTAGTGGGGTTAGAGCTAGAAATAGCA	1	bc
CACTCTCCCT	GAAACACCGGTTCCCGTTAGCTCGTAGTGGGGTTAGAGCTAGAAATAGCA	1	bc
AAAGCCAAAT	GAAACACCGGTTTACTTAGTTAACTAGTGGGGTTAGAGCTAGAAATAGCA	1	bc
GACCAGGAAA	GAAACACCGGTACTATTTGCTTGCGTGTGGGGTTAGAGCTAGAAATAGCA	1	bc
GAAGTCGAGA	GAAACACCGGTGCTAATAGTTAGCTCGGGGGGTTAGAGCTAGAAATAGCA	1	bc
CCCTCTGAAC	GAAACACCGGTTCAACCTGCGTGGGGTTAGGGCTAGAAATAGCAAGTTAA	1	bc
CAATGAAATA	GAAACACCGGTGCTAGCGGTTTCGAAGTGGGGTTAGAGCTAGAAATAGCA	1	bc
GACAACCTCC	GAAACACCGGTAATCTAAAGATCCCCGTGGGGGTAGAGCTAGAAATAGCA	1	bc
AATTGCCCAT	GAAACACCGGTTGAATGAGTTAACTAGTGGGGGTAGAGCTAGAAATAGCA	1	bc
GCTGCGGAGA	GAAACACCGGTGCAACGCGCGACTTGGGGTTTGTGCTTCTAATAGTAAGT	1	bc
ATCCGACGGA	GAAACACCGGTAGACTGGAACCACGGGTGGGGATAGAGATAGAAATAGCA	1	bc
TAACCACCAT	GAAACACCGGTTTACTTCGTTAACTAGTGGGGTTAGAGCTAGAAATAGCA	1	bc
GAATACGTAT	GAACCACCGGTACTAGTTACTTACGGGAGGGGGTAGAGCTAGAATTAGCA	1	bc
CGCCGGGACG	GAAACACCGGTCGTGGTAGGTAGGGGGTGGGGTTAGAGCTAGAAATAGCA	1	bc
AATACACAAC	GAAACACCGGTTTCCTTCGTTTACTAGTGGGGTTAGAGCTAGAAATAGCA	1	bc
TGCACCTTCA	GAAACACCGGTTCCCTTCATCACCTAGTGGGGATATAGCTATAACAAGCA	1	bc
AATATATATA	GAAACACCGGTTATGAGGAACACGTCGTGGGGGTAATAGTAAGATTACCT	1	bc
CAATAGCAAC	GAAACACCGGTTCAACCGGCGTGGTGTTAGAGCTAGAAATAGCAAGTTAA	1	bc
GCATTAAAGC	GAAACACCGGTGCTAATAGTTAGCTCGTGGGGTTAGAGCTAGAAATAGCA	1	bc
ATGTTAACAA	GAAACACCTGTTGGCTTTACTTATGCGTGGTATATAGCAAGTAAACTAAG	1	bc
TAAGAAAAAG	GAAACACCGGTGGTGTTAGAGCTAGAAATAGCAAGTTAACCTAAGGCTCG	1	bc
GACTCAGTAT	GAAACACCGGTACTAGTTACTTACGGGGGGGGTTAGAGCTAGAAATATCA	1	bc
AAATCATCCC	GAAACACCGGTTTTAAACGTATGTCAGTGGGGTTATAGCTAGAAATAGCA	1	bc
TAAATGCTAG	GAAACACCGGTTGTCGTTCAGCGAGAATGGGGTTGTTAATCGAAATAGAG	1	bc
CGACCCGTTA	GAAACACCGGTTTAGTATGGAGGGATTTGGGTTTAGATCGAGAAATAGCG	1	bc
GGAATATGTC	GAAACACCGGTACTGGTTACTTACGGGTTGGGTTAGAGCTAGAAATAGCA	1	bc
GCATCCCTAT	GAAACACCGGTGACGCGAGGACGGTGGTTGGGTTAGAGTTAGAAATAGCA	1	bc
CGCCGGCTCC	GAAACACCGGTCGTCGCTCGTAGGTCGGGGGGGTAGAGCTTGAAATAGCA	1	bc
GAAATGCAAA	GAAACACCGGTGTAAATAGTTAACTCGTGGGGTTAGAGCTAGAAATAGCA	1	bc
AAAACAGACT	GAAACACCGGTTGTAAGCGATGGATTGTGGGGTTAGAGCTAGAAATAGCA	1	bc
ATGACCCCCA	GAAACACCGGTTTACTTAGTTAACTAGTGGGGGTGGATCGAGAAAGAGGA	1	bc
ATCTATGTCA	GAAACACCGGTACTAGTTACTTAGGGGAGGTCTTGGAGCTAGAAGTTGAA	1	bc
TAGCCCACCA	GAAACACCGGTGGCAGCCAGCCACTTGTGGGGTTAGAGCTAGAAATAGCA	1	bc
CCAATACTCC	GAAACACCGGTGACTCGAGGTCGGTGGTGGGGTTAGAGCTAGAAATAGCA	1	bc
ATGACCGTCC	GAAACACCGGTCCTGGAAGCTGGGTTGTGGGGTTAGGGCTAGAAATGTCA	1	bc
AATTGAGCCG	GAAACACCGGTTTTGGTAAACGCGGTTTGGGGGTAGAGGCAGGTTAACCT	1	bc
CGGCGGACAG	GCAACACCGGTCGACGTTCGTAGGGCGTGGGGTTAGAGCTAGAAATAGCA	1	bc
TATCCATAAA	GAAACACCGGTGACGAACGTATGTCAGAGGGGATAGAACTCGAAGTCGCA	1	bc
GGCCACGCAA	GAAACACCGGTGGCAGCCAGCCACTTGTGGGGTTAGAGCTAGAAATAGCA	1	bc
TAACCAACAG	GAAACACCGGTGGGGTTAGAGCTAGAAATGGCAAGTTAACCTAAGTCTCG	1	bc
TCGGGCCAAT	GAAACACCGGTGTGATTCGTCAAGTGGGGTGAGAGCTAGTAAAAGCAAGT	1	bc
AAGTTGACAC	GAAACACCGGTTGGGTTGAATCCTTTGTGGGAGTAGAACTATGAATAGCA	1	bc
TGTCCAAGCT	GAAACACCGGTTTTCCTGGCATCTACTGGGGGGATAGCTCGAGATAGCAA	1	bc
CTCATATACA	GAAACACCGGTTCCCGTTAGCTCGTAGTTGGGTTAGAGCTAGAAATAGCA	1	bc
AATACCTAAC	GAAACACCGGTGACAAACGTATGTCAGTGGGGTTAGAGCTAGAAATAGCA	1	bc
TCTCTAACCG	GAAACACCGGTGTGAGGAGATTATGCGTGAGAAATAGCAAATAACCTAAG	1	bc
ATGAACGACG	GAAACACCGGTGGCGGCCAGGCACTTGGGGGGTTAGAGCTAGAAACAACA	1	bc
GGGCTAATAC	GAAACACCGGTGGCAACCAGACACTTGTGGGGTTAGAGTAAGAAATACAA	1	bc
TTACTACCCC	GAAACACCGGTCGTAAACGAGGGTTTGTGGGGTTAGAGCTAGAAATAGCA	1	bc
CCCCGAAGAC	GAAACACCGGTAGAAGTGACCTACGGGTGGGGTTAGAGCTAGAAATAGCA	1	bc
GATTAACCAA	GAAACACCGGTGGCAATTCGATATGAGTGGGGTTAGAGCTAGAAACTGCA	1	bc
TAATTAATCC	GCGGAAACACCGGTGAGCTAGTCAATGTCGTGTGGCTAGAGATAGAAAGA	1	bc
GTAATATCAC	GAAACACCGGTGACAATTGTATGTTAGTGGGGGTAAAAGCAGGAAAACCA	1	bc
GAATCAGCCG	GAAACACCGGTTTTAGTAAATGGTGAGTGGGGTTAGAGCTAGAAATAGCA	1	bc
CCCAACCACG	GAAACACCGGTGGCAGCCAGCCACTTGTGGGGTTAGAGCTAGAAATAGCA	1	bc
CTATCAAACC	GAAACACCGGTTGTAAGCGCTGGTTTGTGGGGTTAGAGCTAGAAATAGCA	1	bc
ATCTACCCCG	GAAACACCGGTGTCGGGAGATTATGAGTGAGCATTAGCAAGGAACGTAAG	1	bc
GACACCTAAT	GAAACACCGGTTTACTTAATTAACTAGTGGGGTTAGAGCTAGAAATAGCA	1	bc
AGCCTATGTA	GAAACACCGGTACTAGTTACTTACGGGGGGGGTTAGAGCTAGAAATAGCA	1	bc
AAAATTGTAA	GAAACACCGGTTCTCGTTCATTGGGGGTGGGGTTAGAGCTAGAAATAGCA	1	bc
AAGCTAACCG	GAAACACCTGTGTGAGGAGATTATGCGTGAGAAATAGCAAGTAAACTAAG	1	bc
AACACTTACT	GAAACACCGGTTCCCGTTAGCTCGTAGTGGGGTTATAGCTAGAAATAGCA	1	bc
AATTAAGCAG	GAAACACCGGTGCCCTTTATGGGACCGCGGGGTTAGAGCTAGAAATAGCA	1	bc
ATAGCAGACA	GAAACACCGGTGCGGGTAGCGCTAGAAATAGTAAGTTTACCTAAGGCTCG	1	bc
TCAGCCCTAA	GAAACACCTGTGGGGCTAGAGCTAGAGATGGCATGTTAACCTAAGGCTCG	1	bc
GGACGCGACT	GAAACACCGGTGCTAGCCAGTTACTTGTGGGGGTAGAGCTAGAAATAGCA	1	bc
CTCTAACATA	GAAACACCGGTGTGCGGAGATTATGCGTGAGAAATAGCAAGTAACCTAAG	1	bc
AACACTTACT	GAAACACCGGTTCCCGTTAGCTCTTAGTGGGGTTAGAGCTAGAAATAGCA	1	bc
GCATCTATAA	GAAACACCGGTACTATTTGAGCTAGGAATAGCAAATTGCTATAAGTCTAA	1	bc
CCCCCAACCC	GAAACACCGGTTGAACCGGCGTGGGATTAGAGATAGCAATAGAAAGTTAA	1	bc
AAACCATTAA	GAAACACCGGTGAAGAATGGAGGGAAGTGGGGTTAGAGCTAGAAATAGCA	1	bc
ACACAGCACG	CAAAACACCGGTTTTCTTTGCTCGAGGGTGGGGTTAGAGCTAGAAATAGC	1	bc
AATTTAACAC	GAAACACCGGTGCTAATAGTTAGCTCGTGGGGTTAGAGCTAGAAATAGCA	1	bc
CCCTCTCTAC	GAAACACCGGTTCAACCGGCTTGGGGTTAGGGCTAGAACTAGCAATTTAA	1	bc
GTAGGACACT	GAAACACCGGTTGGAAGCGTCAAAATGTGGGGTTGGGCTAGGAAAAGCAA	1	bc
CGCACTTCGA	GAAACACCGGTTCCCGTTAGCTCGTAGTGGGGTTAGAGCTAGAAATAGCA	1	bc
TCCGATGTAA	GAAACACCGGTGGTGGTTAATCTAGAAAGGGCATGTTAACCGAATGAGCG	1	bc
TCACCCCGCC	GAAACACCGGTATACTGGGTCCAAGCGCGTGATTCGAGCTAGAAATCGCT	1	bc
TAAACTACCT	GAAACACCGGTTGAGTTTATCACGAAGTGGGGTTAGAGCTAGAAATAGCA	1	bc
CGCTCCTACG	GAAACACCGGTGGCAGCCAGCCACTTGTGGGGTTAGAGCTAGAAATAGCA	1	bc
AATCGGCGAA	GAAACACCGGTTGGGGAGAACTCGGTGAGGTAGGGATAGCCAGTTAACCT	1	bc
CAGGGAGAGT	GAAACACCGGTGAGAGGGTTCAAGTGGGGGGAGTGCTAGAAAAAGCAGGA	1	bc
GCATCAATAA	GAAACACCGGTACGAGTAAATTAAGGGAGGGCATCGTGATAGAAATATCG	1	bc
ACCCGACGAC	GAAACACCGGTGAAGTAGGTCCACTAGTGGGGTTAGAGCTAGAAATAGCA	1	bc
GCATGCAAAA	GAAACACCGGTGATAATAGTTAGCTCGTGGGGTTAGAGGTAAAAATAGCA	1	bc
TTCTCTCCGT	GAAACACCGGTTCCCGGTAACTCTTAGTGGGGTTTGAGCTATAAACTGCA	1	bc
GGAACTTATA	GAAACACCGGTGAGCATGATAACGTCGGGGGGGTTAGAGCTAGAAATAGC	1	bc
TCAGCAGCCA	GAAACACCGGTTGTAGTAGATGGAGAGAGGGGTTGGAGCTATAAATCGCA	1	bc
TCTGCAACCC	GAACACCGGGTACGCTATAGCTAGCAGTAGCATTTTAACCAAAGGCTCGT	1	bc
AAAAGCGAAT	GAAACACCTGTTTAGTTAGTTAACTTGTGGGGGTAGAGGTAGGAATAGCA	1	bc
AAAAAATACA	GAAACACCGGTGAGCATGATAAGGTCGGTGTGGTTATAGCTAGAAATAGC	1	bc
GTCATTTCTT	GAAACACCGGTGCGCATGATCAAGTACGTGGGGTTAGAGCTAGAAATATC	1	bc
GATTAGCCCA	GAAACACCGGTAATCTAGAGATCGCCGTGGGGGTAAAGCCAAGAAAACCA	1	bc
TCCAACAGCG	GAAACACCGGTGGTCGCCGTGGAGAGGTGGGGTTAGAGCTAGAAATAGCA	1	bc
CCAGGAGATA	GAAACACCGGTGCGAGTGGATCCGAAGAGGGGTTAGTGATCGAAATAGAA	1	bc
GCCTCAAACC	GAAACACCGGTTCAACTGGCGAGGGGGTGGAGCTAGAAATAGCAAGATAA	1	bc
AAAACCCTCG	GAAACACCGGTGACGCGAGTGCGACGGTGGGGTTAGAGCTAGAAATAGCA	1	bc
