TTCTCCCCCT	GAAACACCGGTCGCGAAAATGTGCCGGTGGGGTTAGAGCTAGAAATAGCA	2	bc
ATGTCCAAAT	GAAACACCGGTCTTCCTGGAATCTACGTGGGGTAGAACTAGAAATAGCAA	1	bc
CACCCCCTCC	GAAACACCGGTATAATATAGAGGGAAGTGGGGTTAGAGCTAGAAATAGCA	1	bc
AAAATAAAAG	GAAACACCGGTTCTACCAGCTAGTTCTTGGGGGTTAAAGCTAAAAAAGCC	1	bc
ATTCCACAAC	GAAACACCGGTTGTAAGCGATGGTTTGTGGGGTTAGAGCTAGAAATAGCA	1	bc
ATTCTTCTAC	GAAACACCGGTCTCGAAAATGTGCCGGTGGGGTTAGAGCTAGAAATAGCA	1	bc
TAAACAATCT	GAAACACCGGTTAAGCGAGTGGTTAGGGCTAGAAGTGGCAGATTAAGCTA	1	bc
TAGGCAAACA	GAAACACCGGTGAGCTTAGCGCTTGAGATAGCTTGTTAACCTAAGGCTAG	1	bc
GAGTCCCCCT	GAAACACCGGTTTACTTAGTTGGTTAGGGTGGGTCTAGGTAGAACAAGCT	1	bc
CGATTATAAA	GAAACACCGGTGCTAATATTTAGCTCGTGGGGTTAGAGCTAGAAATAGCA	1	bc
ATACTATATT	GAAACACCGGTTGTCATCGTTGCGTTGTGGGGGTAGGGGCTGAAATTGGA	1	bc
TGCTAAGTTA	GAAACACCGGTCTTCGTGGATTCTGCGTGGGGTAGAGCTAGAAATAGCAA	1	bc
CACTAGGTAC	GAAACACCGGTACTAGTTACTTATGGGTGGGGTTATAGCTAGAAATAGCA	1	bc
GACTCTGTCC	GAAACACCGGTACTCGTTACGTACGAGCTCGGGTAGAGCTAGGTTTAGCA	1	bc
TACTCTTCCA	GAAACACCGGTACTCGTTACTTACTGGTGGGGTTAGAGCTAGAAATAGCA	1	bc
GTGATCTATG	GAAACACCGGTGATCATGACAACGTCGTTGGCTTAGAGTTACAAGTTACA	1	bc
AATCCACATT	GAAACACCGGTGTCGCTTCGATCTGAGGGTGGATATAGCTAGTAAAAGTA	1	bc
TCAACACACC	GAAACACCGGTTTTCGATCATAGGTCGTGGGGTTAGAGCTAGAAATAGCA	1	bc
GTGGGAGCTC	GAAACACCGGTGAGATGCCTCACCGGTTGGGGCTAGAAATAGAAAGATAA	1	bc
GACTCAGGCA	GAAACACCGGTTATAGTTACTGGTTAGAGGGGGTAATAGTAGGAATAGCT	1	bc
AAAACCGTCA	GAAACACCGGTTTAGTATGGAGGGAAGTGGGGTTAGAGCTAGAAATAGCA	1	bc
ATCCAACAGT	GAAACACCGGTTGTAAGCGATGGTTTGTGGGGTTAGAGCTAGAAATAGCA	1	bc
ATATCAGTCG	GAAACACCGGTTCTAGAAACTGAGGTGGGGGGAGAGATCGAAAAATAGCA	1	bc
ATACAACCCG	GAAACACGGGTTGTAAGCGATGGTTTGTGGGATTAGAGATAGAAATAGGA	1	bc
CACCGACATA	GCAACACCGGTGCAAGCGGCTTAGAAGTGGGGTTAGTGATGGAAACAGCG	1	bc
TTCACGCTCT	GAAACACCGGTCGCGAATCTGTGCCGGAGGGGTTAGTGCTCGTAATGGCA	1	bc
TGCACCCACG	GAAACACCGGTGGCAGCCAGCCGGTTGTGGGGTTAGAGCTAGAAATAGCA	1	bc
CGCTATTCAA	GAAACACCGGTGAGAACAGAACGTTTTGGGGTTAGAGCTAGAAATAGCAA	1	bc
TAACCAAATT	GAAACACCGGTCTTCATGGATAGTTCGTGGGGTTAAAGTAAGAAAAAGCA	1	bc
AAACGCACAA	GAAACACCGGTTTAGTATGGATCGAAGTGGGGTTAGAGCTAGAAATAGCA	1	bc
ATGCACTTCC	GAAACACCGGTTCCCGTTAGCTCGTGGGGTTAGAGCTAGAAATAGCAAGT	1	bc
TCACCCCTAC	GAAACACCGGTGTTGCGTGCGCTAGAGCGGGGTTAAGCCTGTTAATCTCA	1	bc
TCAGCCAACC	GAAACACCGGTGGGGTTAGAGCTAGAAATAGCCTGTTAACCTCAGGCTAG	1	bc
TGCACTTCCT	GAAACACCGGTTCCCGTTAGCTCGTGGGGTTAGAGCTAGAAATAGCAAGT	1	bc
GAATTTGTCC	GAAACACCGGTACTATTTACTTATGGGTGGGGTTAGAGCTAGAAATAGCA	1	bc
GACTCTGCCA	GAAACACCGGTACTAGTTACTTACGGGGGGGATTAGAGCTAGAAATAGGA	1	bc
TTCTTAGACC	GAAACACCGGTCCTCCTAGATGGGGTTAGGGGTAGAACTAGAAATAGAAC	1	bc
CGTTAATAAC	GAAACACCGGGGTTAGAGCTAGGAGTGGGAGGTTAGCCTTAGGCTAAGCC	1	bc
GAGGGGGAAA	GAAACACCGGTGAGATGCCTCACCGGTTAGAGCTAGAAATAGCAAGATAA	1	bc
ACACCGCACC	GAAACACCGGTTGAGACGGAGGGGGGGTAGAGCTAGAAATAGAAAGATAA	1	bc
AAACCCCTCT	GAAACACCGGTTTACTATGTAGACAAGTGGGGTTAGAGCTAGAAATAGCA	1	bc
TCTTCAACAA	GAAACACCGGTGAGAACAGAACGTTAGAGCTAGACATAGCAAGTTACCCT	1	bc
GTATAAGATA	GAAACACCGGTGAGCGTGATAACGGCCTGGGGGTAAGAGCTAGAAATAGC	1	bc
AAAAAAAGCT	GAAACACCGGTGTAGTCGGGGAGAGGGGGGGTTAGAGCTAGAAATAGCAA	1	bc
GTGAGAGATA	GAAACACCGGTGAGATGGATCACCGGGTGGGGCTAGAAATAGAAAGAGAA	1	bc
GTAGGCCAGT	GAAACACCGGTTGGATGCGTCGCCGTGTGGGGCTAGAGCTAGCAAGGTCA	1	bc
ACCGAAGATA	GAAACACCGGTGGGCGGAGATTTTGCGTGAGCAATAGCAAGTAACCTAAG	1	bc
GAAACCTATT	GAAACACCGGTTTACTTAGTTAACTAGTGGGTTTAGAGCTAGAAAAAGCA	1	bc
GAACGCGTTA	GAAACACCGGTTTGGTTTGGAAGGAAGGGGGGTTGAAACTAAAAATTACC	1	bc
CCCGCACAAA	GAAACACCGGTGGGGGTAGAGCTAGAAAGAGCAAGTTAACAGAAGGCTAG	1	bc
GCCTTAAGCA	GAAACACGGGGGCTTATAGCTAGATATAGGAAGTAAACCTAGGGCTAGCC	1	bc
ACGCTCACAA	GAAACACCGGTTGGCTATGCTCCTTTGTGGGGGTTAGGGTATAAAATACC	1	bc
TGCACTTCCT	GAAACACCGGTTCCCGTAACCTCGTAGTGGGGTTAGAGCTAGAAATAGCA	1	bc
ACGCCAAAAA	GAAACGCCGGTGGGGTTAGAGCTAGAAATAGCAAGTTAACCTAAGGCTAG	1	bc
AATCTAACCT	GAAACACCGGTGCGCGGAGATTCTGCGTGAGAAATAGCCAGTAACCTACG	1	bc
CCGACCCACC	GAAACACCGGTTCAACCGGTGTCTTTTGTGGGGTTAGAGCTCTAGACAGC	1	bc
ACATTCCCAA	GAAACACCGGTGGCAATTCGATCTGAGTGGGGTTAGAGCTAGGAATAGCA	1	bc
TGAACACAAA	GAAACACCGGTTGGGGTAGGTGACAGAAGGAGTTAGAGAACGAAATAGCA	1	bc
AAAATAATAG	GAAACACCGGTTATCGATCATAGGTCGTGGGGTTAGAGCTAGAAATAGCA	1	bc
AGTTAATCCA	GAAACACCGGTGCCCTCTATACGTTTTTGGGTTAGCGCTAGAAATAGCCA	1	bc
GTGGCACATA	GAAACACCGGTGAGATGCATCACCGGTTAGGGCTAGAAATAGCAAGTTAA	1	bc
CGGCGGGGTG	CAAAACACCGGTCGGCGATCGTGGGGTTAGAGCTAGAAATAGCAAGATAA	1	bc
ATTACACTCA	GAAACACCGGTCCTAGAAGCTGGGGTTAGAGCTAGGAATAGCAAGTTAAC	1	bc
ATCCCCCTCT	GAAACACCGGTTCTAAGCGCTGATTTGTGGGGTTAGAGCTAGAAATAGCA	1	bc
TCCGCATCCA	GAAACACCGGTGGGCGTAGGGCTGGACATGACTAGCTAACTAACGGATGG	1	bc
ATCATATTAG	GAAACACCGGTTTTCGTTCATAGGTCGTGGGGGTAGTGCTAGATATAGCT	1	bc
TTCTTCCAAA	GAAACACCGGTCGCGAAAATGTGCCGGTGGGGTTAGAGCTAGAAATAGCA	1	bc
AGGCAAGAAA	GAAACACCGGTGAGCTTTGCCAGAGGTTGGGGTTAGAGCTAGAAATATCA	1	bc
AGCTCACCCT	GAAACACCGGTGTGCGTAGATTAGGAGTGGGAAAAAGCAAGTAACCTGAG	1	bc
ATCATGGTCG	GAAACACCGGTTCTAGAACCTGGGGCTAGGGCTTAGAGTAACAAGTTGCC	1	bc
AATCCTGCCC	GAAACACCGGTGACCTTTATGTGTCCGGGGGGGTTGGAGCTGGAATTGCC	1	bc
TCCACCAAAT	GAAACACCGGTTTACTTAGTTCACTAGAGGGGTTAGAGCTAGAAATAGAA	1	bc
ATGCCCCTAC	GAAACACCGGTGATAGAAGCTTGGGTGAGGGGTAAAAATAGCAAATTAAA	1	bc
GAACCCCTCC	GAAACACCGGTCATCTAACGATCCCCGTGGGGATAGCGCTAGCATTAGCC	1	bc
ACGTCGGACG	GAAACACCGGTTCAACCGGCGGCTTTTGTGGTGGTAGAGGTAGGTATAGC	1	bc
TAAAAACATT	GAAACACCGGTTTAATTAGTTAACTAGTGGGGTTAGAGCTAGAAAGAGAA	1	bc
TCCTCACAGA	GAAACACCGGTGTGCTTAGAGCTTGAGTTAGCAATATCAAGTAACGCTAG	1	bc
GCGGGAGAAA	GAAACACCGGTGAGATGCGTAACCGAATTGAGCTAGAAATAGCAAGTTAA	1	bc
CCACCAAATT	GAAACACCGGTGGTGGTAGAGTTAGAAATGGGATGTTAACCGAAAGTGAG	1	bc
GTCATCCATA	GAAACACCGGTGAGCATGATAACGTCCTTGGGGTTAGAGCTAGAAATGGC	1	bc
GGAACATCAG	GAAACACCGGTGGCAGTCAGTGACTTGTGGGGTTAGAGCTAGAAATAGCA	1	bc
TGGTCAAGAA	GAAACACCGGTTCTCGTTACTGGTGTGAGAGCTAGGTACTCGAAGTAGCC	1	bc
TTAACCGTAG	GAAACACCGGTGGGATTAGCGCGTGATAGAGCTAGAAATAATAAGTCAAG	1	bc
CGGCAGCCAC	GAAACACCGGTTCAACCGGCGTCTTTTTGTGGGGTTAGAGCTAGAAATAG	1	bc
CACGCAAAAC	GAAACACCGGTGGGGTTAGAGCAAGAAATAGCAAGTAAACCTAAGGCTAG	1	bc
ATAGAGGAGC	GAAACACCGGTGATCTGCCTCACCGGGTGGAGCTAGAGCTAGCAAGATCA	1	bc
ATCTACCCCC	GACACACCGGTGTGCTGAGACTATGCGTGGGGATTAGCAAGGAACCTAAG	1	bc
CTACGACGCT	GAAACACCGGTTGTAAGCGACGGCTTGTGGGGTTAGAGCTAGAAATAGAA	1	bc
AATCCTGCAG	GAAACACCGGTGCCCTTTATGGGACCGTGGGGTTAGAGCTAGAAATAGCA	1	bc
ATTCAACAGT	GAAACACCGGTGTTCGGGGAATATACGTGGGAAATAGCTAGAAACATAAG	1	bc
AGACAATCCG	GAAACACCGGTGGCAGCCAGCCACTTGTGGGGTTAGAGCTAGAAATAGCA	1	bc
TTAACATATC	GAAACACCGGTCAGCATGATATCCACCGGGGGGATAGAGCTATATATAGA	1	bc
GTGAACAAGT	GAAACACCGGTGGTAGCCGTGGAGAGGTGGAGATAGCAAGAGAAATAGAG	1	bc
ACACACGCAC	GAAACACCGGTTCAACCGGCGTGGGGTGAGAGCTAGAAATAGCAAAATAA	1	bc
TGGTTAGATT	GAAACACCGGTCTTCTTGGATTCTACGTGGGGTAGAGCTAGTAATAGCAA	1	bc
TCATCCCCAC	GAAACACCGGTGGTGTAAAAGCTCGAGATGGCAAGTTAACCGAAATATCG	1	bc
CATTAACACC	GAAACACCGGTGGCAATTCGATCTGAGTGGGGTTAGAGCTAGAAATAGCA	1	bc
ACGATCGCAC	GAAACACCGGTTGTCTTTGCTCCTTTGTGGGGTTGGGGCTGTAAATGCAA	1	bc
AAACCGTTAC	GAAACACCGGTTTTCGACCATAGGTCGTGGGGTTAGAGCTAGAAATAGCA	1	bc
AACATACTTT	GAAACACCGGTTTTCGATCATAGGTCGGGGGGTTAGAGCTAGAAATAGCA	1	bc
ATCTAAGTAA	GAAACACCGGTGTGAGGAGATTATGCGTGGGGATAAAGAAGTAAATTAAG	1	bc
TCCACCCACG	GAAACACCGGTTCAACCGGCGTGGGGTTAGAGCTAGAAATAGCAAGATAA	1	bc
GAGGGAAGGG	GAAACACCGGTTAGAGTTACGGGTTAGAGCTAGAAATAGCAAGCTAAACT	1	bc
GCAGACAAAA	GAAACACCGGTGGGATTCGTCCAGTAGTGGGGTTAGAGCTAGAAATAGCA	1	bc
ATGTGGGTAG	GAAACACCGGTGGGGATAGATTCGGAGAGGGGTAGATAACGGAAGTAGAG	1	bc
TCACACCTTT	GAAACACCGGTGACGCTGGGGTTTAGGTGTAGTAAGAGCAAGTTAAGCTA	1	bc
AGGTAAAAAC	GAAACACCGGTGGGCTTTACTCCTTTGTGGGGTTAGAGCTATAGATAGCA	1	bc
TAATTATTAA	GAAACACCGGTTGTGGTGATCACGGTGTGGGGGAAAGAGCAAGATAACCC	1	bc
AGGCGGGCCG	GAAACACCGGTGTGCGGAGATTATGCGTGAGAAATAGCAAGTAACCTAAG	1	bc
GGAACATCTA	GAAACACCGGTGAGCGTTATAACGTCGGGGGGGATAGAGCTATAACAAGC	1	bc
TTATTCTAAC	GAAACACCGGTCGCGAAAATGTGACGGTGGGGTTAGAGCCAGAAATAGCA	1	bc
CGCACATCCA	GAAACACCGGCGAGCACTAAACGGTTTTTGGTTTGAGCTAGAAATAGCAA	1	bc
ATGACAGTAC	GAAACACCGGTCACAGAAGCTGGTGTTATAGGTAGAAGCAGGAAGTTAAC	1	bc
TTACCAGATA	GAAACACCGGTGGGGGTAGAGGTAGAAATAGTAAGAATAGCTAAGGATAG	1	bc
AATACATCCT	GAAACACCGGTGCCCATCGTCTGTCAGTGGGGTTAGAGCTAGAAATATCA	1	bc
GCCTCTGTCA	GACACCCCGGTACTAGTTGCTTCCGGGTGGGGTTCGAGCTAGACATCGCA	1	bc
AAGGCTGACA	GAAACACCGGTGGGGTTAGAGCTAGAAATAGCAAGTTAACCTAAGGCTAG	1	bc
TAACCTGCTA	GAAACACCGGTTTTCGATCATAGGTCGTGGGGTTAGAGCTAGAAATAGCA	1	bc
GGCTATGTCG	GAAACACCGGTACTAGTTACTTACGGGTGGGGTTAGAGCTAGAAATAGCA	1	bc
TTCCCCGCTT	GAAACACCGGTTTCGCAGATGTGCCCGTGGGGTTAGACCTAGAAATAGCA	1	bc
GAGCCACGCT	GAAACACCGGTTATATTTACTGGTTAGAGCTAGTAATAGTATGTTAACCT	1	bc
AAAAACCCCC	GAAACACCGGTGCTCTTTATGTGACCGTGGGGTTAGAGCTAGAAATAGCA	1	bc
GACTTTTTCC	CTCCCCCCCGGTACTCTTTCCTTACGGGTTTTGTTAGAGCTAGCCCTCTC	1	bc
CCGATCGTCA	GAAACACCGGTACTAGTTACTTACGTGTGGGGTTAGAGCTCGAAATAGCA	1	bc
TTTTCTTCCT	GAAACACCGGTCGCGAAAATGTTGCGGTGGGGTTAGAGCTAGAAATAGCA	1	bc
ATGTCAGTAG	GAAACACCGGTCCTAGATACTGAGGGGAGGGCTTAAAGTTACAAATAAAA	1	bc
GATGAACGTA	GAAACACCGGTCCTCGAACCTGGGGGTGGGGCTAGAGCTAGCAAGATCAA	1	bc
GCCTTACCTA	GAAACACCGGTGCGCGGAGATTACGCGTGAGATATCGCCTGTAACTCACG	1	bc
TCAGAAACCG	GAAACACCGGTGGGGTTAGAGCTAGAAATAGCAAGTTAACCTAAGGCTAG	1	bc
AACACACCAT	GAAACACCGGTGTACTTAGTTTATTAGTGGGGTTAGAGCTAGAAATAGCA	1	bc
TAACATGCAA	GAAACACCGGTTTTCGATCATAGGTCGTGGGGTTAGAGCTAGAAATAGCA	1	bc
GAAATAGCCG	GAAACACCGGTGTTAGTGATAGGGTCGGGGGGGTAGAGCTAGGAATAGCA	1	bc
AATTATGAAA	GAAACACCGGTGCCCTTTATTTACGCGTGGGGTTAGAGCTAGGAATAGCA	1	bc
GTGGCCTAAA	GAAACACCGGTGAGATTCCTAACCGGTTAGGGCTAGAAATAGCAGGCTAA	1	bc
TCAGCCACCC	GAAACACCGGTGGGGTTGGAGCTAGAAATAGCAAGTTAACCTAAGGCTAG	1	bc
ATCCCCAGGT	GAAACACCGGTCTTCCTGGAATCTACGTGGGGTAGAGCTAGAAATAGCAA	1	bc
AAATTAACAC	GAAACACCGGTGATAATCGTTAGCTCGTGGGGTTAGAGCTAGAAATAGCA	1	bc
AACACGCTCT	GAAACACCGGTTTCCGATCATATGGCGCGGGGTTAGAGCTAGTAATCGCA	1	bc
TTCTGTGTAA	GAAACACCGGTACTGGTTACTTACGGGTGGGGTTAGAGCTAGAAATAGCA	1	bc
CACTTGATCC	GAAACACCGGTTCAGATTAGCAAAAGCAGGTTAAGAGCTGGAAAGAGCAA	1	bc
ATACAACCGT	GCGGAAACACCGGTTGTAGACGTTGGGTTGGGGGGTTAGAGCTAGACATA	1	bc
ATGACAGCAG	GAAACACCGGTCATAGAAGCTGGGGTTAGAGCTAGAAATAGCAAGATAAC	1	bc
ATGATCAAAA	GAAACAACGGTGCTAGAAGCTGGGGCTAGAGCTTAAAATAGGAAGTTACA	1	bc
CAATGAGAAA	GAAACACCGGTGAGAGTAGATTCGGAGAGAGCAAATTCACCTAAGGCGAG	1	bc
GCGGTCATCA	GAAACACCGGTGAGAACAGAACGTTTTGGGGTTAAAGCTGGAAATATCAA	1	bc
AAACACCTAC	GAAACACCGGTTTTGTTTGGTGGGGAGTGGGGTTAGAGCTAGAAATAGCA	1	bc
AATAATCAAT	GAAACACCGGTGTACTTAGTGAACTAGTGGGGTTAGAGCTAGAAATAGCA	1	bc
AATACATAAA	GAAACACCGGTGACAAACGTATGTCAGTGGGGTTAGAGCTAGAAATAGCA	1	bc
AACTACCCCC	GAAACACCGGTGTGCGGAGAGTATGCGTGAGAAATAGCAAGTAACCTAAA	1	bc
TAACTAGACT	GAAACACCGGTTTTGCTGAAATCTACGTGGGGTAGAGCTAGAAATAGCAA	1	bc
CGTTCCTCCC	GAAACACCGGTGGGATCAGTCCGTTTTGGGGTTAGAGCTAGAAATAGCAA	1	bc
GGACTAACAC	GAAACACCGGTGACAAACGTATGTTAAGGGGGGTTAGAGCTGGAAATAGC	1	bc
GAAGTAGAGA	GAAACACAGGTGCTATTAGTTAGCTCGTGGGGTTAGCGCTAGAACTAGCG	1	bc
CTCACACACA	GAAACACCGGTTCAACCGGCGGGGGGGTAGAAGAAGAAATAGCAAGATAA	1	bc
TAATCAAACA	GAAACACCGGTTTAGTTAGTTAAAAAGTGGGGTAAGAGCTAGAAAAAGAA	1	bc
GAATCAGCCG	GAAACACCGGTTTTAGTAAATGGTGAGTGGGGTTAGAGCTAGAAATAGCA	1	bc
CAGTAAGCAC	GAAACACCGGTTGTCTTTACTCCTTTGTGGGGTTAGAGCTATAAATAGCA	1	bc
GATGGCGCGA	GAAACACCGGTGAGATGCCTCACCGGTTAGAGCTAGAAATAGCAAGTTAA	1	bc
TGCTCAGAAA	GAAACACCGGTCTTCCTGGGATATACGTGGGGTAGAGCTAGAAATAGCAA	1	bc
AGATATTAAC	GAAACACCGGTGTTCTTTGCTCAAGGGTTGGGTTAGCGCTATAAATATCA	1	bc
AAGATGGTCG	GAAACACCGGTTTTCGATCATAGGTCGTGGGGTTAGAGCTAGAAATAGCA	1	bc
TCAGGCGAGA	GAAACACCGGTGAGATTCGTCACCGAATAGAGCTGTAAATAGCAAGTTAA	1	bc
ATGTCACTAA	GAAACACCGGTGCGCGTAGATTATGTGTGGGGTTTAGAGCTAAACCTACC	1	bc
AAAATAATAG	GAAACACCGGTTTTCGATCATCGGTCGTGGGGTTAGAGATAGAAATCGAA	1	bc
AAAGCAACAA	GAAACACCGGTGGTGTGGGAGCTAGAGTTGGCGAGATAACCTGTTACTAG	1	bc
CAAAGGGTAG	GAAACACCGGTGTTCGATCATAGGTCGTGGGGTTAGAGCTAGAAATAGCA	1	bc
TCCAACTTCG	GAAACACCGGTGACAGCCGGCCTCTTGCGGGGGTTGAGCTAGAAATAGCA	1	bc
TTCTTACATT	GAAACACCGGTGTGCGGAGATTATGCGTGAGAAATAGCAAGTAACCTAAT	1	bc
AAAACGCTCG	GAAACACCGGTTTTGCGAGATCGGTTGTGGGGGTAGAGCTAGAAATAGCA	1	bc
AAAAATGCGA	GAAACACCGGTGCCGTTTGTGGGACCGGGGGTAGAGAGAGAAAAATAGCA	1	bc
TAATTGCACA	GAAACACCCGTGGGGTTAGAGCTAGAAATAGAGAGTTAACCTCAGGCTAG	1	bc
TTTTTGTCAA	GAAACACCGGTTGCGAAAAAGTGCCGGTGGGGTAAATCGCAAGATAACCA	1	bc
CACCGAGTTA	GAAACACCGGTGCTAGTTGCTTCGGGGTGGGGTTAGAGCTAGAAATATCA	1	bc
TCTTGGGAAA	GAAACACCGGCTGGGGGGGACTCGGAGTGGGAGAGATAGCAAGTTACCCT	1	bc
ACCGCGAAAA	GAAACACCGGTGGGGTTAGAGCTAGAAATAGCAAGTTAACCTAAGGCTAG	1	bc
AATCATGACC	GAAACACCGGTGACCTTTACTCGAGGGTGGGGTTAGAGCTAGAAATAGCA	1	bc
CGGCGGGTTG	GAAACACCGGTGAGCATGGTAACAGACGTGGGGTTATAACTAGAAATAGC	1	bc
TTCATCCACT	GAAACACCGGTTTTCTTAGTTAACTAGAGTGGTTAGAGCAAGAAATAGCA	1	bc
TTCGCCACAA	GAAACACCGGTGGGGTTAGAGCTAGAAATAGCAAGTTAACCTAAGGCTAG	1	bc
AATCTAACAG	GAAACACCGGTGTGCGGAGATTATGCGTGAGAAATAGCAAGTAACCTAAG	1	bc
CCGTTACAAT	GAAACACCGGTCTTCCTTGATTCTACGTTGGGTTGGGCTAGTAATTGCAA	1	bc
AAAACCAAGT	GAAACACCGGTTTAGTTAGGTAACTAGTGGGGTTAGAGCTAGAAATAGCA	1	bc
TTCTTATATA	GAAACACCGGTGAGGATGATAACGCCGTGGGGTTAGAGCTAGAAATAGCA	1	bc
TCAGGCGAAA	GAAACACCGGTTGGGGCAGAGCTAGAAATGGCGAGATAACCTTAGGATAG	1	bc
CAGTCACCAC	GAAACACCGGTGGCAATTCGATCTGAGTGGGGTTGGAGCTAGAAATAGCA	1	bc
CCCCGGGACC	GAAACACCGGTGCAAGCGGTTTCGAAGTGGGATTAGAGCTATAAACAGCG	1	bc
GTGAGCCTCC	GAAACACCGGTGATCTACCTCACCGCGTGGGGCTAGAACTAGCAATAGAA	1	bc
CGCCTCCGTT	GAAACACCGGTAGAATGGATCCACGGGTGGGGTTAGAGTTAGAAATGGCA	1	bc
CACTACGCAA	GAAACACCGTGACTATTTACTCTCAGTGGGGTTTAAGCTTGGAATTGCCA	1	bc
TCTACAAACG	GAAACACCGGTGGGGTTAGAGCTAGAAATAGCAAGTTAATCTAAGGCTAG	1	bc
GACAACGTTA	GAAACACCGGTAATCTAGAGATCCCCGTGGGGATAGAGCTAGAAATAGAA	1	bc
AGAACTCCCT	GAAACACCGGTTTTCGTCAGCTCTTAGTTGGGTTAGAGCTAGAAATAGCA	1	bc
AATCAAGATT	GAAACACCGGTCTTCCTGGAATCTACGTGGGGTAGAGCTAGAAATAGCAA	1	bc
GGAAACTATA	CTAAACACCGGTGAGCATGATAAACTCGGTGGGTTTAGAGCTAGAAAAGC	1	bc
TTCTTAACAC	GAAACACCGGTCGCGAAAATGTGCCGGTGGGGTTAGAGCTAGAAATAGCA	1	bc
TGCCACCACC	GAAACACCGGTATTCCTGGAATCTACGTGGGGATAAGCTAGAAATTGCAA	1	bc
GGCTCTGTCA	GAAACACCGGTACTAGTTACTTACGGGTGGGGTTAGAGCTAGAAATAGCA	1	bc
AACATACTGA	GAAACACCGGTTTTCGGACATAGGGCGTGGGAATAGAGATGTAAATAACG	1	bc
AGTGGGAGCG	GAAACACCGGTGAGCTGCCTCAACGGTTAGAGCTTGGAAAGGCAACTTAA	1	bc
AACATGCACC	GAAACACCATTTTACGCTCCTAGGTCGTGGGGTTAGAGCTAGCAATTACC	1	bc
GCCAGACCCC	GAAACACCGGTGGTCGCCGTGTCGAGGTGGGGGTAGTGCTAGATTTACCT	1	bc
GGGACTGAGA	GAAACACCGGTGCCAGGCCTCACCGGTTGGGGCTAGAGATAGCAATATAA	1	bc
ATGATCGTAA	GAAACACCGGTCCTAAAAGTTGGGGTTAGGGGTAGAAATAGCAAGTTAAC	1	bc
AATCAATACC	GAAACACCGGTGACTAACAAATGTCAGTTTACCTAGAGCTAGAAAGCTCA	1	bc
AACTAACCAC	GAAACACCGGTGTGCGGCGTATATGCGTGGGGATTAGCAAGGAAATAGAG	1	bc
