ATCAGCAAGA	GAAACACCGGTGGGGTTAGAGCTAGAAATAGCAAGTTAACCTAAGGCTAG	2	bc
CCTAATGCAG	GAAACACCGGTGCCCTTTATGGGCCCGTGGGGTTAGAGCTAGAAATAGCA	1	bc
AAAAAGACAA	GAAACACCGGTGGTGGTAGATCTAGAAGTGGGGTGATAACCTAAAGTTAG	1	bc
GGTCCCTTCC	GAAACACCGGTAACCTACGTATGTCAGTGGGGTTAGAGCTAGAAATAGCA	1	bc
CAAAGTGCTT	GAAACACCGGTGCTCGCGGTTTCGAAGTGGGGTTAGAGCTAGAAATAGCA	1	bc
TTCTTCACGA	GAAACAGGGGTTAAGGATGGAAATATCGAGTTAGACTTAGGCTGGTAAGC	1	bc
GTATTATGAG	GAAACACAGGTGATCGTGATAACGTTCGGGGGGTTAGAGCTGGAATTGCC	1	bc
ACTTGGAAAA	GAAACACCGGTTGTGGGGGACTCGGAGTGGGAGAGATAGCAAGTTAACCT	1	bc
GAATTACCCA	GAAACACCGGTGCTACTAGTTCGCTCGTGGGGTTAGAGCTAGAAATAGCA	1	bc
AAAATCATTA	GAGACACCGGTTTGCAATGCAGGGATAGAGGTAGTAGAGCTAGGTTTAGC	1	bc
ACCCCCTCCC	GAAACACCGGTGACAAACATACGCCAGTGGGGTTAGAGCTATAAATAGCA	1	bc
TCCACTCCCC	GAAACACCGGTTCCCGTTAGCTCGTAGTGGGGTTAGAGCTAGAAATAGCA	1	bc
CGACTAATTC	GAAACACCGGTTGTGATTCTCAAAATGAGGGGTAGAGCTAGAAAGATCAA	1	bc
ATCTATCTAA	GAAACACCGGTACTCGGCGCTTATGCGTGAGAATTAGCAAGTAACCTAAA	1	bc
TACCTCGCAC	GAAACACCGGTTCAACCGGCGTCTTTTGGGGGGTTAGAGCTAGAAATAGC	1	bc
AAACGATCAT	GAAACACCGGTGACAGACGTATGGCAGTGGGGTTAGAGCTAGAAATAGCA	1	bc
AATTGAGATA	GAAACACCGGTTAGCAGGATCACGTTAGAGCTAGAAATAGCAAGTTAACC	1	bc
CAAAGCGTTT	GAAACACCAGTGCTAGCGGCTTCGAAGTGGGGTTAGAGCTAGAAATAGCA	1	bc
ACAAAACTCT	GAAACACCGGTGACTCGAGAACGGGGGTGGGGATAGAGCTAGAACTAGCA	1	bc
TAAAACTCCC	GAAACAGGGGTTAGCTCTAGAACTAGCAGGGTAACCTAAGGCAAGTACGT	1	bc
AGTAAATCCA	GAAACACCGGTGAGAAAAGAACGTTATGTAGAAATAGAAAGATAAACTAC	1	bc
CGGTCAACCG	GAAACACCGGTTATCGCTACGGATTTGTGGGGTTAGAGCTAGAAATAGCA	1	bc
GTCTAGCAGC	GAAACACGGGGTCAACCGGCGTCTTTTGTGGAGTTAGAGGTAGAAATAGG	1	bc
ATGACCGCAC	GAAACACCGGTGACAAACGTATGTCAGTGGGGTTAGAGCTAGAAATAGCA	1	bc
GGATTAACCA	GAAACACCGGTGCTCATAGTTAGCTCGTGTGGTTAGAGCTAGAAATAGCA	1	bc
GACGCAAAAA	GAAACACCGGTACGGTTAGATTACGGGATAGGAAAGAGATATAAGGATCA	1	bc
GATCCAACCG	GAAACACCGGTTATCGTTACGGATTTGTGTGGTTATAGCTAGAAATAGCA	1	bc
CTTCCACAAC	GAAACACCGGTGGCAATTCGATCTGTGTGGGGTTAGAGCTAGAAATAGCA	1	bc
AACCTGCTTT	GAAACACCGGTTTTCGTTCATAGGACCGCGGGTTTACAGCTAGCAATTGC	1	bc
TTATTATCCA	GAAACAGGGGTTAGAGCTAGAAATAGCAAGTTAACCTAAGGCTAGTCCGT	1	bc
ACATTCACAC	GAAACACCGGTTGGGTTTGCTCCTTTGGGGGGAGAGATCTCTAGATAGCA	1	bc
AATTCATTTC	GAAACACCGGTGACAAACGTATGTCAGTGGGGTTAGAGCTAGAAATAGCA	1	bc
CCGTATGCAC	GAAACACCGGTAGGCTTTACTCATTTGTGGGGTTAGAGCTATAAATAGCA	1	bc
TCATTTATAC	GCAACACCGGTTGAGATAATCAAAAAGTGGGGTAGAGCTAGAAATAGCAA	1	bc
AATTATTCCC	GAAACACCGGTGACAAACGTATGTCAGTGGGGTTAGAGCTAGAAATAGCA	1	bc
ACGAATGCCT	GAAACACCGGTTCCCTTTATTGGTCCGTGGGGTTAGAGCTAGAAATAGCA	1	bc
ACGTTAATCC	GAAACACCGGTTGGCTTTACTCCTTTGTGGGGTTAGAGCTATAAATAGCA	1	bc
AGACCATACA	GAAACACCGGTTGGAAGTAGCGAGTTGAGGGGTGACTGCTACAATAAGCA	1	bc
ATCTTCTCAA	GAAACAGGGGTTGGGGCTAGATCTAGCAGGTTAAAATAAGGCTAGAACGT	1	bc
AGCCCGCTTT	GAAACACCGGTTTTCCTGGAATCTACGTGGGGTAGAGCTAGAAATAGCAA	1	bc
CCGCCATCAC	GAAACACCGGTTGGATTTACTCCTTTGTGGGGTTAGAGCTATAAGTAGCA	1	bc
AGAAAGAAAG	GACACACCGGTGTTCTTTGCTCGAGGGTGGGGTTAGAGCTAGAAATAGCA	1	bc
GCATATGTCC	GAAACACCGGTACTAGCTACTTACGGGGGGGGGTAGAGCTAAGAATAGCA	1	bc
AAACCCGTTG	GAAACACCGGTGCTAGCAGCTGCGAAGTGGGGTTAGAGCTAGAAATAGCA	1	bc
TTCTTATATC	GAAACAGGGGTTAGCGCTCGAAATAGCAAGTTAACCTAAGGCTAGTCCGT	1	bc
ACCTCCCCCC	GAAACACCGGTTCAACATGCATCTTTGTGGGGGTTAGAGTTGAAATTAGC	1	bc
GTTGGCGCAA	GAAACACCGGTTGGGTGCAAGTTTACGTGAGGGTAGTACCAAGTTAACTT	1	bc
CCTCTATCAC	GAAACACCGGTGAGAAACGTATGTTAGTGGGGTTAGAGCTAGAAATAGCA	1	bc
CCACTAATGC	GAAACACCGGTTGGGTATGCTGGGTTGGTGGGGTTAGAGTTTGAAATACC	1	bc
CGTCCGTAAA	GAAACACCGGTGTTCATTGATTGAGGGTAGGATGAGAGCCTGAGATTGCA	1	bc
CCTTATCCCC	GAAACACCGGCGCCCTTTACGGCTCCTGGGGGGTTGTGCTTGAAAAAGCA	1	bc
TTTTCCTTCC	GAAACAGGGGTTAGAGATAGAAATAGCAGGGTAACCCATGGCTAGTTCGT	1	bc
GCAGCCGAGA	GAAACACCGGTGAGGTGAGAGCTAGACATAGCATGGTAAGCTAAGACTTT	1	bc
TCCGAAAAAT	GAAACACCGGTGGGGGTCGAGGAGGGGTTGGGAAAGTGCTAGAAAGATCA	1	bc
GGCAAATAAA	GAAACACCGGTGGCAACCAGCCACTTGTGGGGTTAGAGCTAGAAATAGCA	1	bc
TAAAGTGAAA	GAAACACCGGTTTAATTAGTTAACTAGTGGGGTTAGAGCTAGAAATAGCA	1	bc
AGACTGTAAA	GAAACACCGGTGTTCATGGTAACGTCCGTGGGGTTGGAGCAAGAAATAGC	1	bc
TATACGCCAA	GAAACACCGGTTTAGTTGGACTCGGAGTGGGGGAAGTAGCAGGTTTACCT	1	bc
CCGTAAGCAA	GAAACACAGGTTCTCTTTACTTCCTTGTGGGGTTAGAGCTATAAATAGCA	1	bc
TAGTCCATCG	GAAACACCGGTTATCGTTACGGGTTTGTGGTATTAGAGCTAGGAATAGCA	1	bc
CCGTTCCCCC	GAAACACCGGTTGGCTTTACTCCTTTGTGGGGTTAGAGCTATAAATAGCA	1	bc
GCGACACGCG	GAAACACCGGTTATCGTTGCGGGTTTGTGGGGTTAGAGCTAGAAATAGCA	1	bc
AATTATTCCC	GAAACACCGGTGCAATTTATGGGACCTGGGGGTTAGAGTTAGAAATAGCA	1	bc
GTGGGAAAAA	GAAACACCGGTGAGATGCAAGTTAACCTAAGGCTAGACCGATATAAACTT	1	bc
AAACCAAACA	GAAACACCGGTTTTATATGGAGGGAAAGGGGGGTTAGACTTAAAAAAGGA	1	bc
TTGTCAAATT	GAAACACCGGTCTTCCTGGAATCTACGTGGGGTAGAGCTAGAAATAGCAA	1	bc
TGAACATCAT	GAAACACCGGTTCCCGTTGGCTCGTAGTGGGGTTAGAGCTAGAAATAGCA	1	bc
GGAGGAAAGC	GAAACACCGGTTATCGTTACGGATTTGTGGGGTTAGAGCTAGAAATAGCA	1	bc
CTCTCACCAC	GAAACACCGGTGTGCGGAGATTATGCGTGAGAAATAGCATGTACCCTAAG	1	bc
AAATAAACCC	GAAACACCGGTTGGGGTAGTCAAAAAGTGGGGAATAGCTAGAAATATAAG	1	bc
TACTTAACAC	GAAACACCGGTTGAGATAATCAAAAAGTGGGGTAGAACTAGAAAGAGCAA	1	bc
AACACCCACC	GAAACACCGGTAGTCTAAGGAGCCCCGTGGGGTTATAGCTAGAAATATCA	1	bc
AGCAAATCCG	GAAACACCGGTGGCAGCCAGCCACTTGTGTGATTATAGCTAGGAATAGCA	1	bc
AATCAGAAAA	GCAACACCGGTGTCCTTTCTATGGGAGTTGGGTTAGAGCTAGAAATAGCA	1	bc
GGCAATTTCA	GAAACACCGGTGCCAGCCAGCCACTTGTGGGGTTAGAGCTAGAAATAGCA	1	bc
TGGGGGGGAG	GAAACACCGGTGAGATGCAAGTTAACCTAAGGCTAGTCCGTTATCAACTT	1	bc
GATTCTTTAA	GAAGCACCGGTACTAATTGCTTACGGGTGGGGTTAGAGCTAGAAATAGCA	1	bc
TAAAAATTCC	GAAACACCGGTGCCCTTTATGGGACCGTGGGGTTAGAGCTAGAAATAGCA	1	bc
CAATTACACC	GAAACACCGGTTGAGATGATCACAAAGTGGGGTAGAGCTAGAAATAGCAA	1	bc
CATTCCCCCA	GAAACACCGGTGGCACTTCGATCAGAGTTGGGTTTGAGATATTAATCGAA	1	bc
CTCCCCGACT	GAAACACCGGTCGGGAAGAGCTAGAGGTAGGAATAGAACCTGAAGCAAGA	1	bc
AATCTCACAT	GAAACACCGGTGTTCGTGGATTATGCGTGGGAATTAGAAAGTAACCTAAG	1	bc
GCATATGTCA	GAAACACCGGTACTAGTTACTTACGGGTGGGGTTAGATCTAGAAATAGCA	1	bc
TTAATAATCA	GAAACACCTGTGAGCATGATAACGTCCGTGGGGTCAGAGCTAGAAATAGC	1	bc
AGTTCATACA	GAAACACCGGTGGGAACAGAACGTTAGAGGGGGTAATAGCCGGTTAACCT	1	bc
CCGTTCCCCC	GCACGGACGAAACACCGGTTGAATTTACTTATTTTATTTGTTACATGTTT	1	bc
CATTCACGCG	GAAACACCGGTGGCAATTAGGTCTGAGTGGGGGTAGTGCTAAGATAAGCA	1	bc
TGAACCCATG	GAAACACCGGTTTAGTATGGATGGAAAGTGGGGTTAGAGCTAGAAATAGC	1	bc
TTAATAGATT	GAAACACCGGTGTGCATGATAACGACGGGGGGGTTAGAGCGAGAAAGAGC	1	bc
ACCTAGCAAC	GAAACACCGGTTCAACCGGCGTATTTTGTGGGGTTAGAGCTAGAAATAGC	1	bc
GTCCTCTATC	GAAACACCGGTAAGCTGGATAACGTCCGGGGCGTAAAGGCTAGAATTAGA	1	bc
GATATATAAA	GAAGCACCGGTGAGCATGGTAAGGTTCGTGGGGATAGCGATAAAAATAGC	1	bc
CCCCCCATGA	GAAACACCGGTTTCGTATGGCTGTTACGGGGGGTTAGCGCTAGAAATAGC	1	bc
TGACCCGTTT	GAAACACCGGTCACGCTGGAATCTACGCGGGGAAGAGCTAGATATCGCAA	1	bc
AAAAGAATGA	GAAACACCGGTTTAGTATGGAGGGAAAGTGGGGTTAGAGCTAGAAAAAGA	1	bc
ACTAACGCCT	GAAACACCGGCGCCCCTAATGTGACCGCGGGGATTAGCCAGGAAACAGAA	1	bc
AAAATAATAC	GAAACACCGGTGAGCATGATAACGTCCGTGGGGTCAGAGCTAGAAATAGC	1	bc
AATTGTGCCT	GAAACACCGGTTGTGGTGAACTCGGTGTGGGAGAGATAGCCAGTTAACCT	1	bc
GAAATATAAC	GAAACACCGGTGATCATTATAACGTGGGGGGGTTAGAACTAAAAAATGGA	1	bc
AGTCAATCCC	GAAACACCGGTGACGAACGTATGCCGGTGGGGTTAGAGCTAGAAATAGCA	1	bc
CGCTCATGCA	GAAACACCTGTGGGCACAGAAGGGTTTGGGGTTAGAGCTAGAAATAGCAA	1	bc
AGAAAGGTCG	GAAACACCGGTCCTCTTTGCTGGAGTGTGGGGTTAGAGCTAGAAATAGCA	1	bc
TAATAAGAAA	GAAACACCGGTACTGGTTACTTACGGGTGGGGTTATAGCTAGAAATAGAA	1	bc
AAGCCCGTCA	GAAACACCGGTCTTGTATGCTGGGATTGTGGGGTTAGAGCTAGAAATAGC	1	bc
TAATCGCTCC	GAAACACCGGTTGAAATAGTCAAATAGTGGGGTGAAACTAGAAATAGCAA	1	bc
CACAAACATT	GAAACACCGGTACTAGCGGTTTCGCAGTGGGGTTAGAACTAGAAATAGCA	1	bc
TAACGCGCCC	GAAACACCGGTGCTGTAAATTTCGCAGTGGGGTTAGAGCTAGAAATAGCA	1	bc
GGAAGAGATA	GAAACACCGGTGAGCATGATAACGTCCGTGGGGTTAGAGCTAGAAATAGC	1	bc
TGCTCTTCAA	GAAACACCGGTGAGAACAGGATGTTAGAGCGAGTAAAAGCAAAAATACCA	1	bc
TGATCAAAAT	GAAACACCGGTCCTCATGGCTAGCTCGTGGGAGTAGAGCTAGTAGCAGCA	1	bc
ACCTGGCCAA	GAAACACCGGTTGTGGGGAACTCGGTGAGGGAGAAATAGCAAGTTAACAT	1	bc
TGAATATATT	GCACCACCGGTGAGCAAGCTAAAATCTGTGCGGATAGATCTAGCAATAGC	1	bc
GTCTATTCCA	GAAACACCGGTCCTGGTTACTTACGGGTGGGATTAGAGCTAGAAATAGCA	1	bc
CCGCAGAAAC	GAAACACCGGTTGTCTTTGCTCGTTTGTGGGGTTAGAGCTATAAATAGCA	1	bc
GGTCAAGCTT	GCAACACCGGTCTTCCTGGAATCTACGTGGGGTAGAGCTAGCCATCGCAA	1	bc
TGTCGGGCTT	GAAACACCGGTCGTCGTGAAATCGACGTGGGTGAAATCTCGAGATAACCA	1	bc
CATTGCCGCC	GAAACACCGGTGGAAATTAGATATGAGTGGGGTTAGAGCTAGAAATAGCA	1	bc
GCGTCCGGCG	GAAACACCGGTTCTCGTTACGGATTTGTGGGGTTAGAGCTAGAAATAGCA	1	bc
ATGCCATCTC	GAGACACCGGTGATAAATGGTTGTTATGGGGTTCAGTGTCTGGATAGCCA	1	bc
TGCGCCTCAT	GAAACACCGGTTACAGTTGGCTGGTAGTGGGGTTAGAGCTAGAAATAGCA	1	bc
AGCCGAAAGA	GAAACACCGGTGGTCGCCGTGGAGAGGTGGGGTTAGAGCTAGAAATAGCA	1	bc
ACTACTCCAC	GCCACACCGGTGACATACGTATGTCAGTGGGGTTAGAGCTAGAACTAGCA	1	bc
ACAAAAAACT	GAAACACCGGTGGTAGGCGTGGAGAGGTGGGGTTAGAGCTAGAAATAGCA	1	bc
TTCCTCCACC	GAAACAGGGGTGAGATCCAGAAATAGCAAGGTATCATAAGGCTAGTCCGT	1	bc
GGAATACCTA	GAAACACCGGTGCGCATTATAACGTCGTGGGGTTAGAGCTAGAAATAGCA	1	bc
AAACCCCTCC	GAAACACCGGTTTTCTATGGATGCAAGGGGGGGTTAGAGCTAAAATAAGC	1	bc
GGACCAGACG	GAAACACCGGTCTTCCTGGAATCTACGTGGGGTAGAGCTAGAAATAGCAA	1	bc
AATTTCTCCC	GAAACAGGGGTTAGAGCTAGAACTAGCAAGTTAACCTAAGGCTAGTCCGT	1	bc
AAACAGGGAC	GAAACACCGGTTGTGGGGAACTCGGTGTGGGAGAAATAGCAAGTTAACCT	1	bc
CATTTACACC	GAAACACCGGTGGCAATTCGATCTGAGTGGGGTTAGAGCTAGAAATAGCA	1	bc
GACTAAATCA	GAAACACCGGTGCTCGTAGTTAGCTCGTGGGGTTAGAGCTTGAAATAGCA	1	bc
GCCTAATGCC	GAAACACCGGTGGCCGCAGTGGTGAGGAGTGGTTAGAGCTAGAAATAGCA	1	bc
CAGAGAACAC	GAAACACCGGTGGGCTTTACTCCTGTGTGGGGTTAGAGCTATAAATAGCA	1	bc
CCCACAAGCA	GAAACACCGGTGGCCGCCGTGTCTAGGTGGGGTTAGAGCTGGAAATAGCA	1	bc
ATGCGCATGA	GAAACACCGGTTTAGTATGGGGGGAAAGTGGGGTTAGGGAAAGAAATAGA	1	bc
TAAGGCCAGA	GAAACACCGGTTTGCTTAGTTATCTAGTGGGGTTAGTGCTCGAAATAGCA	1	bc
CAATCACATC	GAGACACCGGTGGCAGTGGTATCTGAGTGGGGTTAGAGCTAGAAATAGCA	1	bc
GTGCCAGAAA	GAAACACCGGTCTTCCTGGAATCTACGTGGGGTAGAGCTAGAAATAGCAA	1	bc
ACGATAGCAC	GAAACACCGGTTCGCTTTACTCCTTTGTGGGGTTAGAGCTATAAATAGCA	1	bc
TGATTTTCCT	GAAACACCGGTTCTCGTTAGCTCGAAGTGGGGTTATAGCTAGTAATAGCA	1	bc
AGACAAGAAT	GAAACACCGGTCTTCCTGGAATCTACGTGGTGTAGAGCTAGAAATAGCAA	1	bc
GGAAACGAGG	GAAAAACCTGTGTTAGTAAGGCATTGGTGGGGTTAGAGCGAGAAATAGAA	1	bc
AAATTCATCA	GAAACACCGGTTTAGTATGTAGGGAAAGGGGGGTTAGAGCTAGAAATAGC	1	bc
GCCTTAACAA	GAAACACCGGTTGGCTTTACTCCTTTGTGGGGTTAGAGCTATAAATAGCA	1	bc
GAACCCAAGG	GAAACACCGGTTTAGTGTGGAGGGAAGTTGAGGTTAGAGCTAGCAATAGT	1	bc
GCCTCAGACG	GAAACACCGGTTTAAGTAGCGTCTTTTTGGGGGTTAAGGCTGAAAATAGC	1	bc
TAATTGACAC	GAAACACCGGTTGAGATGATCAAAAAGTGGGGGAGAGCTAGAAATAGCAT	1	bc
AAAGCAACAA	GAAACACCTGTGACAAAAGTATGTCAGTGAGGATAGAGCTAGAAATAGAA	1	bc
CATCGGGCTA	GAAACACCGGTTGTGGCGAACTCGGTGTGGGTGAAATAGCAAGATAACCT	1	bc
CCCTTTATAA	GAAACACCGGTTGGCTTTACTCCTTTGTGGGGTTAGAGCTATAAATAGCA	1	bc
GAGGGCTCGC	GAAACACCGGTGAGGGACGGAGGTAAGAGGGGCAAGTGAACCAAAGAGCA	1	bc
TAATGAGTGC	GAAACACCGGTTGGGATCATCAAAAAGGGAGGTAGAGCTAGAAATAGCAA	1	bc
AGCCGAAAGA	GAAACACCGGTGGTAGCAGTGGAGAGGTGGGGTTAGAGCTAGAAATAGCA	1	bc
AGGTCAAAAC	GAAACACCGGTTTTCTTTGCGCAATGGTGGGGTTAGAGCTAGAAATAGCA	1	bc
GAAGCAGAAG	GAAACACCGGTGGGGGTAGAGCGAGAGTTGGGCTGGAACTATAAATAGCA	1	bc
AAGCCATGAG	GAAACACCGGTGACAAACGTATGTCAGTGGGGTTAGAGCTAGAAATAGCA	1	bc
GGTTCCTCCA	GAAACACCGGTGAGAACAGAACGTTAGAGCTAGAAATAGCAAGTTAACCT	1	bc
CCGTTCACGA	GAAACACCGGTGGGCTTCACGTTAACGTAGGGCTAGTCCGATATAAAGTT	1	bc
GTGCCAGAGA	GAAACACCGGTGTGCTGCAAGTTAACCTAAGGCTAGTCCGTTATCAACTT	1	bc
GGCTAGGAAC	GAAACACCGGTACTCTTTACTTACGGGTGGGGTTAGAGCTAGAAATAGCA	1	bc
CCTCCTGCAG	GAAACACCGGTGCTATTTCTAGAACTGGCAAGTTAGAGCTAGAAATAGCC	1	bc
AGCCGAAAGA	GAAACACCGGTGGCCGCCGTGGGGAGGTGGGGTTAGAGCTAGAAATAGCA	1	bc
ACATAGGAAC	GAAACACCGGTACTAGTTACTTACGGGTGGGGTTAGAGCTAGAAATAGCA	1	bc
GAATTCATGA	GAAACACCGGTGCTGTTAGTTAGCTCATGGCTTGAAATCGAGAGATAGCA	1	bc
AAACCAATAC	GAAACACCGGTGTAGTATGGAGGGAAGGGGGGGTAAGAGTTAGAAATAGC	1	bc
AACTCGCACA	GAAACACCGGTTGAAACTCGTTCTTAGTGGGGGTAGAGCTAGAAATAGCA	1	bc
TAATTATTTA	GAAACACCGGTTGAGATAATCAAAAAGTAGGGTAGAGCTAGAACTAGCAA	1	bc
ATAACCGTGC	GAAACACCGGTTTTAGAAGGAGGGATAGGGGGGTGAGAGATAGACATAGA	1	bc
GAAATATACC	GAAACACCGGTTAGCATAATCACATCGTGGGGGTTAGATATAAAAAGAAC	1	bc
AAAAACCGTG	GAAACACCGGTCCTGGAAGAGCTAGAAATAGCAATATAACCTAAGGCTAG	1	bc
ATTAAACCCG	GAAACACCGGTGCGCGGAGATTAACCGTGAGAATTAACCAAGAACCTACA	1	bc
GAACGATCTT	GAAACACCGGTGATCGCGGTTTCGAAGTGGGGTTAGAGCTAGAAATAGCA	1	bc
TCAGCAACCG	GAAACACCGGTGTGGTTAGAGCTAGAACGGGCATAGAAACATAAGTCGAA	1	bc
ATAAAACAGT	GAAACACCGGTGTGCGGAGATAATTAGTGGGGTAAAAGATGGAACCAACG	1	bc
GCCTATTTCC	GAAACACCGGTACTAGTGACTTATGGGGTGGGGTTAAGGCTAGAATTACA	1	bc
ACATACATCA	GAAACACCGGTGAGAACAGAAAGTTAGAGCTAGAAATAGCAAGTTAACCT	1	bc
CTACCACCAT	GAAACACCGGTTGCAAGCGAAGGTTTGTGGGGGTAGAGCTAGAAATAGCA	1	bc
