GCCAAAAGCT	GAAACACCGGTGGTCGCCGTGGGGTTAGAGCTAGAAATAGCAAGTTAACC	4	bc
GCCAAAAGAT	GAAACACCTGTGGTCGCCGTGGGGTTAGAGCTAGAAATAGCAAGTTAACC	2	bc
AATTGGGCAA	GAAACACCGGTTGTGGGGAACTCGGTGTGGGAGAAATAGCAAGTTAACCT	2	bc
AATAAAGAAA	GAAACACCGGTGCCCTTTATGGGACGGTGGGGTTAGAGCTAGAAATAGCA	1	bc
TCCTTCTTCT	GGAACACCGGTCGCGAAAATGTGCCGGTGGGGTTAGAGCTAGAAATAGCA	1	bc
AAATAAATGA	GAAACACCGGTTTGGGATGTGGGGTTGGGTCTAGAAATAGGATATTTAAG	1	bc
CAACGACGCA	GAAACACCTGTAGAATGGATCCACGGGTGGGGTTAGAGCTAGAAATAGCA	1	bc
ATCTCCACGA	GAAACACCGGTGTGCGGAGATTATTCGTGAGAAATAGCAAGTAACCTAAG	1	bc
TCGTCAATAC	GAAACACCGGTTGACATTATCCCTATGTGGGGTTAGAGTTAGCAATGGCA	1	bc
TCCTTCCTCC	GGAACACCGGTCTCGATAATGCGCCGGTGGGGTTAGAGTTAGAAATAGAA	1	bc
TCCTTCATCC	GAAACACCGGTTGAGATAATCAACAAGTGGGGTAGAGCCTGGAATTGGCA	1	bc
AAGATGATAC	GAAACACCGGTTTTCTATCATAGGTCGTGGGGTTAGAGCTAGAAATAGCA	1	bc
ACCTGCCCCC	GAAACACCGGTAGGAGGGAACTATGGGTGGGGTTTGAGAAGGAAATAACA	1	bc
CACCCGAATT	GAAACACCGGTGCTAGCGGTTTCGAAGTGGGGTTAGAGCTAGAAATAGCA	1	bc
AATCCCCTCC	GAAACACCGGTCACAAAAGTTGGCCGGGGGGTAGAGGTAGAAAAATAACA	1	bc
CAACCCCGCA	GAAACACCGGTATAATGTGTACGCGAGTGGGGTTAGAGCTAGAAATAGCA	1	bc
CAACGGGTGG	GAAACACCGGTCGAGTATGGGGGGGTTGGGGTTGAAATAGCAAGGTAACC	1	bc
ACGTTGCCAC	GAGACACCTGTTGGCTTTGCTCCTTTGTGGGGTTAGAGCTATAAATAGCA	1	bc
AACAAGAGAG	GAAACACCGGTGTTCGAGCATAAGCCGTGGGGATCGAGCTAGAAATAGCC	1	bc
GTACTATCTC	GAAACACCGGTGACAAACGTATGGCAGTGGGGTTAGAGCCAGAAATAGCA	1	bc
CATCTCGATT	GAAACACCGGTCTTCGTGGGGTAGAGCTAGAAATAGCAAGTTAACCTACG	1	bc
GCCAAACGCT	GAAACACCGGTGGTCGCCGTGGGGTTATAGCTAGAAATAGCAAGTTAACC	1	bc
GAATCATCAA	GAAACACCGGTTTTAGTAATTGCAAAGTGGGGTTAGAGCAAGACGTAGCA	1	bc
AGACAACCTA	GAAACACCGGTAATCTAAAGAGACCCGTGGGGATAGAGCTAGAAATAGAA	1	bc
GGACGGGATG	GAGACACCGGTGAGCGTGCGCTAGAAGTGGGATGATAACCAGAGGTAGGA	1	bc
CATTCGAAAC	GAAACACCGGTGGCAATTCGATCTGAGTGGGGTTAGAGCTAGAAATAGCA	1	bc
TGAATATCCA	GAAACACCGGTGCCCTTTATGGCGCCGTGGGGTTAGAGCTAGAAATAGCA	1	bc
CATTACCACC	GAAACACCGGTGGCAATTCGATCTGAGTGGGGTTAGAGCTAGAAATAGCA	1	bc
GTCATTTCTA	GAAACACCGGTTAGCATGAGCTCGCAGTAGCAAGATAACCTAAGGCTAGT	1	bc
CAGTTCCCAC	GAGACACCGGTTGGCTTTACTCATTTGTGGGGTTAGAGCTATAAATAGCA	1	bc
GACTTTTCAA	GAAACACCGGTACTGGTTACTTACCGGTGGGGTTAGAGCTAGAAATATCA	1	bc
AACACGCTCT	GAAACACCGGTTTTGGGTCGTAGATAGCTGGATTTAGCCTGTAAATCTCA	1	bc
TTAAACTTCG	GAAACACCGGTTGTTAGAGCTAAAAAGTTGCTAGAAGCTAGAAGTAATAC	1	bc
GTATTAGATG	GAAACACCGGTGTTCGTGAATTAGAAATGGGGTTATAACCTGAAACTGGA	1	bc
CCTCCGGATT	GAAACACCGGTTCAACTGGCGTCTTTTGGGGGGTTAGAGCTAGAAATAGC	1	bc
TCCTCGTACT	GAAACACCGGTTCAACCGGCCTCTTTGTGTGGGGATAGAGCTAGAAATAG	1	bc
TGTAAAGTAT	GAAACACCGGTAATCGAGGGGTAGAGCTAGGAATAGCAAGAGAAACTAAG	1	bc
TAGCCAGCTT	GAAACACCGGTCTTAGTAGATTGTGACTGGGGTTAGAAGGTTAAACTACA	1	bc
GCAAAAAGCT	GAAACACCGGTGGACGCCGTGGGGTTAGAGGGATAAATAGCAAGTTAACC	1	bc
AATTGGGCAC	GAAACACCGGTTGTGAGGGACTCGGTGTGGGAGTAATAGCAAGTTAACCT	1	bc
GATCCAGAAT	GAAACACCGGTGTTCGTGGGGAAGACGTGGGATTAGAACGAGAACCTACG	1	bc
GCCAAAATCT	CAAAACACCGGTGGTCGCCGTGGGGTTATAGCTAGAAATATCAAGTTAAA	1	bc
CCACGAGACC	GAAACACCGGTAGAATGGATTTCCGGGTGGGGTTAGAGCTAGAAATAGCA	1	bc
CAGCGAAGTG	GAAACACCGGTTATCGGGGTTAGAGCTAGAAATAGCAAGTTAACCTAAGG	1	bc
TTCGCACCGA	GAAACACCGGTGTGCGGAGATTATGCGTGAGAAATAGCACGTAACCTAAG	1	bc
GACACAATCC	GAAACACCGGTAATCTAAGGATCGCCGTGGGGATAGAGCTAGAAATAGCA	1	bc
AACACCCTCT	GAAACACCGGTGACGCGAGGACGTTGGTGGGGTTAGAGCTAGAAATAGCA	1	bc
CTTTTCCAAA	GAAACACCGGTGGCAATTCGATCTGAGTGGGGTTAGAGCTCGAAATAGCA	1	bc
CTCCACCCGC	GAAACACCGGTAGGCTGGATCTACGCGTGGGGATAGAGATGTAACTTGCG	1	bc
CGTTTAAAAC	GAAACACCGGTTTGCTTTACTCCTTTGTGGGGTTAGAGCTATAAATAGCA	1	bc
GGGCGAAGCG	GAAACACCGGTTATCGTTCGGACGTCTGGGGGGTTAGAGCTAGAAATAGC	1	bc
TCCAAACTCT	GAAACACCGGTGACGCGAGGACGGTGGTGGGGTTAGAGATAGAAATAGAA	1	bc
GACCCAGATT	GAAACACCGGTATTCGTGGGTTAGAGGTAGAAATAGAAATATAACCTAAA	1	bc
TCCACCAAAC	GAAACACCGGTGGGGTTAGAGCTAGAAATAGCAAGGTAACCTAAGGCTAG	1	bc
GTATAATAAA	GAAACACCGGTGAGCATGAGCTAGAAATGGGATGTTAACCTAAGGCTAGT	1	bc
GTTTTACATA	GAAACACCGGTGAGCATGCGCTAGGAGTGGGATGATAACCAAAGGCTAGA	1	bc
GCCTAACGCG	GAAACACCGGTTATAGGGGTTAGAGCTAGAGATAGCAAGTTAACCTAAGG	1	bc
TCCGCCCAAC	GAAACACCGGTGGGGTTAGAGTTAGAAATAGCAAGTTACCCTAAGGCTAG	1	bc
GTCAAACCTA	GAAACACCGGTGTGCTTTATGAGGTCGTGGGGGTTAGGAAAGAAAATAGA	1	bc
CCGATATCAA	GAAACACCGGTGAGCTTTACTCCGTTGTGGGGATAGAGCGATAAATAGCA	1	bc
CGCTTACTAG	GAAACACCGGTTTCAGATCATAGGTCGTGAGGTTAGGGTTTAAAATAGAA	1	bc
GTCACATACA	GAAACACCGGTGCGCATGATAACGTCCGTGGGGTTGTAGCTAGAAGTAGC	1	bc
TCATTCATCT	GAAACACCGGTGCCGAGAGGACGGTGGTGGGGCTAGAGATAGAAATAGCA	1	bc
GAGGGCGCAA	GAAACACCGGTGGGGTTAGAGCTAGAAATAGCGAGTTAACCTAAGGCTAT	1	bc
TCCCCCCGCT	GAAACACCGGTAGACTTGATCTACGGGTGGGGTTAGAGCTAGAAATAGCA	1	bc
CCACGACGAC	GAAACACCGGTAGAATTGATCCTCGGGAGGGGATAGAGATAGAAATAGAA	1	bc
CAATGTGCAA	GAAACACCGGTACTAGTTACTTACGGTTGGGGGTAGAGCTAGAAATAGTA	1	bc
GTGTTCTAGA	GAAACACCGGTGGGGTTAGAGCTACAAATAGCAAGTTAACCTAAGTCTAG	1	bc
GCGGGCGCGC	GAAACACCGGTGGGGTTAGAGCTATAGATAGCAAGTTAACCTAAGGATAG	1	bc
CCTACACAAC	GAAACACCGGTTAAACCGGTGTCTTTTGGGGGGTTAGAGTAGAAAAAGGC	1	bc
ACCGTTAACG	GAAACACCGGTTGGCTTTACTCCTTTGTGGGGTTAGAGCTATACATAGCA	1	bc
AATCCTGCCA	GAAACACCGGTGTAGTTTGGGGGACCGTGGGGTTAGAGCTAGAAATAGCA	1	bc
ACTAATCACG	GAAACACCGGTGCAATTTATGGGACCGTGGGGTTAGAGCCAAGAATAGCA	1	bc
CTGATCACCG	GAAACACCGGTTGGCTTTACTCCTTTGTGGGGATAGAGCTATAAATAGCA	1	bc
TGCACATACA	GAAACACCGGTTAGCATGAGCTAGAAATAGCAAGATAACCTAAGCCTAGT	1	bc
AATCTATATC	GAAACACCGGTGAGCAAGGGATAGAAATAGCAAGTTAAGCTAGGGCTAGC	1	bc
GGAATTTCTA	GAAACACCGGTTCGCATGAGCTAGTAATGGGAAGTTAACCTAAAACAAGT	1	bc
CCGTCCATGC	GAAACACCGGTTATCGCTAGTTCTCCTAAGGCTTAGAGCTTATAATAGTA	1	bc
TGTCCGCATG	GAAACACCGGTCTTCGTGGAGTAGAGCTAGGAATAGCAAGTTAACCTAAG	1	bc
ATCTACCTCA	GCAACACCGGTGTGCGGAGATTATGCGTGAGAAATAGCAAGTAACCTAAG	1	bc
GCATTAAACT	GAAACACCGGTGTTCTTTGCTCGCGGGTGGGGTTAGAGCTAGAAATAGCA	1	bc
CCGTGGGCTT	GAAACACCGGTCGTCGTTCGTAGGTCTAGAAATAGCAAGTTAATCTAACA	1	bc
CTTCTATAAA	GAAACACCGGTGAGCATGAGCTAGAAATAGCAAGTTAACCTAAGGCTAGT	1	bc
GCCAACAACA	GAAACACCGGTAATCTAAGGGTTCCCGTGGGGATAGAGCTAGAAATAGCA	1	bc
TTCCCACCCT	GAAACACCGGTGGGGAGCGAGGTATAGTGAGCTTATCAATCGAAATAGCG	1	bc
TATTTACAAC	GAAACACCGGTGGCGATTCTATCTGAGTGGGGTTAGAGCTAGCCGTTGTC	1	bc
TAATCAAGCA	GAAACACCGGTTATGGTAACGTAATTAGTGGGGAGTTAACCAGAAATTTG	1	bc
AATTCGGCAA	GAAACACCGGTTTACTTAGTTACCTAGTGGGGGTAGAGCCAGTTAAACCA	1	bc
GTCATGTTAG	GAAACACCGGTGAGCATGAGCTAGAAGTAGCAAGTTAACCTAAGGCTAGT	1	bc
GAATAATGCA	AGATGACGAAATACCGGTGCCCTTTATGGGAACGTGGGGTTAGAGCTAGA	1	bc
ACCATGCGCT	GAAACACCTGTTTTCGGTCTTAAGCCGTGGGTAGAGAGCTAGCAATAGCA	1	bc
ATACAACAAA	GAAACACCGGTGAGCATGAGCTAGAAATGGGGAGATAGCCTAAGATAGGA	1	bc
CCAACCCAAA	GAAACACCGGTGGCAATTCGATCTGAGCGGGGTTAGAGCTAGAAATAGCA	1	bc
CCTAAAGCAA	GAAACACCGGTGGTCGCCGAGGGGTTAGGGGTGGAAATAGCAAATTAACC	1	bc
ACGCTTGCCG	GAAACACCGGTGGCCTTTACTCGTCCGTGGGGTTAGAGCTAGAAATAGCA	1	bc
TCATACCTCC	GAAACACCGGTGGCGTGAGTGCGCAGGTGGGGTTAGAGCTAGAAGTAGCA	1	bc
CTACCACAAA	GAAACACCGGTTGTAATTGGTGGTTTGTGGGGTTAGAGCTAGAAATAGCA	1	bc
TCCACTCACT	GAAACACCGGTTCAACGTGGACCGTGGAGGGGTTAGTGCTAGTAAGAACA	1	bc
TAGATCTAAT	GAAACACCGGTTGAGATAGTGAACTGGTGGGGTTAGAGCTAGAAATAGCA	1	bc
TGAAAAAAAA	GAGACACCGGTGGGGTTAGAGCTAGAAATAGCATGTTAACATAAGGATAG	1	bc
CATACTTCCT	GAAACACCGGTGGCCGTTCGCTCTGAGTGGGGGTAGAGCTAGAAAATACA	1	bc
TTGACAGGCG	GAAACACTGGTCATCGGGGCTAGAGCTAGAAATAGCAAGATCACGTTAAC	1	bc
GCCAAAAGCT	CAAAACACCGGTGGTCGCCGTGGGGTTAGAGCTAGAAATAGCAAGTTAAC	1	bc
AGAAATATAT	GAAACACCGGTGAGCATGAGCTAGAAGTAGCAAGTTAACCTAAGACTAGT	1	bc
CTACGCGGCT	GAAACACCGGTAGTATAGGTTTAGTGGTGGGTATAGAGCTAGAAATAGCA	1	bc
ATATTAACCC	GAAACACCGGTCGCGAGAGTGGGCCGGTGTGGTTAGAGCTAGAAATAGCA	1	bc
GCGGCAAGAA	GACACACCGGTTATCTGAGTTAGAGCTATAAATAGCAAGTTTACCTCAGG	1	bc
CAGCGAGTTC	GAAACACCGGTCGTCGTTCGTAGGGCTAGAAATAGCAAGTTAACCTAAGG	1	bc
TGTCCTTCTT	GACACACCGGTCTTCGTTAGGTAGAGCTGGAGTTAGCAAGTTAACCTGAG	1	bc
TTGGGGGAAT	GAAACACCGGTCGTGGTTCGTAGGGCTAGAAATAGCAAGCTAACCTAAGG	1	bc
TTCTTCAACA	GAAACACCGGTGCTGATAGTTAGCTCGTGGGGTTAGAGCTAGAAATAGCA	1	bc
ATATAACCTT	GAAACACCGGTGTTAATAGATTATGCGTGTGAAATAGCAAGAAAACTAAG	1	bc
GATGGCGCAA	GAAACACCGGTGAGATACCTCTAGTGGGGGTAGAACTAGCAATAGCACGT	1	bc
TTCACCCCCT	GAAACACCGGTTTCGTAAGTATGCTGGTGGGGTTAGAGCTAGAAATAGCA	1	bc
ATCCCAGCTT	GAAACACCGGTCTTCGTGGGGTAGAGCTAGAAATAGCAAGTTAACCTAAG	1	bc
ACCACAGCAA	GCAACACCGGTGTTCTTTGCGCGATTTGGGGGGTTAAGGTTGAAATTGGA	1	bc
ACGTTAACGT	GAAACACCGGTTGGCTTTACTCCTTTGTGGGGTTAGAGCTATAAATAGCA	1	bc
AAATCAACGA	GAAACACCGGTTTAGGATGAGGGGTTGGGGGTAGAAATAGCAAAATAACC	1	bc
ACGGCGGGAA	GAAACACCGGTCGTCGTTCGTAGGGCTAGAAATAGCAAGTTAACCTAAGG	1	bc
TACCGCGGTT	GAAACACCGGTGGGTTAGAGCTAGGAGTAGCGTGTTAGCTAAATGCAGCA	1	bc
AATTGGGCAA	GAAACACCGGTCGGGGTGAACTCGGAGTGGGAGAAATAGCAAGTTAACCT	1	bc
AGTAATCACG	GAAACACCGGTGCTCTTTGCTGGACCGTGGGGTTAGAGCTAGAAATAGCA	1	bc
GTAACATCTG	GAAACACCGGTTTTCGTGAGTGGGGAGTGGGGTTAGAGCTAGAGATAGCA	1	bc
AGGCGGGCTA	GAAACACCGGTCGTGGGGCGTAGGGCTAGGGAGAGCAAGCTAACCTACGG	1	bc
GTCGCGAGAC	GAAACACCGGTGGGGTCAGAGATAGAATTGGCAAATTAACCGAAGGCTAG	1	bc
CATTCCCTCC	GAAGCACCGGTGACCTTTCGATCTGAGTGGGGATAGAGCTAGAAATAGCA	1	bc
CAGTAAACCC	GAAACACCGGTAATCTAAAGATCCTTGTGGGGATAGAGCTAGAAATAGCA	1	bc
CAGCTAATAC	GAAACACCGGTTGACTTTACTCCGTTGTGGTGTTAGAGCTATAAATAGCA	1	bc
CAGCGAGCAC	GAAACACCGGTTGGATTTATTTCTCTGTGGGGTTAGAGCTAGAAATAGCA	1	bc
GACATATTTA	GAAACACCGGTACTCATGACCTACGAGTAGCAATAGAACCTAAGGCTAGA	1	bc
CACTGTGGAC	GAAACACCGGTAGAATGGATTTACGGGTGGGGTTGAGCTAGAAATAGCAA	1	bc
GGACGGGATA	GAAACACCGGTCTTCATTAGAAGGGCTAGAAATATCAAGTTAACCTAAGG	1	bc
GTGTAAGCGA	GAAACACCGGTGGGGTTAGAGCTAGAAATAGCAAGTTAACCTAAGGCTAG	1	bc
TCATAAAAGA	GAAACACCGGTGGGGGTAGAGTTAGAAAGAGCAAGTTAACCTAACCTTAG	1	bc
AATTGGGCAA	GAAACACCGGATGGGGGGAACTCGGAGTGGGAGAAATAGCAAGTTAACCT	1	bc
CCACGCGTTT	GAAACACCGGTAGTATCGATCTACAGGTGGGGTTAGAGCTAGAAATAGCA	1	bc
GATGGCGCAC	GAAACACCGGTGGCAATAGTGCTAGAAATGGCGTGATAACCTAAGGCTAG	1	bc
AACATGTAAA	GAAACACCGGTTTTGGAACAGCGGGCGTGGGGATAGAGCTATAAATAGCA	1	bc
CGCTCTTCCA	GGAACACCGGTGCCCGCTACCTCGAGAAAGAGCGATATCATCTAACTCGA	1	bc
TAAATCCACC	GAGACACCGGTTTCCTTAGTTAACCGGTGGGGTTAGAGCTAGAAATAGCA	1	bc
GAAAAATACA	GAAACACCGGTGAGCATGAGCTAGAAGTAGCAATATAACTTAAAATTACA	1	bc
TTCCGCGCTT	GAAACACCGGTGGCGGAGGTTTACAAGTGGGGTTAGAGCTAGAAATAGCA	1	bc
GACAATTCCT	GAGACACCGGTAATCTAAAGATCCTCGTGGGGATAGAGCTAGAAATAGCA	1	bc
CATTTATATA	GAAACACCGGTGGCAATTCGATCTGAGTGGGGTTATAGCTAGAAATAGCA	1	bc
TCAACGGTAT	GAAACACCGGTGACGCTAGGGCGGTGGTGTGTTTGGAGCTCTAAGGATCA	1	bc
AGTTCGCCAA	GAAACACCGGTGTTAGATATAGCAAGGTGGGGTTAGAGTTAGAAGTAGCC	1	bc
ATTTCCCAAA	GAAACACCGGTCGAGAAATATCAATTTAACCTAAGGCTAGTCCGTTATCA	1	bc
AAAAATGACT	GAAACACCGGTGCCCTGTGTGGGACCGTGGGGTTAGAGCTAGAAATAGCA	1	bc
TCAAATATCT	GAAACACCGGTGACGCTAGGACGGTGGTGGGGTTAGAGCTAGAAATAGCA	1	bc
GAATAAGCAA	GAAACACCGGTTTTAGTTACTGGTGTGTGGGGTTAGAGCTAGAAATAGCA	1	bc
CCTCCACCCC	GAAACACCGGTTACAAACGTATGTCAAGTGGGGTTAGAGCTAGAAATAGC	1	bc
CAGTGAACTT	GAAACACCGGTTGGATTTACTCCTATGTGGGGTTAGAGCTATAAATAGCA	1	bc
TTTACCGACT	GAAACACCGGTCCTCGAGGGTGAGAGGTGGGGATAGAACGAGAAATTACG	1	bc
AGCTAGCAGC	GAAACACCGGTGTTCTTTGCTCGTGCGTGGGGTTAGACCAGGAAACAGCG	1	bc
CCTACTGACG	GAAACACCGGTGACCTTTGTGAGCCCGTGGGGTTAGAGCTAGAAATAGCA	1	bc
AAAAGGGATT	GAAACACCGGTTTTCGAGCATAGGTCGTGGGGTTAGAGCTAGAAATAGCA	1	bc
GACACTTCCA	GACACACCGGTGGGGTAAGGGCAAGAGAGAGCAAGTTAACCGAAAGCTAG	1	bc
CGTTCACACT	GAAACACCGGTGGCCGTTCGATCTGAGTGGCGTTAGAACTAAAGATAACA	1	bc
TTATCCTACT	GAAACACCGGTTGCGTCAGTTTGCTAGTGGGGTTAGAGCTAGAAGTAGCA	1	bc
AAATCAATTA	GAAACACCGGTTTCGTATGTAGGGTTAGGGCTAGAGATAGACAGTTAACA	1	bc
GACTCGAGCC	GAAACACCGGTTAAAGCGGCTAGAGCTGGGGAGAGCAAGTTAGCCTAAGG	1	bc
ATGATCTCCG	GAAACACCGGTCATAAAAATGAGGTGGAGGGGTTGAAATTAGAAATTAAC	1	bc
ATCTACACGC	GAAACACCGGTATTCGGAGATTATGCGTGAGAAATAACCAGTAAACTAAG	1	bc
AGCCGCCGAA	GAAACACCGGTAGAATGGATCCACGGGTGGGGTTAGAGCTAGAAATAGCA	1	bc
GTAAGGGGTG	GAAACACCGGTGGGGTTAGAGCTAGACATAGCAAGTTAACCTAAGGCTAG	1	bc
AAATAAATAC	GAAACACCGGTTGAGATAATCAAAAAGTGGGGTAGAGCTAGAAATAGCAA	1	bc
CTACTAGATC	GAAACACCGGTTTTCGTGAGTTATAGCTAGAAATAGCAAGTTAACCGAAA	1	bc
GCCAAACGAT	GAAACACCGGTGGTCGCCGTGGGGTTAGAGCTAGAAATAGCAAGTTAACC	1	bc
AATTGGGCAC	GAAACACCGGTTGTGGGGAACTCGGTGTGGGAGAAATAGCAAGTTAACCT	1	bc
TCCTCGCTCT	GAAACACCGGTGCAGCGGGCGCGGTGGTAGGGTTAGAGATAGCAAGATAA	1	bc
GTCATGTATG	GAAACACCGGTGAGCGTGAGCTAGACATGGCAAGTTAACCTAAGGCCAGA	1	bc
CGGAGGCAAG	GAAACACCGGTCTACGTACGTAAGTATAGGAATTGGAGGTAAAAATAGGA	1	bc
AGAAATATCT	GAAACACCGGTGAGCATGAGATAGAAATAGCAAGATAGACTAAGGCTAGT	1	bc
ATCAACCCTA	GAAACACCGGTGACGCGAGGACGGTGGTGGGGTTAGAGCTAGAAATAGCA	1	bc
ATCAAACTAG	GAAACACCGGTGTGCGGAGATTATGCGTGAGAAATAGCAAGTAACCTAAG	1	bc
CTTCCAGACT	GAAACACCGGTCCTAGAAGCTGGGTTAGAAGGTGGGGTTAGAGCTAGAAA	1	bc
TGACCTTCCC	GAAACACCGGTGGGGTTATAGCTAGTAATAGCAAGTTAACCTACGGCTAG	1	bc
AAACCGGCGA	GAAACACCGGTTTAGTATGTGGTGTTAGAGCTAGAAATAGCAAGTTAACC	1	bc
AACACTTCAG	GAAACACCGGTTTTCGATCATAGGTCGTGGGGTTAGAGCTAGAAATAGCA	1	bc
AACCTGCGCC	GAAACACCGGTTTTCGATCATAGGTCGTGGGGTTAGAGCTAGCAATAGCA	1	bc
ACACGCCGAC	GAAACACCGGTAGACTGGATTCACGGGTGGGGTTAGAGCTAGAAATAGCA	1	bc
AACAAACTAA	GAAACACCGGTGTTCGGTCATAATGCGTGGGATATAGCAAGGAACTAAAG	1	bc
TAACGACTCC	GAAACACCGGTTGAAATAGTCAGTAAGTGGGGAAATAGCAAGAAAAGCAA	1	bc
GAATAGCAAC	GAAACACCGGTGTTCTTTGCTCGCTGGTGGGGTTAGAGCTAGAAATAGCA	1	bc
TGTCCATCTC	GAAACACCGGTCTTCAAGGGGTAGAGCTGGGAATAGCAAGTTAAACTAAT	1	bc
CATTCACCCC	GAAACACCGGTGGCCGTTAGATCTGAGGGGGATTAGAGCTAGTACTAACA	1	bc
AATCGATGCC	GAAACACCGGTAGCATGGATCTACGGGTGGGGTTAGAGCTAGAAATAGCA	1	bc
TCAATCCCAA	GAAACACCGGTTGAGTATGGGGGGGTAGAGCTAGAAATAGCAAGATAACC	1	bc
TCGGCCAACA	GAAACACCGGTGGGGTTAGAGCTAGAGATGGTAAGTTAACCTAAGGCTAG	1	bc
ACTTTTCCAA	GAAACACCGGTGGCAATTCGATCTGAGTGGGGTTAGAGCTAGAAATAGCA	1	bc
AATCGAAAAA	GAAACACCGGTGACAAAAGTATGTCAAGTGGGGTTAGAGCTAGAAATAGC	1	bc
AGTAAGGCAG	GAAACACCGGTGCCCTTTATGGGACCGTGGGGTTAGAGCTAGAAATAGCA	1	bc
AATCGCGTAA	GAAACACCGGTTTTGTAGGAGTGGGTGGGGCTGGAAATGGCAGTTAAACC	1	bc
TCAACAATAT	GAAACACCGGTGACACGAGTACGGTGGTGGGGTTAGAGCTAGAAATAGCA	1	bc
AACGGGCAGG	GAAACACCGGTTTGCGATCTCAGGTCGTGGGGTTAGAGCGTGAAACAGCA	1	bc
CACGAGGTTT	GAAACACCGGTGCTAGCGGTTTCGAAGTGGGGTTAGAGCTAGAAATAGCA	1	bc
CCCCGAGACC	GAAACACCGGTGCTAGCGGTTTAGAAGTGGGGTTAGAGCTAGAAATAGCA	1	bc
ACCCGCGCCC	GAAACACCGGTAGAATGGAACCACGGGTGGGGGTAGAGCTAGAAATAGCA	1	bc
ATGCAACAAC	GAAACACCGGTGATAAGCGAAGGTTTGTGGGGTTAGAGCTAGAAATAGCA	1	bc
AAATTAACCA	GAAACACCTGTTGGGGTAGTCAAAAAGTGGGGTATAGCTAGAAATATAAG	1	bc
AATTGGGCAG	GAAACACCGGTTGTGGGGAACTCGGTGTGGGAGAAATAGCAAGTTAACCT	1	bc
CGGTCGGATG	GAAACACCGGTGGTCGTTCGTTGTGCTAGAGATAGCAAGTTAACCTAAAG	1	bc
TAATATCTAA	GAAACACCGGTACTAGTTACTTACGGGTTGGGTTAGAGCTAGAAATGGCA	1	bc
AATATACTAA	GAAACACCGGTGTTAATTCGTTCTGCGTGGGGTTAGAGCTAGAAATAGCA	1	bc
