CACCGCCTCA	GAAACACAGGTAGAATGGATCCACGGGTGGGGTTAGAGCTAGAAATAGCA	2	bc
AACCAATGAC	GAAACACCGGTTTAGTATGGAGGGATTAGAGCTAGAAATAGCAAGTTAAC	2	bc
AGACAACCTA	GAAACACCGGTAATCTAAAGATCCCCGTGGGGATAGAGCTAGAAATAGCA	2	bc
ATAACCGACC	GAAACACCGGTGTGCGGAGATTATGCGTGAGGAATAGCAAGTAACCTAAG	2	bc
TGAACCAAGT	GGAACACCGGTTTACTTAGGGGTTAGAGCTAGAAGTAGCAAGTTAACCTA	2	bc
ATCCAAGAGA	GAAACACCTGTGTGCGGAGATTATGCGTGAGAAATAGCAAGTAACCTAAG	1	bc
CCCCTAAGCC	GAAACACCGGTAGAATGGATCCACGGGTGGGGTTAGAGCTAGAAATAGCA	1	bc
GCAATGCTCA	GAAACACCGGTGAGGCGAGGACTGTGGTGGGGTTAGAGATAGAAATAGCA	1	bc
ATGCCCTTCT	GCCTAAACACCGGTCCTCTCATCTGAGTGGTTTTCTAGCTAGAACTCTCA	1	bc
CCAAGCAGCA	GAAACAACGGGAGGATGGATAGCCGGGGGGGGTTAGAGAAAGAAATAGCA	1	bc
AAATGGGTGA	GAAACACCGGTTTGGTGTGGAGAGACTAGAGATAGAAATAGCAAGCTAAC	1	bc
ATGACAGAAG	GAAACACCGGTCGCAGATCAGTCAGAATTAGGATGTAAATATAAAGATCG	1	bc
ATTATAGAAA	GAAACACCGGTGGGCATTATAACGTCGGGGGGTTAGAGGTTAGAATTAGC	1	bc
GAATGAGCAA	GAAACACCGGTGATGATGATAACGTCGGTGGGGTTAGAGCTAGTTATAGC	1	bc
TGAACTAAAA	GAAACACCGGTTCCCGTTAGCTCGTAGAGGGGTTAGAGATAGAAATAGAA	1	bc
AATCCCTCGA	GAAACACCGGTTTCGTACGGAGGGATTAGAGTTAGAAATAGCAAGTTACC	1	bc
AATTCTGCAG	GAAACACCGGTGCCCATTAGGGGACCGTGGGGTTAGAGCTAGAAATAGCA	1	bc
CAGTCGAACC	GAAACACCGGTTAAACTGACGTATTTTGTGGGGTAAGACATAAAAAAACA	1	bc
TTAATCTCTC	GCACCACCGGTGGCGATAATGACGTCCTTGGCTTGGTAACCGCCGGCTCG	1	bc
TTTTGGTCAC	GAAACACCGGTCGCGGGGATGTCGGGGTGGGGGTAGAAGTAAGACGTCCA	1	bc
ATGGCCCACT	GAAACACCGGTTGTAAGCGATGGTTTGTGGGGTTAGAGCTAGAAATAGCA	1	bc
AAGACTGTAG	GAAACACCGGTCCTAGAAGCTTAGGGGGGGGATTGGAGGTAATAGCAGCA	1	bc
ATCTTTCCCC	GAAACACCGGTCGCGAAAATGTGGGGGTAGAGCTAGAAATAGCAAGTTAA	1	bc
TATACCGACT	GAAACACCGGTGCACTTAGTTAGCCCGTGGGGTTAGAGCTAGAAATAGCA	1	bc
TGGCCCGCTT	GAAACACCGGTCTTCCTAGCGTCCACGTGGGGTTAGACTTAGAAACACCA	1	bc
AGAATAAGCC	GAAACACAGGTTTTAGTAAATGGTGAGTGGGGTTAGAGCTAGAAATAGCA	1	bc
ATTACCGCCA	GAAACACCGGTCCTAGAAGATGAGTTGGGTTAGAGCTAGAAATAGCAAGT	1	bc
AACTTACAAC	GAAACACCGGTTTTCTATCATAGTTTGTGGGGTTAGAGCTAGAAATAGCA	1	bc
GAGAGCGAGT	GAAACACCGGTTTAGTTAGAGGTTAGAACTGCAAGTAGCACTTTGACCTG	1	bc
ACCTAGCCCC	GAAACACCGGTTCAAGCGGAGTCTTTTGGGGAGTTAGAGATAGAAATAGC	1	bc
CCGTGAGCTG	GAAACACCGGTTGTCGTTCGTCGTGCGTGGGGTTAGAGCTATAAATAGCA	1	bc
TTAATCTTCC	GAAACACCGGTGACGCGAGTGCGGGGGTAGGGCTAGAGCTAGCAAGATCA	1	bc
AGGAGCGACG	GAAACACCGGTCGTCTTTCGTAGGGCGTGGGGTTAGAGCTAGAAATAGCA	1	bc
AACTAATTAC	GAAACACTGGTGACAAACGCATGTCGGTGGGGTTAGAGCTAGAAATAGCA	1	bc
CAATCAAGAG	GAAACACCGGTTACCGTTACGGATTTGTGGGGTTAGAGCTAGAAATAGCA	1	bc
GACAACAGAA	GAAACACCGGTGGTAGGGATTGACCTGGGGGGTGAGAGCTAGAAATAGCA	1	bc
CGTCGGTCCA	GAAACACCGGTGAGAATAGTAAGCTCGTGGGGTTAGAGCTGGAATTAGCA	1	bc
CCACCCCTAT	GAACAACCGGTGACTCTAGGACGGTGGGGGGTTTAGAGCTAGAAATGACA	1	bc
AAACCCTCGT	GAAACACCGGTTTAGTATGTAGGGATTTAGGCCAGAAATAGCCAGGTAAC	1	bc
GAATTACGAG	GAAACACCGGTTTTCGTAAATGGTGCGTGGGGTTAGAGCTAGAAATAGCA	1	bc
GAGTCTTCCT	GAAACACCGGTTATCGTTACGGATTTGTGGGGTTAGAGCTAGAAATAGCA	1	bc
AGGAGTTTTG	GAAACACCGGTTGTCGTTAGTAGGGAGTGGGGTTAGAGCTAGAAATAGCA	1	bc
AGACCCGAAG	GAAACACCGGTGCTATTTGCTGGGGGGGGGTGTTACTACAAGTAACAGGT	1	bc
TCCGCCCCCT	GAAACACCGGTCGCGTAAGTGCGGGGTTAGAGCTATAAATAGCAAGCTAA	1	bc
TTCTCATCCT	GAAACACCGGTCGCGCAAATGTGGGGTTAGAGCTAGAAATAGCAAGTTAA	1	bc
TAATCAGCAA	GAAACACCGGTTTTCGTAGCTTACTTGTGGGGTTAGAGCTAGAAATAGCA	1	bc
GAGTGGGAAG	GAAACACCGGTGCTCGTACTTAGCGCGTGGGGTTAGAGCTAGCAAGAGAA	1	bc
CAATTGAACC	GAAACACCGGTTCAGACGGCGACTTTTGGGGGGATAGAGCTAGAAATAAC	1	bc
TACCAGGTAG	GAAACACCGGTAGTAGTTAGTAAGGGGTGGGGTTAGAGCTAGAAATAGCA	1	bc
GGACCCTTCA	GAAACACCGGTTTCATCCCGCCACTTGTGGGGTTAGAGCTAGAAATAGCA	1	bc
GACTCACTAA	GAAACACCGGTGGCAATTCGATCTGAGTGGGGTTAGAGCTAGAAATAGCA	1	bc
AAGATAAACG	GAAACACCGGTCCTAGTAGTTAACTCGGGGGGGTAAGAGCTAGAAATAGA	1	bc
GAAATAGATT	GAAACACCGGTGTTAGCGGTTACGAAGTGGGGTTAGAGCTAGAAATAGGA	1	bc
ATATAAAAAC	GAAACACCGGTGTGCTTTGCTTAAGGGTGGGGTTAGAGCTAGAAATAGCA	1	bc
AGCTAAGCGT	GAAACACCGGTCTTCGTAGATTATACGTGGGGATGAGCTAGTAATAGCAA	1	bc
TTAACCCACC	GAAACACCGGTTGCGATAGTGAAGTAGTGGGGTTAGAGCTAGAAAGAGAA	1	bc
GATTCAGCAA	GAAACACCGGTACTAGTTGCTTACGGGGGGGGTTAGAGCTAGAAATAGCA	1	bc
TCCTATGAAA	GAAACACCGGTTCAACCGGCGTCTTTTGTGGGGTTAGAGCTAGAAAAAGC	1	bc
AAATCACACA	GAAACACCGGTTGTAAGCGATGGTTTGTGGAGTTAGAGCTAGAAGTAGCA	1	bc
TATCCTGACG	GAAACACCGGTCTTCTTGGTATCTACGTGGGGTTGAGCCTGGAATTGCCA	1	bc
GTGGGCGGCG	GAAACACCGGTGAGCTGCCTCACCGGTGGGGTTAGAGCTAGAAATAGCAA	1	bc
CCCAGTTGCC	GAAACACCGGTAGAATGGATCTACGGGTTGGGTTAGAGCTAGAAATAGCA	1	bc
GGGATGGATG	GAAACACCGGTCGTCGTTCGTAGGGCGTGGGGTTAGGGCTAGAAATAGCA	1	bc
TTCGTCCAAA	GAAACACCGTTGTTGTTTGTTCGAGGGTGGGGTTAGAGCTAGAAATAGCA	1	bc
AGCCCGTCCT	GAAACACCGGTTCCCGTTAGCTCGGAGTGGGGTTAGAGCTAGAAATAGCA	1	bc
AAATCAAAAC	GAAACACCGGTGATAAACGTATGTCAGTGGGGTTAGAGCTAGAAATAGCA	1	bc
GACTCAGAAA	GAAACACCGGTAGTAGTTGCTTACGGGTGGGGTTAGAGCTAGAAATAGCA	1	bc
ACACGACGCC	GAAACACCGGTAGAATGGATCCACGGGTGGGGTTAGAGCTAGAAATAGCA	1	bc
AGACAATCAC	GAAACACCGGTGTTCTTTGCTCGAGGGTGGGGTTAGAGCTAGAAATAGCA	1	bc
ATGCACGTAG	GAAACACCGGTCCTAGAAGCTGAGTGGGGTTAGAGCTAGGAATAGCAAGT	1	bc
AAAACCAAAA	GAAACACCGGTTTACTTAGGGGTTAGAGCTAGAAATAGCAAGTTAACCTA	1	bc
TTAGCCAACA	GAAACGCCGGGGGGGTTAGAGCTAGAAATTGCAAGTTAAACTAAGGCTAG	1	bc
AAACTGTGTA	GAAACACCGGTACTAGTTACTTACGTGTGGGGGTAAAGCTAAACATAGCC	1	bc
TAGTTAATAC	GAAACACCGGTTGGTATAATTACTTTGTGGGGTTAGAGCTATAAATAGCA	1	bc
AGGATAGCCA	GAAACACCGGTGGTCTTTGCTGGAGGGTGGGGTTAGAGCTAGAAATAGCA	1	bc
AAACCCGTCG	GAAACACCGGTTTAGTATGGAGGGATTAGAGCTAGAAATAGCATGGTAAT	1	bc
TACACATAAA	GAAACACCGGTTTGCGTTGATCTGGAGAGGGCAAGGTACTCGAAGTAGCA	1	bc
CGACCAACTT	GAAACACCGGTGCTAGAAATAGCAAGTTAACCTAAGGCTAGTCCGTTATC	1	bc
TTCTCCGCGA	GAAACACCGGTCGCGAACATGAGGGGTTAGAGCTAGAAATAGCAAGTTAA	1	bc
CCACCCCACA	GAAACACCGGTTTAACCTGCATGGTAGGGGGGTTAGAGCTCGAAATAGCC	1	bc
GAACTAAGCG	GAAACACCGGTGATCATGATACCTTTGTGGGGTTAGAGCTAGAAATAGCA	1	bc
CTCTCACCAA	GAAACACCGGTGGGAATAGGTTATGAGTGGGAATAGAGCTAGAAACAGAA	1	bc
TAAAGAGAAT	GAAACACCGGTTTACTTAGGGGTTAGAGGTGGAAATAGCAAGTTAACCTA	1	bc
AAGATAACAC	GAAACACCGGTTGGCTTTACTCCTTTGTGGGGTTAGAGCTATAAATAGCA	1	bc
GGAATAAAAT	GAAACACCGGTGCTAGTAGGTAGGTCGGGGGGGTAGAGGTAGAAGTAGGA	1	bc
CTGCCTGCCT	GAAACACCGGTCCTAGTTAACTCGTAGTGGGGTTAGAGCTAGAAATAGCA	1	bc
TAACTACCCT	GAAACACCGGTTTACTTAGTGGTTAACGGTGGAAGTCGCAAGTTAACCTA	1	bc
TGACCGCAAA	GAAACACCGGTGTTCTTTGATCGAGAGATGGGATATAGCTCGAAATAGCA	1	bc
AGGCTGGCAC	GAAACACCGGTGTTCTTTGATCGAGGGTGGGGTTAGATCTAGAAATAGCA	1	bc
GTAATGTAGC	GAAACACCGGTGAGCATGATACCGTCCATAGCATGTTAACCTAAGGCTAG	1	bc
TTTTCCTCCA	GAAACACCGGTGGGGACAATGCGGGGTTAGAGTTAGAAATAGAAAGGCAA	1	bc
CAGTCGGGCG	GCAACACCGGTTATCGTTCGGGGGGTGTGGGGTTAGAGCTAGAAATAGCA	1	bc
AAACCCACCG	GAAACACCGGTTTTAGTAAATGGTGAGTGGGGTTAGAGCTAGAAATAGCA	1	bc
GGATCAGAAA	GAAACGCCGGTTTTCTTTACTAGTGGGTGGGGTTAGAGCTAGAAATAGCA	1	bc
TATACCCCAA	GAAACACCGGTTTACTTAGGGGTTAGAGCTGGAAATAGCCAGTTAACCTA	1	bc
CGCACCACCC	GAAACACCGGTTCCCGTAAACTCGGAGTGGGGGTAGAGCAAGAAAAAGCA	1	bc
TCTTCCGACT	GAAACACCGGTTTAACTGGAGTCTTTTAGGGGTGGGGCTAGAGCTAGAAA	1	bc
GTCTCACCGG	GAAACACCGGTGTGAGGAGATTATGAGTGAGAAATAGCCAGTAACCTAAG	1	bc
GAGAAAGCCG	GAAACACCGGTGCCCTTTATGGGATCGTGGGGTTAGAGCTAGAAATAGCA	1	bc
AAAATCCTCT	GAAACACCGGTGTTCCATCGTAGGTAGTGGTATTAAAAGTAGGATTAGCT	1	bc
AAATCAATGC	GAAACACCGGTTTAGTATGGCGAGATTAGAGCTAGAAATAGAAAGATAAC	1	bc
GAATAATACG	GAAACATCGGTGGCAGTCAGCCATGTGTGGGGTTAGAGCTAGAAATAGCA	1	bc
AGACCTCCCC	CTCCCCCCCGGTGTTCTTTTCTCGAGGGTTTTTTTAGAGCTATCCCTATC	1	bc
CGTCTAACTT	GAAACACCGGTTTGCTTTGAATCTATGTTGGGTTGAGCTAGTAATAGCAA	1	bc
GAGACCAGCC	GAAACACCGGTAATCTATACGGATTTGTGGGGTTAGAGCTAGAAATAGCA	1	bc
AATCATGCAA	GAAACACCGGTGCCAGTTACTTCCAGGTGGGGTTAGAGCTAGAAATAGCA	1	bc
ATGTCAACCG	GAAACACCGGTGAGCGGTGCGGATGTGAGAGATAGAGAAAGCAAGCTAAG	1	bc
AGACCATCAA	GAAACACCGGTGCTAGAAGTAGCAAGTTAGCCTAAGGCTAGTACGTTATC	1	bc
CGTCCGGCAG	GAAACACCGGTCACCGTTCGTAGGGCGTGGGGTTAGAGCTAGAAATAGCA	1	bc
AACATGGATG	GAAACACCGGTTTTCGTTCATAGGTCGTGGGGTTAGAGCTAGAAATAGCA	1	bc
ACTCGCCGCA	GAAACACCGGTAGAATGGATCCACGGGTGGGGTTAGAGCTGGAAATAGCA	1	bc
GAATCGCACC	GAAACACCGGTTTTAGCAGATGGTTATGGGGGGTTGAGCTAAAAATAACA	1	bc
AGATAAAAAC	GAAACACCGGTGTTCTTTGCTCGCGGGTGTGGTTAGAGCTAGAAATAGCA	1	bc
CGACGATCCA	GAAACACCGGTGCTAGAGATAGCGAGTTCAGCTTAGGCTTGCAAGTTCTA	1	bc
CCTCGCCGTT	GAAACACCGGTAGTCTGGATCTCCGGGTGGGGTTAGAGCTAGAATAACCA	1	bc
TGAGCACCCA	GAAACACCGGTGGGCGTAGACCTAGAAAGAGGATATAAATCTAAGGAGAG	1	bc
ACCCGTCGAC	GAAACACCGGTGGAATGGATCCACGGGTGGGGTTAGAGCTAGAAATAGCA	1	bc
AACCACATCA	GAAACACCGGTTTAGTATGGAGGGATTAGAGCTAGAAATAGCAAGTTAAC	1	bc
CATAAAGCCA	GAAACACCGGTGACCTTTATAGGACTGTGGGGTTAGAGCTAGAAATAGCA	1	bc
CGCTTACCCA	GAAACACCGGTAGGAAGTTAAAGCTATAGGGATAGAGTTAGAAATAGAAA	1	bc
AGGACCTCCG	GAAACACCGGTTCCCGTTATCTCGTGGTGGGGGTAGAACAATAAACAGCA	1	bc
GAATTATCCA	GAAACACCGGTGTTGGTAATAGGTTAGAGGGGTTAGAGCTAAAAATAGCA	1	bc
GCAGGCAAGA	GAAACACCGGCGGGGTGACTCAAGTGCAATAAAAAGTAAGCTAACGTAAG	1	bc
CGCAGCTGGT	GAAACACCGGGAGAAAGGACCCAAGGGAGGGGGTAGAGCTAGAAATAGCA	1	bc
TTATAACTGA	GAAACACCGGTGTGCGGAGATTATGCGGGAGAAATAGCAAGTATCGTAAG	1	bc
ATCAACACTC	GAAACACCGGTGACGCGAGGACGGTGGTGGGGTTAGAGCTAGAAATAGCA	1	bc
ACGCGAAAAA	GAAACACCGGTTTTCTATAAGGCGTTGTGGGGATATAGCTAAATATAGCA	1	bc
TGTTGGGATA	GAAACACCGGTTGTGGGGAACTCGGTGTGGGAGAAATAGAAAGTTAACAT	1	bc
TCCCTAGCAC	GAAACACCGGTTCAACCGGCGTCTTTTGTGGGGTTAGAGCTAGAAATAGC	1	bc
ATAGCAAACA	GAAACACCGGTGTGGTTAGATGTGGAGATTGCAAGCTAGCCTAAGCCAGT	1	bc
TCACCAAATT	GAAACACCGGTCTTCCTAGAATCTGAGAGGGCAAGTGATCGTAATAGCAA	1	bc
AAAGCCAAAA	GAAACACCGGTGGGGTTAGAGCTAGCAATAGCAAGTTAACCTAAGGCTCG	1	bc
TACCCAGTTT	GAAACACCGGTCTTCCTGGAATCTACGTGGGGTAGAGCTAGAAATAGCAA	1	bc
ACATAGCAAA	GAAACACCGGTGGTCTTTGCTAGAGAGTTGGGTTAGTGCTAGAATTATCA	1	bc
GCGGCGGAGA	GAAACACCGGTGAAATCCCTCACCGGTGGGGTTAGAGCTAGAGATAGCAA	1	bc
TGCATTTAAT	GAAACACCGGTTCCCGTTAGCTCGTAGTGGGGTTAGAGCTAGAAATAGCA	1	bc
GACAATGATT	GAAACACCGGTACTAGATACTTAGGGGTGGGGTTAGAGCCAGAAATAGCA	1	bc
AAACCAGCAG	GAAACACCGGTTTTAGTAAATGGCGAGTGGGGTTAGAGCTGGAAATAGCA	1	bc
AACTTCTTCC	GAAACACCGGTTGTGAATATGTGGTGTTAGGGTTAGAAATAGCAAGTTAA	1	bc
AACCTACTTT	GAAACACCGGTTTTCCATCAAACGACTTGGGGTTAAACCTGGAAATACAA	1	bc
AGAGTAAAGC	GAAACACCGGTTATCGTTACGGATTTGTGGGGTTAGAGCTAGAAATAGCA	1	bc
AGAACTAACA	GAAACACCGGTTCCAGTTGGCTCGTTGTGGGGTTAGAGATAGAAATAGCA	1	bc
TTATTATTCC	GAAACACCGGTCGCGAAAATGTGCCTGTGGGGTTGAGGTAGAAAAAGCAA	1	bc
TAAACAACAT	GAAACACCGGTTTACTTAAGGGTTAGAGCTAGAAATAGCAAGTTAAACTA	1	bc
GGATTGCAAC	GAAACACCGGTGTTCTTTGCTCGAGCGTGGGGTTAGAGCTAGAAATAGCA	1	bc
AACAATGCTT	GAAACACCGGTGCCCTTTATGGGACCGTGGGGTTAGAGCTAGAAATAGCA	1	bc
GGGAGGGATG	GAAACACCGGTCGTCGTTAGTAGGGCGTGGGGATAGAGCTAGAAATAGCA	1	bc
CCCCGACCAC	GAAACACCGGTAGAATGGATCCACGGGTGGGGTTAGAGCTAGAAATAGCG	1	bc
CCACTAAAAC	GAAACACCGGTGGGCTTTACTCGTTTGTGGGGTTAGAGCTATAAATAGCA	1	bc
GTAAAGTATC	GAAACACCGGTGAGCATGATAACGTCCATAGCAAGTTAACCTAAGGCTAG	1	bc
CAAATACAAC	GAAACACCGGTTTGCTTTACTCATTTTTGGGGTTATAGCTCTAGATAGAG	1	bc
GAACCAGCTT	GAAACACCGGTCTTCGTAGATGGTGAGTGTGGTTATAGCTAGAAATTGCA	1	bc
GTCATATAAC	GAAACACCGGTGAGCATGATAACGTCCATAGCAGGTTAACCTAAGGCTAG	1	bc
ACCCACGCCC	GAAACACCGGTAGAGTATATCGGCGTGTGGGGTTAGAGCTAGAAATAGCA	1	bc
AATAAAGCAC	GAAACACCGGTGACAAACGTATGGCAGGGGGGGTAGAGCTAGAAATAGCA	1	bc
CAGCGAACTT	GAAACACCGGTTGGCTTTACTCCTTTGTGGGGTTAGAGCTATAAATAGCA	1	bc
CGCCGCCATT	GAAACACCGGTGGTCTGGATACAAGGGTGGTGTTAGAGCGAGAGATAGCA	1	bc
AACACACAAT	GAAACACCGGTTTACTTAGGGGTTAGAGCTAGAAATAGCAAGTTAACCTA	1	bc
TTCTCACATC	GAAACACCGGTCTTCCTGGAATCTACGTGGGGGAGAGCTAGAAATATAAA	1	bc
AAAGCACTAA	GAAACACCGGTGGTGGTAGAGCTAGAAATAGCAAGTTAACCTAAGGCTAG	1	bc
TCATTCACCC	GAAACACCGGTGGGGATAGTGATAGATTTATGTTGGAAATCGAAAGCTAA	1	bc
AATACCGAAA	GAAACACCGGTTTAGGAAGAGGCGAGGGGGAAGAATTAGAAAGTAAACCT	1	bc
TAACTCAAGA	GAAACACCGGTGCTAATAGTTAGCTCGTGGGGTTAGAGCTAGAAATATCA	1	bc
ACCCGACGAC	GAAACACCGGTAGCATGGATCCATGGGTGGGGTTAGAGCTAGAAATAGCA	1	bc
TCCAAATACG	GAAACACCGGTGGCAGCAAGCCACTTGTGGGGTTAGAGCTAGAAATAGCA	1	bc
AAAAACCACT	GAAACACCGGTGCACTTTATGGGACCGTGGGGTTAGAGCTAGAAATAGCA	1	bc
AATACCGCAA	GAAACACCGGTTGTGTGGAATTCGGAGTGGGGGTAATAGTAAGTTAAGCT	1	bc
TTTCAAGCTT	GAAACACCGGTCTTCCTGGAATCTACGTGGGGTAGAGCTAGAAATAGCAA	1	bc
ATATCAAAAT	GAAACACCGGTTGTAAGCGATGGTTTGTGGGGTTAGAGCTAGAAAAAGCA	1	bc
CTCAAATCGT	GAAACACCGGTCCTCGGAGATTATGCGGGAGAAATATCGACATAGCTAGA	1	bc
GAACCCGTCG	GAAACACCGGTTTTAGAAGTTGGTGTGGGGGGATAAAGCTAGAACTAGCA	1	bc
AGACAGAAGA	GAAACACCGGTGTTCTTTGCTCGAGGGTGGGGGTAGAACTATGAATAGCA	1	bc
GTAACCATCT	GAAACACCGGTGCTAATAGGTTTGTTGCAGGTATAAATAGCGAAACAGAA	1	bc
ATAAACACAA	GAAACACCGGTTTACTTAGGGGTTAGAGCTAGAAAGAGCAAGTTAACCTA	1	bc
TCCGTATAAA	GAAACACCGGTCGCGATACTGTGCCTGTTGGGTTAGAGATAGAAAGAGCA	1	bc
ATCTACGTGG	GAAACACCGGTCCTCGGAGATTAGGCGTGAGAAATATCGAGATACCTAAT	1	bc
CGACCCCTTT	GAAACACAGGTGACCGTAGGTAGGGAGTGGGGTTAGAGCTAGAAATATCA	1	bc
GACCCCATGG	GAAACACCGGTTTAGTATGGCGGGAAGTGGGGTTAGAGCTAGAACTAGCA	1	bc
CAATCCCACC	GAAACACCGGTTCACTCGGCGTACTTTTTGGGGTTGGGCTTGGAATTAGC	1	bc
GACACCACAT	GAAACACCGGTTTTCTTAGTTCCCTCGTGGGGTTAGAGCTAGAAATAGCA	1	bc
CGCACCTCAT	GAAACACCGGTCCCCGTTCGTAGGGAGTGGGGTTAAAGCTAGAAATAGAA	1	bc
AACCTCCTCG	GAAACACAGGTTTTCTGTCTTAGCGCGTGGGGTTAGAGCTAGAAATAGCA	1	bc
TGACCCCCAT	GAAACACCGGTGCTGGAAAGAGCAAGTTAACTTGAGGCTAGACGTTTACC	1	bc
ACAGCCAAGA	GAAACACCGGTGGGGTTAGAGCTAGAAATAGCTAGTTAACCTAAGGCTAG	1	bc
CACCGACTCC	GAAACACCGGTAGAATGGATCCACGGGTGGGGTTAGAGCTAAAAAAACCA	1	bc
GTAATTTACC	GAAACACCGGTACTAGTTACTTGCGGGTTGGGTTAGAGCTAGAAATAGCA	1	bc
GCAAGAGATA	GAAACACCGGTGAGCGTGACAACGTCGGTGGGGTTAGACCTAGAAATAGC	1	bc
AAACGATCAT	GAAACACCGGTGACAAACGTATGGCAGTGGGGTTAGAGCTAGAAATAGCA	1	bc
GACATATTTG	GAAACACCGGTGTTCATGCTAACGTCCGTGGGGTTAGAGCTAGAAATACC	1	bc
TTCTTAAACC	GAAACACCGGTCGCGATAATGTTGGATTAAAGATGGTAGTATCAGGCTAA	1	bc
AACAACTTCG	GAAACACCGGTTTCAGACAACAACTTGTGGGGTTAGAGCTAGAAATAGCA	1	bc
TAAACAAACT	GAAACACCGGTTATCGTAGCTAATTTGTGGGGTTAGAGCTAGAAATAGCA	1	bc
AACAAGCACG	GAAACACCGGTTTTCGATCATCGGTCGTGGGGTTAGAGCTAGAAATAGCA	1	bc
AGCACGCCAC	GAAACACCGGTGCTCTTTGATCGAGGGTGGGGTTAGAGCTAGAAATAGCA	1	bc
TCAACATATA	GAAACACCGGTGAGCATGGTAACGTCCATAGCGGGTTAACCTAAGGCTAG	1	bc
GTACAATATC	GAAACACCGGTGAGCATGATAACGTCCGGGGGGTTAGAGCTAGAAATAGC	1	bc
TGCCCATGCT	GAAACACCGGTTCCCGTTAGCTCGTAGTGGGGTTAGAGCTAGAAATAGCA	1	bc
GACACAATCG	GAAACACCGGTTATCGTTACTGATTTGTGGGGTTAGAGCTAGAAATACAA	1	bc
CCATCAAACA	GAAACACAGGTTCAACCGGAGTCTTTTGTGGGGTTAGAGCTAGAAATAGC	1	bc
CCCAACCACC	GAAACACCGGTGTAATCCAGCCACTTGTTGGTTTAAATCTAAAAATAACA	1	bc
AACACGCAAT	GAAACACCGGTTTACTTAGGGGTTAGAGCTAGATATAGCAAGTTAACCTA	1	bc
GGCCACTCCC	GAAACACCGGTGGCAGCCAGCCACTTGTGGGGTTAGAGCTAGAAATAGCA	1	bc
CGCAGGTATG	GAAACACCGGTGGGGGTAGATCTCTAAATGGCAAAGTGCCCTAAGGATCG	1	bc
GGATTACAAC	GAAACACCGGTGCTCATAGTTAGCTCGTGGGGTTAGAGCTAGAAATAGCA	1	bc
TAATGAACCA	GAAACACCGGTTGAGGTGAACTAAGAGTGGGAGAGATAGCAAGATAACCT	1	bc
CATACCCACA	GAAACACCGGTAGTCTAACGATCTGCGTGGGGATAGAGCTAGAAATAGCA	1	bc
GAATCACCAT	GAAACACCGGTTTTAGTAAATGGCGAGTGGGGCTAGAGCTAGAAATAGCA	1	bc
GTGAGCGACC	GAAACACCGGTGAGCTACCTAACCGGGGGGGTTAGAGCTAGAAATAGCAA	1	bc
TAGATAAAAT	GAAAAACCGGTGTACTTAGGGGTTAGAGCTAGAAATAGCAAGAAAACCTA	1	bc
CATCCCTGAC	GAAACACCGGTGAAAAACGTATGTCAGTGGGGTTAGAGCTAGAAATAGCA	1	bc
ATAGAAGCGA	GAAACACCGGTGTGCGGAGATTATGCGAGAGAAAGAGAAAGTAACCTAAG	1	bc
AAACGTAGGA	GAAACACCGGTTGAGTGGGTCCAGGGGGGGGGATAGAGCTAGAAATAGCA	1	bc
GGGGACGACA	GAAACACCGGTGACATGAAATACCGGGTGAGTTAGAGCTAGGACTAGCAA	1	bc
ATGACAACAG	GAAACACCGGTCCTAGAAGCTGCGTGGGGGTAGTACAGGTAAAAATAGGA	1	bc
GGAAAATATG	GAAACACCGGTGGCCGCGAGGCACTTGTGTGAGTAGAGCCAAAAAAAGCA	1	bc
GACTAATAAA	GAAACACCGGTGCTCGTGATATAGGGGGGGGGGTTAGAGCTGAAAATAGA	1	bc
AAAATAATAC	GAAACACCGGTTTAGAATGGAAGGACGAGGGGTAGAAATAGGAAGTGAAA	1	bc
GTCTATGAAC	GAAACACCGGTACTATTTACTTACGGGTGGGGTTAGAGCTAGAAATAGCA	1	bc
TCCCCAGACT	GAAACACCGGTCTTCCTGGAATCTACGTGGGGTAGAGCTAGAGATAGCAA	1	bc
TGCACCCCAT	GAAACACCGGTTTACTTTGGGGGTAGTTCTGGTATTAGCAAGTTAACCTA	1	bc
AAATCCAATA	GACACAACGGTGCTATTAGTTAGGTTTGAGGTTGAAATCGCGGGATAACA	1	bc
TGTCGAGAAA	GAAACACCGGTCTTCCTGGAATCTACGTGGGGGAGAGCTAGAGATAGCAA	1	bc
ATAACATCAC	GAAACACCGGTGACCATGGTATTTCTGGGGGGTTAGCCCAAGAAATAGCA	1	bc
GAGAGCGCCT	GAAACACCGGTGACCTGTGGGGGTACGGCTAGTAATAGCAAGTTAAACCA	1	bc
TACAAACCGA	GAAACACCGGTGTGCGTAGATTATGAGTGAGAAATAGCATGTAACCTAAG	1	bc
TAAACTGAAA	GAAACACCGGTTTTCTTTAGGGTTAGGGGTGGATATAGCTAGATATACTA	1	bc
AACACGCACC	GAAACACCGGTTCAACCGCCGTCTTTTGGGGAGTGATAGCTAGAGATAGC	1	bc
TCAGGACGAC	GAAACACCGGTGGGGTTAGAGCTAGAAATAGCAAGTTAACCTAAGGCTAG	1	bc
TAAATACATT	GAAACACCGGTTTACTTAGGGGTTAGAGATAGAAATAGCAAGTTAACCTA	1	bc
TCATTAGAAA	GAAACACCGGTGCTACTAGTTAGCTAGTGGGGTTAGAGCTAGAAATAGCA	1	bc
ATATTCTAAC	GAAACACCTGTAGCGAATACGTGAGGGTAGAGCTAGAAATAGCAAGTTAA	1	bc
TGGCTCGATT	GAAACACCGGTCTTCCTGGAATCTACGTGGGGTAGAGATAGAAATAGCAA	1	bc
GGTTCCGCAA	GAAACACCGGTGAGAGCCACTTACTGGTGGGGTTAGAGCTAGAAATAGCA	1	bc
CGACCTTATT	GCGAAAAACCGGTTCCTGTTAGCTTGTAGTGGGGTTAGAGCTAGAAATAG	1	bc
TACACACGGA	GAAACACCGGTTTACTTAGGTGTTAGAGGTAGAAATACCAGGTTACCCTA	1	bc
GAATCCCAAA	GAAACACCGGTTCACTTAGTGGGCACAGCTAGTTATAGCAAGTTAACCTA	1	bc
GAAATCCATA	GAAACACCTGTGTGCATGGTAACGTCGATGGGATAGTGCCAGAAGTCGCG	1	bc
GACTCTGCAT	GAAACATCGGTGCTCGTTACTTACGGGTGGGGTTAGAGCTAGAAATAGCA	1	bc
TGAGCCAAGC	GAAACACAGGTTATCGTTACGGATTTGTTGGGTTAGAGCTAGAAATAGCA	1	bc
AGAAAGTAAA	GAAACACCGGTGATCATGATAACGGCCAGAGCAAGGTAATATAAGTCTAG	1	bc
AAAACCATCC	GAAACACCGGTTGAGTTTGGTCGGTTGTGGGGTTAGAGCTAGAAATAGCA	1	bc
TATCCTGCTT	GAAACGCCGGTCTTCCTGGTATCTACGTTGGGTAGAGCTAGAAATAGCAA	1	bc
AACTCAAAAA	GAAACACCGGTGCCAATAGTTTGCTAGTGGGGTTAGAGCTAGAAATAGCA	1	bc
CACCGACTCG	GAAACACCGGTGGAATGTATCAACGGGTGGGGTTATAGCTAGAAATAGCA	1	bc
TGGAGCTTCT	GACACACCGGTTGCCGTTAGCTGGTAGTGGGGTTAGAGCTAGAAATAGCA	1	bc
CGGCAGATAA	GCAACACCGGTAGTCGTTCGTCGGGCGTGGGGTTAGAGCTAGAAATAGCA	1	bc
GCCAACTCCT	GAAACACCGGTGGCAACCAGCCACTTGTGGGGTTAGAGCTAGAAATAGCA	1	bc
AGGCAGCATG	GAAACACCGGTCTTCGTTCGTAGGGCGTGGGGTTAGAGCTAGAAATAGCA	1	bc
GTCACGCATA	GAAACACCGGTGATCCTGATATCGTTCATGGCGAGATAACTTAATTCTAG	1	bc
AGTACCTCCC	GAAACACCGGTTCCCGTTAGCTCGTAGTGGGGTTAGAGCTAGAAATAGCA	1	bc
CTCTGCCCGA	GAAACACCGGTGTGCGGAGATTATGCGTGAGAGATAGCAAGTAACCTAAG	1	bc
TCCACCTAAG	GAAACACCGGTGGCAGCCAGCAACTTGTGGGGTTAGAGCTAGAAATAGCA	1	bc
ACGACAGACG	GAAACACCGGTTATAGTAGCGGAGGAGGGAGCAAGTTAATATAAGTAGAG	1	bc
TAAATCCTAC	GAAACACCGGTTTAGTTAGTCGTTAGAGCTAGAAATAGCAGGTTTATCTA	1	bc
GGAAGGGATG	GAAACACCGGTGTTAGTTGGTAGGTCGTGGGGTTAGGGTTAAAAAAAGAA	1	bc
GGAATGCATA	GAAACACCGGTGAGCATGGTAACGTCCAGAGCATGTTAACCGAAGTCGAG	1	bc
GACTCTCAAA	GAAACACCGGTACTAGTTCCTTATGGGTGGGGTTAGAGCTAGAAATAGCA	1	bc
GCAATATAAG	GAAACACCGGTGAGCAAGATAACGTCCATAGCAAGTTAACCTAAGGCTAG	1	bc
GAAACAAAAT	GAAACACCGGTTTACTTAGGGGTTAGGGCTGGATAGAGCAAGAAATAGTA	1	bc
TTCATCTTCT	GAAACACCGGTCGCGCAAATGTGTGGGTGGAACTAGAAATAACATGATAA	1	bc
TAAAACCCGT	GAAACACCGGTGTACTTAGGGTATACGTGTGGAAAAAGCAAGAACACAAA	1	bc
TTATCACCGA	GAAACACCGGTTTGCGGAGATTATGCGTGGGGAATAGCAAGTAACCTAAG	1	bc
TTTTTCTCAA	GAAACACCGGTCGCGACAGTGCGGGGTTAGAGCCAGGCATAGCGTGTTAA	1	bc
GAGCGCGAAA	GAAACACCGGTTCTATGCGTCTCCGGGGGGGGTAGAGCTAGAAATAGCAA	1	bc
ATCAACCACG	GAAACACCGGTGGCAGCCAGCCACTTGTGGGGTTAGAGCTAGAAATAGCA	1	bc
GTGATAAGTG	GAAACACCGGTGAGCATGATAACGTCCGGGGGGTTAGAGCTAGAAATAGC	1	bc
GACTCTGTCT	GACACACCGGTACTAGTTACTTACGGGTGGGGTTAGAGCTAGAAATAGCA	1	bc
AATCCAGGAT	GAAACACCGGTCTCAATGGTATGTCAGTGGGGTTGAGCCAGGAATAGCGA	1	bc
CTACCACAAA	GAAACACCGGTTGCAATCGGTTCTTTGTGGGGTTAGAGCTAGAAATAGCA	1	bc
GTCATTTCCA	GAAACACCGGTTAGCGTTATAACGTCCGGGGGGTTAGAGCTATAAATAGC	1	bc
TGTTCAATTT	GAAACACCGGTCGTCCTGGAATCTAAGTGGGGTAGAGCTAGAAATAGCAA	1	bc
GAGAAAGTCG	GAAACACCGGTAATAGAAGCAGAGCGGTGGGAGTGGTGGAAATATCAAGA	1	bc
CCCCGGGACA	GAAACACCGGTTGAACTGCCGAGGGTGTTGGGTTAGAACTAGAAATAGCA	1	bc
TTATTAAACA	GAAACACCGGTCGCGAAAGTGTGGTGTTAGGGATAGTAATCGAAAGTTAA	1	bc
TAATTATACC	GAAACACCGGTTGAGATAATCAAAGCCATGGGAAGTTCTCCAAATAGTAG	1	bc
AGAAATGCAG	GAAACACCGGTGCCCTTTGTGGGAGCGTGGGGTTAGAGCTAGAAATAGCA	1	bc
ATAACCGACT	GAAACACCGGTGTTAGCGATGGTTTGTGGGGTTAGAGCTAGAAATAGCAA	1	bc
ACCCGACGAC	GAAACACCGGTGGAATGGATCCACGGGTGGGGTTAGAGCTAGAATTAGCA	1	bc
TATCCTGCTG	GAAACACCGGTCTCCCTTATGTGACTGGGGGGATCTAGCAAGAACAAGTT	1	bc
GGGTCATGAG	GAAACACCTGTTATAACTACGGGTTTTGGGGGTAGGACTTAGAATAACAA	1	bc
TAATTAAGCC	GAAACACCGGTTATGGTTACGGATTTGTTGGGTTAAGCCTGGAATTAGAA	1	bc
GAGCCAGATG	GAAACACCGGTCTTCATGGAATCTAGAAATAGCAAGTTAACCTAAGGCTA	1	bc
GATCTTGCAA	GAAACACCGGTGCTGGGTACTTACGCGTGGGGTTTGAGATGGAAATAGAG	1	bc
TTTTCCGATT	GAAACACCGGTCTTCCTGGAATCTACGCGGGGTAGAGATAGAAATATCAA	1	bc
ATAACCGAAC	GAAACACCGGTGTGCGGAGATTATGCGTGGGGTATAGCCAGTAACCTACG	1	bc
AAAAAACTCC	GAAACACCGGTAATCTAAAGATGCCCGTGGGGTTAGAGCTAGAAATAGCA	1	bc
GAAATACAAT	GAAACACCGGTGCTAATAGGTAGCTCGTGGTATTAGAGCGAGAAATTACA	1	bc
TGCCACAAAG	GAAACACCGGTGGTCTTAGATCGTGAGTTAGCTTAATGCTGGACCTCTAT	1	bc
CCACGGGTTT	GAAACACCGGTGCTCGTAGGTAGAGCGTGGGGTTAGAGCTAGAAACCTCA	1	bc
CGACAGCATT	GAAACACCGGTGCTCTCTGTTTGGGGGTGGGGTTAGAGCTAGAAATAGCA	1	bc
GCCATATCTA	GAAACACCGGTGAGCATGATAACGTCCGAGGGGTTAGAGCTAGAAATAGC	1	bc
CCATCGCAAA	GAAACACCGGTTCAACCGGCGTCTAAGGTGGGGTTAGAGCTAGAAATAGC	1	bc
AACGGGGTAG	GAAACACCGGTGTGGGTAGATATGGAGTTAGGATAGAGACTTAAATCTCA	1	bc
CCACGAAGCC	GAAACACCGGTGGAATGGATGCACGAGTGGGGTTAGAGCTAGAAATAGCA	1	bc
TCCGCACGAA	GAAACACCGGTGGGGTTAGAGCTAGAAATAGCAAGTTAACCTAAGGCTAG	1	bc
TAACGCCGCT	GAAACACCGGCTTACTTAGGGGTTATAGCTTGAAATAGCACGTTAATCTA	1	bc
GCCTTAGCCG	GAAACACCGGTTCTAGTAAATTGCGAGGGAGGGTAGAGCTTGAAATTGCC	1	bc
CCCTTTTTCA	GAAACACCGGTACTAGTTACTTACGGGTGGGGTTAGAGCTAGAAATAGCA	1	bc
GACTAGGAAC	GAAACACCGGTACTATTTACTTACGGGTGGGGTTAGAGCTAGAAATAGCA	1	bc
GATACCGTTC	GAAACACCGGTAATCTAAGGATCCCCGTGGGGATAGGCTAAGAATTACCA	1	bc
GTACAACATA	GAAACACCGGTGATCTTGATAACGGCCGGGGGGTTAGAGCTAGAAATAGC	1	bc
ATACGCCGCC	GAAACACCGGTAGAATGGATTGACGGGTGGGGTTAGAGCTAGAAATAGCA	1	bc
ATCACCGCCC	GAAACACCGGTCCTAGAAGCTGAGTGGGGTTAGAGCTAGAAATAGCAACT	1	bc
TGCCGTCCCT	GAAACACCGGTAGAATGGATCCACGGGTGGGGGTAGGGGTAGGAAAAGCA	1	bc
GAACCTGTAC	GAAACACCGGTACTATTTGCTTACGGGTGGGGTTAGAGCTAGAAATAGCA	1	bc
TGTCCTTCAT	GAAATACCGGTTCCAAATGTCTCGTAGTGGGGTTAGAGCTAGAAATAGCA	1	bc
ATCTTACAAA	GAAACACCGGTGCTCATAGATAGCTCGTGAGGATTAAGATAGAAATAAAG	1	bc
GACAAAAAAA	GAAACACCGGTAAGCATTACTTCGTGGTGGGGTTAGAGCTAGAAATAGCA	1	bc
ACTAGTGCCT	GAAACACCGGTAGTATTTATGCGCGGGTGGGGAAAGAGATAGAAAGAGCA	1	bc
GCCTATATAC	GAAACACCGGTACTAGTTACTTGCGTGTGGGGTTAGAGCTAGAAATAGCA	1	bc
GATATATCAA	GAAACACCGGTGAGCATGATAACGTCCGGGGAGATAGAGCTAGAAATCGC	1	bc
ATAATGTATG	GAAACACCGGTGAGCGTGATAACGTCCGGGGGGTTAGAGCTAGAAATAGC	1	bc
TCCTTGTACC	GAAACACCGGTCGCGAAGATGTGGGGTTAGAGATAGCAATAGCAAGTTAA	1	bc
TAACTCAATC	GAAACACCGGTTTACTTAGGGGTTAGAGCTAGAAATAGCAAGTTAACCTA	1	bc
CAGCTAAAAG	GAAACACCGGTCCTCGTTGGTAGCTCGTGGGGTTAGAGCTAGAAATAGCA	1	bc
ACTACGGCCC	GAAACACCGGTTCAACCGGCGTCTTTTGGGGGGTTAGAGCTAGAAATAGC	1	bc
ACTCACCGCG	GAAACACCGGTGCAATTGATGCGACGGTGGGGTTAGAGCTAGAAATAGCA	1	bc
AACCTACAAA	GAAACACCGGTGTACGATGAATGGGCGTGGGGTTAAAGATAGAAATAGCA	1	bc
TAGGTAGCTT	GAAACACCGGTTTTGTTGGTCTCTAAGTGGGGTTGAGCTAGAAATAGCAA	1	bc
AGGAACGTAC	GAAACACCGGTCTTAGAAGCTGAGGGGGGTTATAGCTAGTAATAGCAACT	1	bc
CAGACAGTCG	GAAACACCGGTCCTAGAAGCTGAGTGGGGTTGGAGGTGGTAGTAACAGGT	1	bc
CTCTTATCAA	GAAACACCGGTGCTGGAAATAGCCAGTTGACCTAAGACTAATCAGTTGTC	1	bc
GAATCTGAAA	GAAACACCGGTACTAGTTACTTACTGGTGGGGTTAGAGCTAGAAATAGCA	1	bc
AACTTACAAC	GAAACACCGGTGCTCATAGTTCGCTCGTGGGGTTAGAGCTAGAAATAGCA	1	bc
GAACTAGATG	GAAACACCGGTTTTCGTAGGTGGTAGAGGTAGTAATAGCAAGTTAACCTA	1	bc
GAAATCTATC	GAAACACCGGTAATCATGATAACGTCCGTGGGGTTAGGGCTAGAAATACC	1	bc
GGCATATCAA	GAAACACCGGTGAGCATGATAACGTCTATAGCAAGTTCACCAAAGGCTAG	1	bc
GAATTATCTG	GAAACACCGGTTTGCGTGATAACGTCGATGGCAAGGTAATATAATGCGCG	1	bc
CCCATATCAA	GAAACACCGGTAAGCTAAACATCCCTTTGGGGTTGGAGCTATAAATAGCA	1	bc
TTCATGCTCC	GGAACACCGGTTTTCGATCATAGGTCGTGGGGTTAGAGCTAGAAATAGCA	1	bc
GATTGAGCTA	GAAACACCGGTGAGCATGATAATTTCCATAGCAATTTAACCTAAGGCTAG	1	bc
AAAAAAGCAG	GAAACACCGGTGCTCATTGTGAGACCGTGGGGTTAGAGCTAGAAATAGCA	1	bc
ATAATTCCAA	GAAACACCGGTTTACTTAGGGGGCAGAGCGAGATATAGCAAGTTAACCTA	1	bc
AACCGCCGCA	GAAACACCGGTAGAATGTATCCACGGGTGGGGTTAGAGCTGGAAATAGCA	1	bc
ATGTCCTCCG	GAAACACCGGTCCTAGAAGCTGAGTGGGGGTAGAGCTAGAAATAGCAAGT	1	bc
ATTTAATCAC	GAAACACCGGTGACAAACGTATGTCAGTGGGGTTAGAGCTAGAAATAGCA	1	bc
AAACCATCCG	GAAACACCGGTGACAAACGAATGTCAGTGGGGTTAGAGATAGAAATAGCA	1	bc
CAACGCCGCA	GAAACACCGGTAGAATGGATCCACGGGTGGGGTTAGAGCTAGAAATAGCA	1	bc
AAATTGGGGA	GAAACACCGGTTGTGGGGAACTCGGTGTCGGAGAAATAGCCAGCTAACCT	1	bc
CGGTGGGCGA	GAAACACCGGTTGGCGGACGTTGGGCGTGGGGTTAGAGCTAGAAATAGCA	1	bc
TGCAGCGAGT	GAAACACCGGTGACATGCATGATCGGTGGGGATAGAGCAAGTTATCGTAA	1	bc
TGTTAAGAAT	GAAACACCGGTCTTCCTGGCATCTACGTGGGGTAGGACTAGGAATAGCCA	1	bc
GAATAAATCC	GAAACACCGGTAATCTAAAGATCCATGTGGGGAAAGAGTTAGAAATAGCA	1	bc
CAACGGGCAA	GAAACACCGGTGCTAGGGCACTAAATAGGGGGTTCACATCAAGCTAGTCC	1	bc
ATAACCCCGA	GAAACACCGGTGTGCGGAGATTATGAGTGCGAGATAGAACGTAACCTCAG	1	bc
ATGAAGGACG	GAAACACAGGTCCTAGAAGCTCAGGGGGGGTAGAGCTAGAAATAGCAAGT	1	bc
CTTTACCGAT	GAAACACCGGTCTTCCTGGAATCTACGTGGGGTAGAGATAGAAATAGCAA	1	bc
GGGGCCAGAC	GAAACACCGGTTATCGTTACGGATCTGTGGGGTTAGAGCTAGAAATAGCA	1	bc
TAGTCAATCT	GAAACACCGGTTATCGTTACGGATTTGTGGGGTTAGAGCTAGAAATAGCA	1	bc
CAATCACGCC	GAAACACCGGTGGGATGGATTCACGTGTGGGGTTAGAGCTAGAAATAGCA	1	bc
GACCAAGTTT	GAAACACCGGTAATCTAAAGATCCCCGTGGGAATAGAGCTAGAAATAACA	1	bc
TAACGCCATT	GAAACACCGGTTTTCTCGGGGGCTAGAGCTGGATATAGCAAGTTAACCTA	1	bc
GCCTCAGCAA	GAAACACCGGTACTTGTTACTTACGGGTGGGGTTAGAACCAGAAATAGCA	1	bc
TGACCCCATT	GAAACACCGGTTTACCTAGGGTCTAGAGCGGGAAATAGCAAGTTAACCAA	1	bc
AACATTGTAA	GAAACACCGGTACTAGTTACTTACGTGTGGGGTTAGAGCTAGAAATAGCA	1	bc
GAACTATCAC	GAAACACCGGTGAGAATGGTAACTTCGATGGCATGTTAACCTAAGGCTAG	1	bc
ATAACCTATG	GAAACACCGGTCCTAGAAGCTGAGTGTGGTTAGAGCTAGAAAGAGAAAGT	1	bc
AAGCGGGTAG	GAAACACCGGTGGTAGATCGAAGGGAGTGGGGTTAGAGCTAGAAATAGAA	1	bc
GTCATATCCA	GAAACACCGGTGATCATGGTAACGTCCATGGCAAGTTAACCTAAGGCTAG	1	bc
CACAAACGCC	GAAACACCGGTTACCTTTATGGTACCGTGGGGTTAGAGCTAGAAATAGCA	1	bc
AATACACCCT	GAAACACCGGTTCTCTGCATGGGACCGTGGGGTTAGAGCTAGAAATAGCA	1	bc
CAACTCACAC	GAAACACCGGTTGGCTTTACTCCTTTGTGGGGTTATAGCTATAAATAGCA	1	bc
TAATTACTCT	GAAACACCGGTGCTAATAGTTAGCTCGTGGGGTTAGAGCTAGAAATAGCA	1	bc
TAAGCAATGA	GAAACACCGGTGGAGTTTGGAGGAGTTAGAGCAAGATAAAGCAAGGTAAC	1	bc
AGACCTTACT	GAAACACCGGTTGCAGTTAGCTCGTAGTGGGGTTAGAGCTAGAAATAGCA	1	bc
CGCAGGCTAG	GAAACACCGGTCTTCGTTCGTAGGGCGTGGGGTTAGAGCTATAAATAGCA	1	bc
CAATGAGCGT	GAAACACCGGTGCTAGCGGATTCTGCGTGGGGATTAGCATAGAACCTTCA	1	bc
TAGCGACAAT	GAAACACCGGTTGTCGTAGGTAGCTCGTGGGGTTAGAGCTAGAAATAGCA	1	bc
GTCAGCGTCA	GAAACACCGGTCGTGTAAAGCTACCAGTGGGGATAGAGCTTGAAATAGCA	1	bc
ATTTGCGCCG	GAAACACCGGTCGCGAGAATGTGGCAGTGGGAGTAAAACTAAGATTAGCC	1	bc
CCTTATTCAA	GAAACACCGGTGCTAGAAATAGCAAGTTAACCTAAGGCTAGTCCGTTATC	1	bc
TGTACATCTT	GAAACACCGGTTTTCGTTAACTCGTCGTGGGGTTAGAGTTAGAATAGGAA	1	bc
GTTTCATCTA	GAAACACCGGTGCTAGAAATAGGAGGGTGGGCTAAGGCTAGTCCGTTATA	1	bc
CTATTCTCCT	GAAACACCGGTGCTCGCGGATTCTAAGAGTGGTTAGAGCTAGAAATAGCA	1	bc
ATGACCGAAC	GAAACACCGTTTGATTTAGATCTCGAGATGGGAAGTTACCCGAAGGAGCG	1	bc
AACTTACTCG	GAAACACCGGTTTTCGATCATAGGTCGTGGGGTTAGAGCTAGAAATAGCA	1	bc
TGAGACATGC	GAAACACCGGTTATCGTTACGGATTTGTGGGGTTAGAGCTAGAAATAGCA	1	bc
TACACTCACT	GAAACACCGGTTTACTTAGGGGTTAGGGCTAGAAATAGCAAGTTAACCTA	1	bc
GGATAAGGCG	GAAACACCGGTTTTAGTAACTGGAGAGTGGGGTTAGAGCTAGAAATAGCA	1	bc
CTGACAGCCG	GAAACACCGGTCATAGAAGCTGCTTGGGGTTAGTGCTAGAAATAGCAAGT	1	bc
GAAAAAGCAA	GAAACACCGGTACTAGTGACTTAGGGGTGGGGATAGAGCTAGAAATAGCA	1	bc
CGTTCAGAAT	GAAACACCGGTCTTACTGGAATCTAAGTGGGGTAGAGCTAGAAATAGCAA	1	bc
AAGCGCGTCC	GAAACACCGGTAGAATGGATCCACGGGGGGGGTTAGAGCTAGAAATAGCA	1	bc
TCAGACAACA	GAAACACCGGTGGCGATATAGATAGAAATAGCCTGTTAATCTACGGCTAG	1	bc
CCCGCAGCCC	GAAACACCGGTAGAACGGATCCACGGGTGGGGTTAGAGCTAGAAATAGCA	1	bc
ACGAAAGCCG	GAAACACCGGTGCCCTTTATGGGACCGTGGGGTTAGAGCGAGAAATAGCA	1	bc
TAACCAGAGT	GAAACACCGGTCTAGTTGGGATGTATTAGGGGTAGAACTAGAAAGATAAA	1	bc
GTCGATGTGA	GAAACGCCGGGACTAGTTACTTACGGGTGGGGTTAGAGCTAGAAATAGCA	1	bc
GAAAAACTCA	GAAACACCGGTAATCTAAAGATCCCCGTGTGGATAGAGCTAGAAATAGCA	1	bc
CGGCGGGGCC	GAAACACCGGTCGTCGTTCTTCGCGCGTGGGGTTAGAGCTAGAAATAGCA	1	bc
CGCCAGCACC	GAAACACCGGTGTTCTTTACCCGAGGGTGGGGTTAGAGCTAGAAATAGAA	1	bc
GGCTCTGCAA	GAAACACCGGTACTAGTTACTTACGTGTGGGGTTAGAGCTAGAAATAGCA	1	bc
AGCAACCACC	GAAACACCGGTGGCATTCACCCACGTGTGGGGTTAGAGCTAGAAATAGCA	1	bc
CTGCCCGTCC	GAAACACCGGTAGTATTGGTTCAGGGGGGGTATTGCTGGTAGTAGTAGCA	1	bc
GACTCTGCCA	GAAACACCGGTTCTAGTTACTTACGGTTGGGGTTAGAGCTAGAAATAGCA	1	bc
TTCTTAAGCG	GAAACACCTGTTCTGGATACGGATCACCGGGGTTAGAGCTAGAAATAGCA	1	bc
TCCTTCCTCC	GAAACACCGGTAGAATTGATCCACGGGAGTGGGTTGATCTAGAAATAGCA	1	bc
ATTTCATAGC	GAAACACCGGTGACAGGCGAATGTCAGTGGGGCTTGAGATATAACTAAAA	1	bc
CACTATACAA	GAAACACCTGTACTCGTTACTTACGGGTGGGGTTAGAGCTATAAATAGCA	1	bc
TAGACCCACG	GAAACACCGGTTTTCGTTGGGGATATAGGTAGAAATAGCTAGTAAACCTA	1	bc
AGATTAAAAC	GAAACACCGGTGCTAATAGTTAGCTCGTGGGGTTAGAGCTAGAAATAGCA	1	bc
GGACGGGATA	GAAACACCGGTGAGCATGAGAACGTCGCTAGCAAGTTAACAGAAGGCTAG	1	bc
TGCTCCTCCA	GAAACACCGGTTCGAATTAGCAGGTTGTGGGGTTAGAGCTAGAAATATCA	1	bc
GCCACATGTC	GAAACACCGGTTCAACCGGTAACTGTTGTGGGGTTAGAGCTAGAAATAGC	1	bc
AATGGCGCGA	GAAACACCTGTTGTGGTGAACCTGGTGTTGGAGAGATAGCAAGTTAACCG	1	bc
TTCAAATCCT	GAAACACCGGTTCCCGTTAGCTCGTAGTGGGGTTAGAGCTAGAAATAGCA	1	bc
GTCCTATAAC	GAAACACCGGTGAGAATCATAAGGTCGGTGGGGTAAGAGTTGGAAATAAA	1	bc
CCAAAATGTA	GAAACACCGGTGAGCATGATAACGTCCGTGGGGTGAGAGCTAGAAATAGC	1	bc
TAAACAACAT	GAAGCACCGGTTTACTTAGGGGCTAGGGCTAGAAATAGCAAGTTAACCTA	1	bc
TAATTACTCC	GAAACACCGGTTGAGATAATCAAAAAGTGGGGTAGAGCTAGAAATAGCAA	1	bc
CGTCCTCCAC	GAAACACCGGTGCTAGAAATAGCAAGTTAACCTAAGGCTAGTCAGTTATC	1	bc
GGGTGAGCGA	GAAACACCGGTGCGATAAATAGCAAGTTAACCTAAGGCTAGTCCTTTATC	1	bc
GTGTGAGCGG	GAAACACCGGTGATATTAAATACCGGGTGGGGTTGAGCTTGGAAATACAA	1	bc
TCAGCCGAGA	GAAACACCGGTGAGGTGCGTGATAGACCTAGAAAGTTAACCTAATCCTAG	1	bc
GAGTTCAGCC	GCAACACCGGTTATCGTTACGGAGTTGTGGGGTTAGAGCTAGAAATAGCA	1	bc
AGCAACATAT	GAAACACCGGTGAGCATGATAACGTACGTGGGGTTAGAGCTAGAAATAGC	1	bc
ACCATGCCCG	GAGACACCGTTTTTCGATCTTAGGTCGTGGGTTTAGGGCTAGCAATGGCA	1	bc
GGAAAACCTC	GAAACACCGGTAATCTAAAGATCCCCGTGGGGATAGAGCTAGAAATAGCA	1	bc
AAATAAACAA	GAAACACCGGTGCTAATAGTTAGCTCGTGGGGTTAGAGCTAGAAATGGCA	1	bc
CCACGACGTC	GAAACACCGGTAGAATGGATCCACGGGTGGGGTTAGAGCTAGAAATAGCA	1	bc
AATACCGCAA	GAAACACCGGTACCCGTCGTTTACGAGTGGGGTTAGAGCTAGAAATAGCA	1	bc
ATAACGCACG	GAAACACCGGTCCTAGACGCTGGGTGGGGTTCGAGCTAGAAATAGCAGGT	1	bc
AACAAATCCG	GAAACACCGGTGCCCTTTATGGGACCGTGGGGTTAGAGCTAGAAATAGCA	1	bc
CTCTAACAGC	GAAACACCGGTTCACGCGGATTCTTCTTGGGAGATAGAGCTTAACCCAGC	1	bc
CGGCGTGCTT	GAAACACCGGTCGTCGTTCGTAGGGCGTGGGGTTAGAGCTAGAAATAGCA	1	bc
GAAGCAACAG	GAAACACCGGTTTTAGTAAATGGTGAGTGGGGTTAGAGCTAGAAATAGCA	1	bc
CGGCCGCACG	GAAACACCGGTCGTCGTTCGTAGTTCGTGGGGTTAGAGCTAGAAATAGCA	1	bc
AGACAGTACG	GAAACACCGGTGGTATTTGCTCGATGGTGGGGTTATAGCTAGAAATAGCA	1	bc
ATACAACAGA	GAAACACCGGTGTGAGGAGATTATGCGTGAGGAATAGCAAGGAAACTACG	1	bc
AGTCCGGCTT	GAAACACCGGTCTTCCTGGAATCTACGTGGGGTAGAGCTCGAAATAGCAA	1	bc
GACTAAATAC	GAAACACCGGTACTAGTTACTTGCGTGTGGGGTTAGAGCTAGAAATAGCA	1	bc
GTATTGTCTA	GAAACACCGGTTGGGGGGAACTCGGCGTGGGAGAATTAGCCTAATAACCT	1	bc
CCCCAGCAAC	GAAACACCGGTAGAATGGATCCACGGGTGGGGTTAGAGCTATAAATAGCA	1	bc
GGATCAGATT	GAAACACCGGTTTTCGTGGAATCTACGTGGGGTAGAGCTAGAAATAACAA	1	bc
GGTCTATATA	GAAACACCGGTGATCATGATAACGTCCTTGGCAAAGTAACCTAAGGCTAG	1	bc
AGTAAAGCAG	GAAACACCGGTGCGCTTTATGGGATCGGGGGGTTGGGGCTAGAAATATAA	1	bc
TTCATTACAA	GAAACACCGGTGCTAATAGTTCGCTCGTGGGGTTATAGCTAGAAATAGCA	1	bc
AGTTAGTCAA	GAAACACCGGTGCTATTAATAGCAAGGTAACCTTAGGGCAGTACGTTATC	1	bc
TGCATTTATA	GAAACACCGGTTCGCGTGATCTCGTAGTGGGGTTAGAGCTAGAAATAGCA	1	bc
GAATCAGTAA	GAAACACCGGTACGAGTGACTTACAGGTGGGGATAGAGCTAGAAATAGCA	1	bc
TGCACTCAAT	GAAACACCTGTTTACTTAGGCGCGAGGGCTAGAAATAGCAAGAAAAAGCA	1	bc
AGTCCACTAT	GAAACACCGGTCTTCCTGCAATCTACGTGGGGTTGAGCCAGGAATTGGAA	1	bc
CCCGCATACG	GAAACACCGGTGGAAGCCGGGCACTTGTGGGGGTGTAGCTCTAAAGATAA	1	bc
GTGTCCGCCG	GAAACACCGGTTTTAGTAACTGGTGTTTGGGGTTCGAGCTTGAAATATCC	1	bc
TAAAATCTAT	GAAACACCGGTTTTCTTTGGGTTTAGGGCTGGATATAGCAAGTTATCCTA	1	bc
CTACCCTATC	GAAACACCGGTGCTACCGGGTTCTAATTGGGGTTAGAACTAGAAATAAGA	1	bc
AAATACGGGA	GAAACACCGGTATGCGGAGATTATGCGTGAGAAATAACAAGCAACCTAAG	1	bc
TCAGCTACCA	GAAACACCGGTGGGGGTTGAGTTAGAAATAGGTTGTTGATCTAAGTAGAG	1	bc
ATCTCCGCCA	GAAACACCGGTCCGAGAAGATGAGGGGGGAGAGATCTCGAGAAACCTAGG	1	bc
GGCCAGCAAA	GAAACACCGGTGTTCTTTGCTCGAGGGTGGGGTTAGAGCTAGAAATAGCA	1	bc
TATACTGATT	GAAACACCGGTGCACTTTATGAGACCGTGGGGATCGAGCTAGAAATAGCA	1	bc
CCACGGCAAC	GAAACACCGGTGGAATTGGTCCACGGGTGGGGTTAGAGCTAGAAATAGCA	1	bc
TTCTAGTACC	GAAACACCGGTCGCGTAAGTGTGAGGTTGGGGCTAGAGCTAGAAAGATCA	1	bc
TCAAGCCGCA	GAAACACCGGTAGAGTGGATCAACGGGTGGGGTTAGAGCTAGAAATAGCA	1	bc
AAATTCACCA	GAAACACCGGTTTCGTATGTAGGGATTAGAGCTAGAAATAGCAAGTTAAC	1	bc
AAAAATGACC	GAAACACCGGTGTTCTTTGTTCGATCGTGGGGTTAGAGCTAGAAATAGCA	1	bc
AATTTGATAG	GAAACACCGGTTTTCGATCATAGGTCGTGGGGTTAGAGCTAGAAATAGCA	1	bc
AATACGTTAC	GAAACACCGGTGACAAACGAATGTTAGTGGGGTTAGAGCTAGAAATAGCA	1	bc
AAATTCAAGA	GAGACACCGGTGCAGAAAGTGAGGTCAGAGGGATAGAGCGAGAGATAGCA	1	bc
CGCAGTTCTT	GAAACACCGGTTGTCGTTCGTAGGTCGTGGGGTTAGAGCTAGAAATAGCA	1	bc
AAACCACTAA	GAAACACCGGTTTCGTATGGAGGGATTTGGGGTTGAAACAGGAAATTGAC	1	bc
GATAGCGCAA	GAAACACCGGTTATCTAAAACTCCGAGTGGGAGTAGAGCTAGAAATAGCA	1	bc
CCACGCAAAC	GAAACACCGGTGGGATGAATCCACGGGGGGGGATGGTAATAGAAAGAGCG	1	bc
TGATCAGCCT	GAAACACCGGTCTTACTGGAATCTACGTGGGGTAGAGCTAGAAATAGCAA	1	bc
CCCTCGCCAA	GAAACACCGGTGAGAACAGAATGTTTTGGGGATAGAGCTAGAAATAGCAA	1	bc
GTCTAATCTA	GAAACACCGGTCCGGGTTACTTAAGATTGGGGTTAAGGTATGAATTAAAA	1	bc
TCAGGGGAAG	GAAACACCGGTGGGGTTAGAGCTAGAAATAGCAAGTTAACCTAAGGCTAG	1	bc
AAACTAAAGA	GAAACACCGGTGTAGTATGGTGGGAATAGAGATAGAAATAGCAAGTTAAC	1	bc
TAATCAATCT	GAAACACCGGTCTTGCTGGAATCTACGTGGGGTAGAGCTAGAAATAGCAA	1	bc
CACCCATGAC	GAAACACAGGTGACAAACGTATGTCAGTGGGGTTAGAGCTAGAAATGGCA	1	bc
GGCAAAGATT	GAAACACCGGTGGCAGCCAGCCACTTGGGGTGTGAGAGCTAGAAATAGCA	1	bc
AATATATCAA	GAAACACCGGTGACCAAGGTAAGGCCGTGGGGTTGGTACTAGAAATAGAA	1	bc
GCCTAGCACA	GAAACACCGGTTCAACCTACGTATGTGGGGGGTTAAGGGTTAAAATAAGC	1	bc
CCACTAGACT	GAAACACCGGTTGAAAGGGTTCAACAGTGGGGTTAGAGCTAGAAATAGCA	1	bc
CCCTCGCTTA	GAAACACCGGTTCAACCGGCGTCTTTTGAGGTGGTAGAGCTAGGTCTAGC	1	bc
GCCGCTGAAA	GAAACACCGGTACTAGTTACTTACGGGTGGGGTTGGAGCTATAAATAGCA	1	bc
TCCACCAACG	GAAACACCGGTGGGAGTAGCTCTCTTATGAGGGTGGTGATAGAAAGATAA	1	bc
TCCAGCCAAT	GAAACACCGGTTAGAATAGGGGTTAGCGCCAGAGGTAGCACGTTAACCAA	1	bc
CAACCAGCAC	GAAACACCGGTGACAACCGTATGGCAGTGGGGTTATAGCTAGAAATAGCA	1	bc
CCCCGAAGCA	GAAACACCGGTGGAATGGATCCACGGGTGGGGTTAGAGCTAGAAATAGCA	1	bc
TGGACTTACC	GAAACACCGGTTCCCGTTAGATCGTAGTGGGGTTAGAGCTAGAAATAGCA	1	bc
CCCTTCAGCC	GAAACACCGGTCGAATGTATCCACGGGTGGGGTTAGACTTAGAAATACCA	1	bc
GACACCGTCG	GAAACACCGGTGATCTAAATATCCGCGTGGGGATAGAGCTAGAAATAGCC	1	bc
GTCCCCCTCC	GAAACACCGGTAATCTAAAGATCCCCGTGGGGATAGAGCTAGAAATAGCA	1	bc
AAAAACCAAC	GAAACACCGGTGTTCTTTGATAGAGGGAGGGAATCGAACTAGAAATCGCA	1	bc
GAGACTACCG	GAAACACCGGTTCTCGTTACGGATTTGTGGGGTTAGAGCTAGAAATAGCA	1	bc
GTGCGCGACC	GAAACACCGGTGAGGTGCCTCACCGGGGGGGTTAGAGGTAAAAATAACAA	1	bc
CGGTCCTAGA	GAAACACCGGTGCTAGGCCTCGCAAGTGAGGGGTAAGATAGAGAGATATC	1	bc
CAATCAGAAT	GAAACACCGGTGCTAACAGATCGGTTTGGGGTTAGGGCTAGGAATTGCAA	1	bc
GAATCAGTAA	GAAACACCGGTACTAGTTGATTACGGGATGGGTTAGAGCTAGAAATAGCA	1	bc
TAGACCGAGT	GAAACACCGGTTTACTTAGTGGTTATAGCTAAAAATAGCGAGTTAACCTG	1	bc
ATAACGCACC	GAAACACCGGTGTTCTTTGCTCGAGTGTGGGGTTAGAGCTAGAAATAGCA	1	bc
AGGACCGCCT	GAAACACCGGTCCTAGAAGCTGAGTGGGGTTAGAGCTGGAAATAGCAAGT	1	bc
TCACGACGCC	GAAACACCGGTAGAATGGATCCACGGGTGGGGTTAGAGCTAGAAATAGCA	1	bc
CGCCGGCACC	GAAACACCGGTGTTCTTTGCTCGCGGGTGGGGTTAGAGCTAGAAATAGCA	1	bc
CGTCGACGCC	GAAACACCGGTGCTAGAAATAGCAAGTTAACCTAAGGGTAGTCAGTTATC	1	bc
GAATCAGATA	GAAACACCGGTGTTCATAAATGGGGAGTGGGAAGATAGCTTGAGATTGGA	1	bc
GAAAATGCAA	GAAACACCGGTGCTATTAGTGAGACCGTGGGGTTAGAGCTAGAAATAGCA	1	bc
GACAACTTAG	GAAACACAGGTTTTCGATCATAGGTCGTGGGGTTAGAGCTAGAAATAGCA	1	bc
AAATCACAGA	GAAACACCGGTGGCGATTAGATCTGAGTGGGGTTAGAGCTAGAAATAGAA	1	bc
GGTTCAGCTT	GAAACACCGGTTCTAGTTACTGATGGGTGGGGTTAGAGCTAGAAATAGCA	1	bc
GGAAATATTT	GAAACACCGGTGAGCATGATAACGTCCATAGCAAGTTAACCTAAGGCTAG	1	bc
CAACCCCTGC	GAAACACCGGTTTAGTATGGAGGGATTAGAGCTTGAAATAGCAAGTTAAC	1	bc
TAAAGGGAAT	GAAACACCGGTTTACGTAGGGGTTAGAGGGAGAAATAGCAAGGTAACCTA	1	bc
TGCTCTGACT	GAAACACCGGTCTTCCTGAAATCTACGTGGGGTAAGGCTTGGAATAGCAA	1	bc
AAACACCTGC	GAAACACCGGTTTAGTATGGAGGGACTAGAGCTAGCAATAGCAAGTTAAA	1	bc
CCAGGAACAA	GAAACACCGGTGGGGGTAGAGCTAGAAATAGCAAGTTAACCTAAGGCTAG	1	bc
AAGTATGTAG	GAAACACCGGTCCTAGAAGCTGAGTGGGGGTAGTGCTAGAAATAGCAAGT	1	bc
CCAGGACGAC	GAAACACCGGTAGAATCGAACCAAGAGAGGGGATGGTAATCGAAATAGAG	1	bc
CACAGTCGCG	GAAACACCGGTGCAATGGATGCACCGGTGGGGTTAGAGCTAGAAATAGCA	1	bc
GATACAACCG	GAAACACCGGTTATCGTTATGGATTCGTGGGGTTAGAGCTAGAAATAGCA	1	bc
AAAATGGATA	GAAACACCGGTGGGGGGGATAACGGCGGGGGAGTAATAGCTAGATATCCA	1	bc
TAATTAATCA	GAAACACCGGTTGGGATAATCACAACGAGGGCAAGAGAAAGAAATACTAG	1	bc
ATATCCCAAT	GAAACACCGGTTGAATGCGTTGGTTTGTGGGGTTAGAGCTAGAAATAGCA	1	bc
GACCGAGACT	GAAACACCGGTGCTCGCGGTTTCGAAGTGGGGTTAGAGCTAGAAATAGCA	1	bc
AGATAACACC	GAAACACCGGTTTTCTTTGCTCGAGGGTGGGGTTAGAGCTAGAAATAGCA	1	bc
TATTTGACAA	GAAACACCGGTTGTGGGGAACTCGGTGTGGGAGAAATAGCAAGTTAACCT	1	bc
ACGCGACGAC	GAAACACCGGTGGAATGGATACACGGGTGGGGTTAGAGCTAGAAATAGCA	1	bc
CATCGAGCAC	GACACACCGGTGACAAACGTATGTCAGTGGGGTTAGAGCTAGAAATAGCA	1	bc
TCCACTGTCT	CTAAACACCGGTTCTCGTCAGTTTGTAGTGGGGTTATAGCTAGAAATAGC	1	bc
AAATCATCCA	GAAACACCGGTTGTAGGCGATGGTTGGTGGGTTAGAGATAAAAATAACAA	1	bc
CAACTAATTT	GAAACACCGGTGCTAGCGGTTTCGAAGTGGGGTTAGAGTTAGAAATACCA	1	bc
GAACTATCTC	GAAACACCGGTGAGGATGATAACGTCCGGGGGGTTCGCGCTAAAAAGAGC	1	bc
ATACAGCCCT	GAAACACCGGCTGTAAGCGATGGTTTGTGGGGTTAGAGCTAGAAATAGCA	1	bc
CACTTGCTCC	GAAACACCGGTTTGATCTGCTACTTTGTGGGGTTAGAGCTATAAATAGCA	1	bc
GAAACCCCCC	GAAACACCGGTAATCTAAAGATCCCCGTGGGGATAGAGCTAGAAATAGCA	1	bc
AAGCGGGCCG	GAAACACCGGTCGCCTTTAGTGGACCGTGGGGTTAGAGCTAGAAATAGCA	1	bc
CCGTTGCAAC	GAAACACCGGTTGGCTTTACTCCTTTGTGGGGTTAGAGCTATAAATAGCA	1	bc
GATTCAACCA	GAAACACCGGTTATAGTAACGGATATGTGGGTTAAGAACTACAAATAGAA	1	bc
AATCGATAAA	GAAACACCGGTGACAAAAGTATGTCAGTGGGGTTAGAGCTAGAAATAGCA	1	bc
GGATTGCAAC	GAAACACCGGTGTTCTTTGCTCGCTGGTGGGGTTAGAGCTAGAAATAGCA	1	bc
AACAGTTCAT	GAAACACCGGTTCCGGTTAGCTCGGAGTGGGGGTAGTGGTAGAATTAGCT	1	bc
CACCCACGAC	GAAACACCGGTGACAAACGTCTGCCAGTGGGGTTAGAGCTAGAAATAGCA	1	bc
CACTGTGTTT	GCAACACCGGTACTAGTTACTTACGGGTGGGGTTAGAGCTAGAAATAGCA	1	bc
GACTTCATCC	GAAACACCGGTAATCTAAAAATAACCGTGGGGATAGAGCTAGAAATAGCA	1	bc
CATAATCCAA	GAAACACCGGTGCCCTTTATGGGACCGTGGGGTTAGAGCTAGAAATAGCA	1	bc
GTGTTATCTA	GAAACACCGGTGAGCATGATAACGTCCATAGCATGGTACCATAAGGCTCG	1	bc
ATTACCTTCA	GAAACACCGGTGATCATGATAACGTCCATAGCATGTTAACCTAAGTCTAG	1	bc
CAGTCAGCAG	GAAACACCGGTTGGCTTTACTCCTTTGTGGTGTTAGAGCTATAAATAGCA	1	bc
CAACAACAAC	GAAACACCGGTGTTATTTGCTTGAGAGTGGGGTTAGAGCTAGAAATAGCA	1	bc
GAGAACGCAA	GAAACACCGGTGAGATTCCTCACCGGGGGGGTTTAAGCTTAAAATTGCAA	1	bc
CTCATTTATA	GAAACACCGGTGAGCATGATCACGTACATAGCAAAGTGCCCTAAGGATCG	1	bc
ATATAACCCC	GAAACACCGGTGTTCGTAGATGGTGCGTGGGGTTAGAGCTAGAAATAGCA	1	bc
ATATGACACA	GAAACACGGGTTGAGGGGATCTAGGGGTGGGAGAGAGCTAGAGATAGCAA	1	bc
CCGATCACCC	GAAACACCGGTAGTCTATACATCCCTGTGGGGATAGAGCTAGAAATAGCA	1	bc
TTATTCATCA	GAAACACCGGTCGCGAAAATGAGGGGTTGGAGCTAGAAATAGAAAGTTAA	1	bc
AAATAGAACA	GAAACACCGGTTCAAGAAGCGTATTTGGGGGGGTGAGAGATAAAACTAGA	1	bc
CGTTGAGCGA	GAAACACCGGTGATAGAAATAGAAAGTTAACCTAAGGCTAGGCCGATATC	1	bc
GCGTAAACAA	GAAACACCGGTAGGAGTTACTCATTGGTGGGGTTAGAGCTATAAATAGCA	1	bc
AATAACATGA	GAAACACCGGTTTGGTATGGAGGGATTAGATCTAGAAATAGCAAGTTAAC	1	bc
TTGTCCTTCC	GAAACACCGGTCACGGAAGTGTGGGTGTGGGGCTAGACATAGCAAGTTAA	1	bc
ATTACAGACG	GAAACACAGGTCCTAGAAGCTGAGTGGGGTTAGAGCTAGAAATAGCAAGT	1	bc
TAACCAGAAT	GAAACACCGGTTTACTTCGGGGCTAGAGCTGGAAATAGCAAATTAACCTA	1	bc
GAGTCTGGAG	GAAACACCGGTTATCGTTACGGATTTGTGGGGTTAGAGCTAGAAATAGCA	1	bc
AACAGGGAAA	GAAACACCGGTTGTGGGGAACTTGGGGGGGGAGAAAGAGCAAGATAACCT	1	bc
GAAATATTAC	GAAACACCGGTTAGCATGATAACGTCCATAGCAAGTTAACCTAATGCTAG	1	bc
GAGCCAATGG	GAAACACCGGTTATCGTTACGGATTTGTGGGGTTAGAGCTAGAAATAGCA	1	bc
CCCCGACGAA	GAAACACCGGTAGAATGGATGCCCGGGTGGGGTTAGAGCTAGAAATAGCA	1	bc
CCACCAACCT	GAAACACCGGTTGTCTGCGCTGGTTTGTGGGGTTAGAGCTATAAATAGCA	1	bc
AACTCGCACG	GAAACACCGGTTCACGAGGAGACTTCTGGGGGGTTAGAGCTGAAATTGGC	1	bc
ATGAAAGCCG	GAAACACCGGTCCTGGAAGATGAGTGGGGTTAGAGCTAGAAATAGCAAGG	1	bc
GACAATTCCA	GAAACACCGGTTCCCGTTAGCTAGGAGTGGGGTTAGAGCTAGAAGTAGCA	1	bc
CATCGCCGAC	GAAACACCGGTAGCATGGGTCCACTAGTGGGGTTAGAGCTAGAAATAGCA	1	bc
GTCAACCACT	GAAACACCGGTGGCAGCCAGCCACTTGTGGGGTTAGAGCTAGAAATAGCA	1	bc
TTTACCGTCT	GAAACACCGGTCACGCTAGGATGTTGGTGTGGTTAGAGCTAGAAATAGCA	1	bc
CGTCGGGCAA	GAAACACCGGTCGTCGGTCGCAGGGAGTGGGGGTAGTGCCAGGATAACCT	1	bc
AATTATAGCG	GAAACACCGGTTCCCGTTACGGGTTCGTGCGAGTAGTGCTAGGTATAGCT	1	bc
AATCCAAGAG	GAAACACCGGTTATCGTTACGGATTTGTGGGGTTAGAGCTAGAAATAGCA	1	bc
TCACGGGAAC	GAAACACCGGTGGTCGTTCGGAGGGCGTGGGGTTGTAGCTCGAAATAGCA	1	bc
AACTTACTAC	GAAACACCGGTTTTCGTTACTCGCTCGTGGGGTTAGAGCTAGAAATAGCA	1	bc
GAGACCCAAG	GAAACACCGGTTATCGTTGCGGATTTGTGGGGTTAGAGCTAGAAATAGCA	1	bc
GCCTTGTAAA	GAAACACCGGTACTCATTACTTACTTGGTGGGGTATAAACCGAAATCTCA	1	bc
CGGCGGTACG	GAAACACCGGTCGTCTTTCGAAGGGCGTGGGGTTAGAGCTAGAAATAGCA	1	bc
ATCAAGCTGA	GAAACACCGGTGCGCGGAGCTTATGCGTGAGAAATAGCTAGAAATCTAAG	1	bc
TTAACCTTCG	GAAACACCGGTCATGGAAGCTGGATGGGGATAGAGATCGAAATAGCCAAA	1	bc
GAATCTCTAA	GAAACACCGGTACCAGTTACTTACGGGTGGGGTTAGAGCTAGAAATAGCA	1	bc
TTGACCGAAT	GAAACACCGGTTTAATAAGGTGATAGAGCTAGAGAGATAAAGTTAGACAT	1	bc
CGGTTGGTCC	GAAACACCGGTCGGCGTTCGTAGTGCGTGGGGTTAGAGCTATAAATAGCA	1	bc
TCCGCAACAC	GAAACACCGGTGGGGTTAGTGCTACAAATAGCAAGTTAACATAAGGCTCG	1	bc
GGGCACGAGC	GAAACACCGGTGGTGTTAGCGCTAGAAAGGGCTTGTTAATCGAAATCGCG	1	bc
AATCCCTTAA	GAAACACCGGTGACAAACGTATGTCAGTGGGGTTAGAGCTAGAAATAGCA	1	bc
CCCAGCTACA	GAAACACCGGTAGGCATGATACCGGCGTGGGGTTAGAGCTAGAAATAGCA	1	bc
TGATCATCCG	GAAACACCGGTTTTCGTAAACGGGGAGTGGGGTTAGAGCTAGAAATAGCA	1	bc
GATGCAAACG	GAAACACCGGTTATAGTTACGGATTTGTGGGGTTAGAGCTAGAAATAGCA	1	bc
GCAACCCACA	GAAACACCGGTAGTGTAAGAATCACCGAGGGCAAGGTAACAGAATGCGCT	1	bc
AGTAAAGCTT	GAAACACCGGTCTTCCTGGACTCTGCGTGGGGTAGAGATAGAAATAGCAA	1	bc
AAACACCTAC	GAAACACCGGTTTACTATGGATGGGTTAGGGGTAGGAATTGGAAATTACC	1	bc
CAATCCTCAT	GAACCCCCGGTTTACTTCGGGGTTAGAGCTAGAAATAGCAAGTTAACCTA	1	bc
CATCCCCACC	GAAACACCGGTAGAATGGCTCCACGGGTGGGGTTAGAGCTAGAAATAGCA	1	bc
TGCATACACC	GAAACACCTGTGGCAGCCAGCCACTTGTGGGGTTAGAGCTAGAAATAGCA	1	bc
TCAAATCCGC	GAAACACCGGTTTTAGTAAATGGTGAGTGGGGTTAGAGCTAGAAATAGCA	1	bc
AATACATCCT	GAAACACCGGTGACCAACGTATGTCAGGGGGGGTTAGAGCTGGAAATAGA	1	bc
AGCAACCAGG	GAAACACCGGTGGCAGCCGACCACTTGTGGGGTTAGAGCTAGAAATAGCA	1	bc
AGATAATAAA	GAAACACCGGTGTGCTCTGATCGAGGGGGGGGTTAGAGTTAGAATAACCA	1	bc
ACCTTTTCAA	GAAACACCGGTTGTAAGCGATGGTTTGTGGGGTTAGAGCTAGAAATAGCA	1	bc
ACCCGCCGAA	GAAACACCGGTAGAATGGAACCACGGGTGGGATTAGAGCTAGAAATAGCA	1	bc
ATCTTACCAC	GAAACACCGGTTTGCTGTGCTTCTTTGTGGGGTTAAGCATGTAACCAGAG	1	bc
ATCACCCACC	GAAACACCGGTTCAACCTGCGTCTTTTGTGGGGTTAGATCTAGAAATAGC	1	bc
AAACCCAAAC	GAAACACCGGTGTTGTTTGCTCGGGGGGGGGTAGAGATATAAAGATAACC	1	bc
CACACGCTCC	CTAAACACCGGTTTAATAGGGGTCTCTTGTGGGGTTAAACTAAAAATTAG	1	bc
GTGTTCAACC	GAAACACCGGTGCTAATAGTTAGCTCTTTGGGTTAGAGCTAGAAATCACA	1	bc
GGCAACACAC	GAAACACCGGTGGCCTCCAGCCACTTGTGGGGTTAGAGCTATAAATAGCA	1	bc
CCACGCAGGC	GAAACACCGGTAGAATGGATCCACGGGGGGGGATAGAGCTAGAAATAGCA	1	bc
GGTCACGATG	GAAACACCGGTGGCAGTCAGCCCCTTGTGGGGTAAAAGCAAAAATTAGCA	1	bc
CTGTCACACG	GAAACACCGGTCCTAGAAGCAGCGTGGGGTGAGTGCTAGTAATAGTAAGT	1	bc
AAACCAGTTT	GAAACACCGGTCTTCCTTGAGTCTACTTGGGGTAGATCTGGAAATAGCAA	1	bc
GATTTAACAC	GAAACACCGGTGATAATAGTTAGCTCGTGGGGTTAGAGCTAGAAATAGCA	1	bc
AACTAGCACC	GAAACACCGGTTCAAACGGCGTCTTTTGGGTGGTTAGAGCTAGAAATAGC	1	bc
GTAACAATTA	GAAACACCGGTGTGCTTTGTAAGGTCCTTGGCATGTAACTCGAAGGCTCG	1	bc
ACATCAACAA	GAAACACCGGTGGGGTTAGAGTTAGAGATAGCAAGATAACCCAATGCTAG	1	bc
GAAACCGAAA	GAAACACAGGTTTACGTAGGGGGTAGAGCTAGAAATAGCAAGATAAAGTA	1	bc
TTTACAGTTT	GAAACACCGGTCTTCCTGGAATCTACGTGGGGTAAAACTATGAGTAGCAC	1	bc
TTAAGCGTCA	GAAACACCGGTGACGCGAGGAAAGTGGTGGGGATAGCGCTAGAAATAGAA	1	bc
TTAACAGACA	GAAACACCGGTGGGGTTAGAGCTAGAAATAGCAAGTTAACCTAAGGCTAG	1	bc
GAACCATCCA	GAAACACCGGTGAGAATGAAAAGGTCTGTGGGGAGAAAGATAGAGATAGC	1	bc
AGACTACCAC	GAAACACCGGTGTTCTTTGCTCGAGGGTGGGGTTATAGCTATAAATAGCA	1	bc
TAGATCCAGT	GAACCACCGGTTTAGTTAGGGGTTAGAGTTGGAAATTTCAAGAAAGCTTA	1	bc
AGATCACCAA	GAAACACCGGTGTTCTTTGCTCGCGGGTGGGGTTAGAGCTAGAAATAGGA	1	bc
TAAAAAGAAT	GAAACACCGGTTTACTTAGGGGTTAGAGCTAGAAATAGCAAGTTAACCTA	1	bc
ATGACAGTAA	GAAACACCGGTCCTAGCAGATGGGTGTGGTTATAGCTCGAGATAGAACGT	1	bc
GAAATTTTAA	GAAACACCGGTGAGCATGATAAAGTCTCTGGCTAATTAACCTAAGTCTAG	1	bc
AACACACCAT	GAAACACCGGTTTACTTAGGGGATAGGGCTAGAACTAGAAGGTTAAAATA	1	bc
TGTAAGATAA	GTAACACCGGTGAGCATGATAACGTCCATAGCAAGTTAACCTAAGGATAG	1	bc
TGTCCAGCAA	GAAACACCGGTCTTCCGGGAATCTACGTGGGGTAGAGCTAGAAATAGCAA	1	bc
GCGATAACAA	GAAACACCGGTGAGCTTGATAACGTCGCGGGGAAGTTAACCTAAGTCTAG	1	bc
GACGGCGTCA	GAAACACCGGTAATATAAAGATCCCGGTGTGGATAGAGATAGAGATAGCA	1	bc
TACTATCTCC	GAAACACCGGTACTAGTTGCTTACGGGTGGGGTTAGAGCTAGAAATAGCA	1	bc
CCCTGGCATT	CTAAACACCGGTTCAACCGGCGTCTTTTGTGGGGTTAGAGCTAAAAATAG	1	bc
AAATCACTGA	GAAACACCGGTTTAGTATGGATGTGTGAGAGATAGAAATAGCAAGTTAAA	1	bc
TGATTAATCC	GAAACACCGGTTATGATAATGGATTTGTGGGGTTGGAGCTAGAAATAGCA	1	bc
TATTTCGCCG	GAAACACCGGTCGCGAAAATGTGAGGGTAGAGCTAGAGATAGCAAGTTAA	1	bc
AATTACCGTC	GAAACACCGGTCCTAGAAGCTGAGTGGGGTTAGAGCTAGAGATAGCAAGT	1	bc
TACTAGAACC	GAAACACCGGTTGAACCGGCGTATTTTGTGGGGTTTAAGCTAGAACTAGC	1	bc
CGGAGTGCTT	GAAACACCGGTTGCCGTTAGCACGGCGTGGGGTTAGAGCTAGAGATAGCA	1	bc
CAACGCTCTT	GAAACCCCGGTGCTAGCGGTTTCGCAGTGGGGTTAGAGCTAGAAATAGCA	1	bc
AAAGCAATGG	GAAACACCGGTTTAGTATGGAGGGATTAGAGCTAGAAATAGCAAGTTAAC	1	bc
ACCCGGCTAC	GAAACACCGGTTTTCGATAATAGGTCGTGGGGTTAGAGCTAGAAATAGCA	1	bc
CAAACAATTA	GAAACACCGGTTTGCATGGTAACGTCCATGGGATGTTAATCTAAGTCTAG	1	bc
TCAAGCGTCG	GAAACACCGGTGACGCGAGGACGGTGGTGGGGTTAGAGCCAGAAATAGCA	1	bc
TAAACAGCAT	GAAACACCGGTTTACGTAGGGGTTGAGGGGGGAAATAGCAAGTTAAACCA	1	bc
GAAGCATCGG	GAAACAGGTTAGGGAGAGAGCCAGTTGGGGGATTAAAGCTAGAAATAGCA	1	bc
CAACCCCAAC	GAAACACCGGTTTACTTAGTTAACTAGTGGGGTTAGAGCTAGAAATGGCA	1	bc
ATAAACCGAA	GTAACACCGGTTTACTTAGAGTTTAGAGCTAGAAATAGAAATTTAACCTA	1	bc
GCCAATGTAT	GAAACACCGGTACTAGTTACATACGGGAGGGGTTAGAGCTAGAATTAGCA	1	bc
AAGCCAGATG	GAAACACCGGTCTTGGTGGAAGATATGGGGGGGAGAGGTAGAAATAGAAA	1	bc
CAAACACAAC	GAAACACCGGTTTACTTAGGGGTTAGAGCTAGAAATAGCAAGTTAACCTA	1	bc
CGCCGCAGAC	GAAACACCGGTGGAATGGATCCTCGGGAGGGGTTAGAGCTAGAAATAGCA	1	bc
CTCTCCGCCC	GAAACACCGGTCACGAAAGTGTGGTGTTAGAGGTAGAAATAGCAAGCTAA	1	bc
TTATCAACAA	GAAACACCGGTGGCGTTAAAGTTAGAGTGGGGTTAGTGCTAGAAATAGCA	1	bc
CGGCCAGCTT	GAAACACCGGTCTTCCTGGAACCTATGTGGGGTTAAGCTAGAAATAGCAA	1	bc
ATATAAACGC	GAAACACCGGTGTGGGGAGATAATAAGTGAGAAATAGCAAGTAACCTCAG	1	bc
ACACTCTTTC	GAAACACCGGTTTTCGATCATAGGTCGTGGGGTTAGAGCTAGAAATAGCA	1	bc
AACACGGACG	GAAACACCGGTTCAACCGGCGTCTTTTGGGGGGTTAGAGCTAGAAATAGC	1	bc
CGTTAACAAG	GAAACACCGGTGGCAGCTAGACCTTTGTGGGGTTAGAGCTAGAAATAGCA	1	bc
CGCTTATCGA	GAAACACCGGTGAGCATGATAACGTCCATAGCAAGTTAACCTAAGGCTAG	1	bc
TAATCCCCCT	GAAACACCGGTTTACTTAGGGGGTAGAGCTAGATATAGCAAGTTAACCTA	1	bc
GTGACCCAAA	GAAACACCGGTGAGATGTGGGGTTAGAGCTAGAAATAGCAAGTTAACCTA	1	bc
GGAATATAAC	GAAACACCGGTGATCATGGTAACGTCGGTGGGGTTAGAGCTAGAAATAGC	1	bc
TAATTAATCC	GAAACACCGGTTTTGATAATTAAAAAGTGGGGTAGAGCTAGAAATAGCAA	1	bc
AATCCAGCTT	GAAACACCGGTGCTAGATGTTTACCAGTGGGGTTAGAGCTAGAAATAGCA	1	bc
TAATCTCAAG	GAAACACCGGTTTAATTAGGGGGTAGGGCTAGAGATAGCAAGTTAACCTA	1	bc
GTAATCGAGA	GAAACACCGGTGAGCATGCTAACGTCCGTGGGGTTAGAGCTAGAAATAGC	1	bc
AAATTAATCC	GAAACACCGGTTGCGATAGTAAATAAGTGGGGTAAGAGCTGAAATAAGCA	1	bc
TTTGCAGAAA	GAAACACCGGTGGTGGGAGAGTCGGTAAGGGAGAGATAGCAAATGAATAT	1	bc
GCATTAACCC	GCCACACCGGTTGTGCTCGTTACCTCGTGGGGTTAGGGCTGGAATTCCAC	1	bc
ATCTCACCCT	GAAACACCGGTGTGCGGCGATTGTTTGTGGGATTAAGGCTATAACCAACA	1	bc
AACAGGCACG	GAAACACCGGTTTTCGGGAACTCGTAGTGGGGGTAGAGCTAGAATAAGCA	1	bc
TAATCCAACT	GAAACACCGGTTTACTTAGGGGTTATAGCTGGTAATAGCAAATTTACCTA	1	bc
CCCAACCTAC	GAAACACCGGTAATCTCAAGACCTTCGTGGGGATAGAGCTATAAATAGCA	1	bc
CTGTAGCTGG	GAAACACCGGTGGTCGGAGGTAGGGCGTGGGGTTAGAGATAGAAATAGCA	1	bc
GGCCCCTCCG	GACACACCGGTGGCAGCCAGCCACTTGTGGGGTTAGAGCTAGAAATAGCA	1	bc
TAAATAAAAT	GAAACACCGGTTTACTTAGGGGTTAGATCTAGATATAGCTAGTTATCGTA	1	bc
ATAACCTTAG	GAAACACCGGTCCTAGTAGCTTAGAAGGGGGAGAATAAGAAAAAGCAAGT	1	bc
TCCCGCTCCC	GAAACACCGGTCGCGAATATGAGGGGTTAGAGCTAGAACTAGCAAGTTAA	1	bc
TGGGGGGAAG	GAAACACCGGTCGTCGTTCGTAGGGCGAGGGGTTAGAGCTAGAAATAGCA	1	bc
GAAAACAACA	GAAACACCGGTGGCAGCCAGCCACTTGTGGGGTTAGAGCTAGAAATAGCA	1	bc
ATCTGATCAC	GAAACACCGGTCGAGACGATCTCGGGTTAGGGGTAGAAACAAGAAATCAA	1	bc
CCTACATCAC	GAAACACCGGTGACACAAGTATGTCAGTGGGGTTAGAGATAGCAATCTAA	1	bc
CCGTTGATAG	GAAACACCGGTTTTCGATAATCGTTCGTGGGGTTAGAGCTAGAAATAGCA	1	bc
ACGGCGGCTA	GAAACACCGGTCGTCGTTCGTAGGGCGTGGGGTTAGAGCTAGAAATAGCA	1	bc
TTAATCCCCC	GAAACACCGGTCGCGAAAATGAGGGGTTAGAGCTAGAAATAGCAAGTTAA	1	bc
TCTACACTAA	GAAACACCGGTGGCAAGTGGATGGGGGTGGGGTTAGAGCTAGAAATAGCA	1	bc
ACGACCGACC	GAAACACCGGTCCTAGAAGCTGAGAGGGGGTTAAGCTAGGACTAGTACGT	1	bc
AAAAAAATGA	GAAACACCGGTTTAGTATGGAGGGATTAGAGCTAGAAATAGCAAGTTAAC	1	bc
TAATTAATCC	GAAACACCGGTTCAGTTTATCAGACCGTGGGGTAAGAGTTAAAAAAGGAA	1	bc
ATCCGAGCGA	GAAACACCGGTGGGCGGAGATTATGCGAGAGCTATAGCAAATAACCTAAG	1	bc
GACAAGAACG	GAAACACCGGTTGCCGATAGCAACTTGTGGGGTTAGTGCTCGAAATAGCG	1	bc
AATCATTTAA	GAACCCCCGGGACAAGTTTCTGACAGGGGGGGTTAGGGCTGGAAATAGAA	1	bc
ATAAAGCCAA	GAAACACCGGTTTACTTAGGGGTTAGAGCTAGAAATAGCAAGTTAACCTA	1	bc
GAAATCTATC	GAAACACCGGTGAGCTTGATAACGTCCATAGCACGTTACCCTAAGGCTAG	1	bc
AAATTACACA	GAAACACCGGTGCTAATAGTTAGCTCGTGGGGTTAGAGCTAGAAATAGCA	1	bc
ATGCCACGCG	GAAACACCGGTTATCGTTACGGATTTGTGGGGTTAGAGCTAGAAATAGCA	1	bc
GGTAAATAAG	GAAACACCGGTGGCAGCCAGACACTTGTGGGGTTAGAGCTAGAAATAGCA	1	bc
GAATTAACCC	GAAACACCGGTGCTAATAGTTAGCTCGTTGGGTTAGAGCTAGAAATACCA	1	bc
TCCTCTGTCA	GAAACACCGGTACTAGTTACTTAAGGGCGGGGTTAAGCATAGAAATCGCA	1	bc
GCCTTACCCC	GAAACACCTGTGCTAATAGTTAGCTCGTGGGGTTAGAGCTAGAAACAGCA	1	bc
CCTCGTCGCG	GAAACACCGGTAGCATGGATCCACGGGTGGGGTTAGAGCTAGAAATAGCA	1	bc
GTAACATCCT	GAAACACCGGTGCCCGTTAGCTCGTAGTGGGGTTAGAGCTAGAAATAGCA	1	bc
CAGTTCCCAA	GAAACACCGGTTGGCTTTACTCATTTGTGCGGTTAGAGCTATAAATAGCA	1	bc
GAATAGCGAG	GAAACACCGGTTATCGTTGCGGATTTGTGGGGTTAGAGCTAGAAATAACA	1	bc
TAATTCGCCC	GAAGCACCGGTTTCGAAAATGTGTGGGTGGGGCTAGAAATAGAAAGATAA	1	bc
AAAAAGCTAC	GAAACACCGGTGTTCTTTGCTCGAGGGGGGGTTGAGAGCGAAAAATAGCA	1	bc
ATGACAGTGA	GAAACACCGGTCTTCGGAGAGTTAGCAAGAGCAAGATAACCTAAGCTAAG	1	bc
CCCCGAAGAC	GAAACACCGGTGGAATGGATCCACGGGTGGGGTTAGAGCTAGAAATAGCA	1	bc
GAACCCCTTA	GAAACACCGGTTTACTATGGAGGGATTAGAGCTAGAAATAGAATGTTACC	1	bc
ATAACCCTAA	GAAACACCGGTGTCCATAGTGTGTCAGGCGGGATAGAGCACGTAAACCTA	1	bc
GCCTTGCACA	GAAACACCGGTTCTACTGGCTAGCTCGGGGGGGTAGAGCTTGAAAAAGCC	1	bc
TAATAACCGA	GAAACACCGGTTTGCTGAGGGGTTAGATGTGAAATTAGCAGGATACCATA	1	bc
AATTAAAGGG	GAAACACCGGTTATCGTTACGGATTTGTGGGGTTAGAGCTAGAAATAGCA	1	bc
CCTTCATCCC	GAAACACCGTTAGGATCGATACATTTTCGGGTTTGAGCCAGGAAATACAA	1	bc
AAAAAAAACA	GAAACACCGGTGCCCTTTGTGGGACCGTGGGGTTAGAGCTAGAAATAGCA	1	bc
GCAACACAAA	GAAACACCGGTGAGCATGATAACGTCCATAGCAAGTTAACCTAAGGCTAG	1	bc
TCCCAGCCGC	GAAACACCGGTAGAATGGATCCACGGGTGGGGTTAGAGCTAGAAATAGCA	1	bc
TACCCTTTCT	GAAACACCGGTTCCCGTTATCTCGTAGTGGGGTTAGGGCTGGAAATAGCA	1	bc
AAGCCAATCG	GAAACACCGGTTATCGTTACGGATTTGTGGGGGTAGAGCTAGAGATAGCA	1	bc
GAAACAGAAG	GAAACACCGGTTTAAGTAAATGGTGAGTGGGGTTAGAGCTAGAAATAGCA	1	bc
GAAATCTAAA	GAAACACCGGTGAGCATGATAACGTACATGGCATAGTAACCGAAGGAGAG	1	bc
TATACAGAAT	GAAACACCGGTCTTCCTGGAAAATACGTGGGGTAAAACTTGAAATTACAA	1	bc
ACCTGGCCCA	GAAACACCGGTTGTGGGGGACTCGGTGTGGGAGAAATAGCAAGTTAACCT	1	bc
TCAGCACTCA	GAAACACCGGTGGGGCTAGAGCGAGAGATGGCATGTTACCAGAAGGCTCG	1	bc
GACTCTCAAA	GAAACACCGGTACCAGTTAGTTACGGGTGTGGTTAGAGCTAGAAATAGCA	1	bc
AACCTCCTGA	GAAACACCGGTTTTCTATCATATGTCGTGGGCTTAGAGCTAGAAATAGCA	1	bc
TGAGAGAAAA	GAAACACCGGTGGGGTTAGAGCTAGGAAGGGCAAGTAAATAGAAGGCTAG	1	bc
CACCTCTCTT	GAAACACCGGTGCTAGCGGTTTCGAATTGGGGTTAGAGCTAGAAATAGCA	1	bc
CGCACTTAAA	GAAACACCGGTGCCCATTATCTCGTCGTTGGGTTTGAGCTAGAAATAGCA	1	bc
GTCTATGTCG	GAAACACCGGTACTAGTTGCTTACGGGGTGGGGTAGGGCTTGGAATTGCA	1	bc
CAATTACACA	GAAACACCGGTGCTAATAGTTCACTCGTGGGGTTAGAGCTAGAAATAGCA	1	bc
CCATCACATC	GAAACACCGGTTCAACAGGTGTCTTTGGGGGGGTTAGAGCTAAAAATAGC	1	bc
GTCTTTTCAC	GAAACACCGGTAGCGAAAATGTGGGGGTAGGGCTAGAAATAGAAAGATAA	1	bc
CAAAGAAGCC	GAAACACCGGTAGAATGGATCCACGTGTGGGGTTAGAGCTAGAAATAGCA	1	bc
GCTACTGACG	GAAACACCGGTGCCCGTTGTGAGAGCTTGGGATTGCAGCTTGACCTAGCG	1	bc
TAATTAATCC	GAAACACCGGTTGAAATGGCTAGAGATAGAAAGTTAACCTAAGACTAGAC	1	bc
ACGTCAGCAC	GAAACACCGGTTGTATTTAATGCTTTGTGGGGTTAGAGCTATAAATAGCA	1	bc
GCACGCCACC	GAAACACCGGTAGAATGGATCCACAGGTGGGGTTAGAGCTAGAAATAGCA	1	bc
TTCATCTCTA	GAAACACCGGTTAGCATGATAACCTCGATAGCATGTTAACCTAAGTCTAG	1	bc
TAAGCAACCA	GAAACACCGGTTGTCGTTACGGATTTGTGGGCATATAGCTATAAGTAGCA	1	bc
GACAATTAAA	GAAACACCGGTACTAGTTACTTACGGGTGGGGTTAGAGTTAGAAATAGCA	1	bc
GCACGCAGCC	GAAACACCGGTGGAATGAGTTAGATCGTGGGGTTAGAGCTAGAAATAGCA	1	bc
GAGACAGTCG	GAAACACCGGTTCTAGAAGCTGAGTGGTGGGAGAGCTAGTAATAGCAGGT	1	bc
TAATCATTAA	GAAACACCGGTTCAAGTAATAACAAGTTAACCTAATGCTAGTCCTTGATC	1	bc
GCAAGACGCA	GAAACACCGGTGGGATGGAGCTACGGATGGGATTATAACTAGAAACAGGA	1	bc
TGAAAATACG	GAAACACCGGTGGCAGCCAGCCACTTGTGGGGTTAGAGCTAGAAATAGCA	1	bc
TTATTAATCC	GAAACACCGGTGAGGTGCCTCACAGGTTGGGTTAGAGCTAGAAATAGCAA	1	bc
TTCATCCAAT	GAAACACCGGTTTACTTAGGGGTTAGAGCTAGAAATAGCAAGTTAACCTA	1	bc
GACCCAGTAA	GAAACACCGGTACTAGTTACTTACGGGTGGGGTTAGAGCTAGAAATAGCA	1	bc
AAAAATGCTT	GAAACACCGGTGCTCGCGGTTTCGCCGTGGGGTTAGAGCTAGAAATAGCA	1	bc
AAAACTGAAG	GAAACACCGGTTTACTTCGCGGTTCTAGTGGGAAATAGCATATAAACCTA	1	bc
ATCATATCCC	GCAACACCGGTCGCGAAAATGTGGGGGTAGGGAGAAATAGCAAATTAACC	1	bc
GTGCGCCGCC	GAAACACCGGTAGAATGGCTCGAAGGGTGGGGTTAGAGCTAGAAATAGCA	1	bc
ACATCACACC	GAAACACCGGTTCAATCAGCGTCTTTTGTGGGGTTAGAGCTAGAAATAGC	1	bc
CCCCGTCCCT	GAAACACCGGTAGAATGGATCTACGGGTGGGGTTAGAGCTAGAAATAGCA	1	bc
GTGTAAAGGA	GAAACACCGGTTATCGGAGAGTATTTGTGAGATAAGAGCTATAAATAGCA	1	bc
GACTTAGCCA	GAAACACCGGTACTCGTTACGTACGGGTGGGGTTAGAGCTAGAAATAGCA	1	bc
AATATAGCCA	GAAACACCGGTGCCATTTGTTAGCCCGTGGGGTTAGAGCTAGAAATAGCA	1	bc
AGACGGAACG	GAAACACCGGTGGTCGTTGGTCGAGGGAGAGGTAAGAGCTACAAGTAACA	1	bc
TAGCCAAGCT	GAAACACCGGTTATCGTTACATCTTAGAGGTAGAGATCTCTATTTAACAT	1	bc
ATGATACACA	GAAACACCGGTCCTAATAGTTAACTCAGAGGTATAGATCTCAAAATAACA	1	bc
ATGGGAGAAA	GAAACACCGGTGAGATGCCTCAAGTGATAGAAATAGCAAGTTAACCAAAG	1	bc
TATACTGCCT	GAAACACCGGTTGCCGGTAGCTCGGAGTGGGGGTAGTACCAGAATTAGCA	1	bc
TTGGCAATCA	GAAACACCGGTCCTAGAAGCTGAGTAAGGTTCGAGCTAGCAATAGCCAGT	1	bc
TCGTACTTCC	GAAACACCGGTTCCCGTTAGCTCGTAGTGGGGTTAGAGCTAGAAATAGCA	1	bc
ATCTTCGCCA	GAAACACCGGTCGCGAAAATGAGGGGTAAGATCTCGAAATAGCAAGTTAA	1	bc
TGACTCAGCA	GAAACACCGGTTTTAGTAGATGGTGAGCGGGGTTAGAGCTAGAAATAGCA	1	bc
GAACCAATAA	GAAACACCGGTTCAGATAGGTAGGTCGTGGGGTTAGAGCTAGAAATAGCA	1	bc
ATGCAAGAAG	GAAACACCGGTCTTCCTAGAAGGTAGGGGGGGGAGTTAGAAAAATAACAA	1	bc
GCCTGCGCCG	GAAACACCGGTTTTAGTGAACCACGGGTGGGGTTAGAGCTAGGGATAGCA	1	bc
GGCAAACTCA	GAAACACCGGTATTCTAAGAATCTCCGTGGGGATTAAGAAATAACCAGAA	1	bc
CGACGGGACG	GAAACACTGGTCGTCTTTGGTAGGGCGTGGGGTTAGAGCTAGAAATAGCA	1	bc
TCATATGCAA	GAAACACCGGTACTAGTTACTTACGGGAGGGGTTAGTGCTAGAAATAGCA	1	bc
GCCATATACC	GAAACACCGGTTCACCTGATAAAGTCCATAGCACGTTAACCTAATCCTAG	1	bc
GTAAATGAAA	GAAACACCGGTAAGAGGAGCTAGAGCTAGAGATAGCAAGTTAACCTAAGG	1	bc
GAAACAAAGA	GAAACACCGGTGTGGATTGGAAGGATTAGAGCTAGACATAGCAAGTTAAC	1	bc
CCTTGGACAA	GAAACACCGGTTGGGGTGAACCCGGTGTGGGAGAAATAGCATGATAATCA	1	bc
GTATTATCAA	GAAACACCGGTGAGCATGATAACGTCCGTGGGGTTAGAGCTAGAAATAGC	1	bc
CAGTGGGTCG	GAAACACCGGTTGTAGTTCGTAGGGTGTGGGGTTAGAGCTAGAAATAGCA	1	bc
GAATATGAAG	GAAACACCGGTATTAGTTACTTACGGGTGGGGTTAGAGCTAGAAATAGCA	1	bc
TGTAAAGTTG	GAAACACCTGTCTTCCTGGAATGTACGTTGGGGAGAGCTAGAAATAGAAA	1	bc
CCGTTAAGCG	GAAACACCGGTTGGCTTTACTCCTTTGTGGGGTTAGAGCTATAAATAGCA	1	bc
AGGTAGAACG	GAAACACCGGTTATCTTTGCGCGTGTGTGGGGTTAGAGCTAGAAATAGCA	1	bc
GCGCCACGCG	GAAACACCGGTAGAAGGGATGCACGGGAGGGAGTAGTGCTAGGATAAGAA	1	bc
ATCCCACCAC	GAAACACCTGTGACAAACGTATGTCAGTGGGGTTTGGGCTAGAAATAGCA	1	bc
GAATCGGACC	GAAACACCGGTTGAACTGGAGCTTTATGTGGGGATAGAGCTTGAAACAGG	1	bc
TCCGCGCACA	GAAACACCGGTGGGGTTAGAGCTAGAAATAGCAAGTTAACCTAAGGCTAG	1	bc
GACAAATCCC	GAAACACCGGTACTCTTTATGTCACCGTGGGGTTAGAGCTAGAAATAGCA	1	bc
CGCCGCTGCA	GAAACACCGGGGGAATAGATAGAAGTGGGGGGTTAAAGTTAGAAATAGCA	1	bc
TGTTCTTAAA	GAAACACCGGTGCTAGAAATAGCAAGTTAACCTAAGGCTAGTCCGTTATC	1	bc
TATAACTGAC	GAAACACCGGTTTTAGTAAATGGTGAGTGGGGTTAGAGCTAGAAATAGCA	1	bc
TCCTTGCTCC	GACACACCGGTTCAACCGGCGTCTTTTGTGGGGTTAGAGCTAGATATAGC	1	bc
CGGCGGACAG	GAAACACCGGTCGTCGTTCGTAGGGCTTGGGGTTAGAGCTAGAAATATCA	1	bc
GATTCAGTAA	GAAACACCGGTGCTAATTGCTTATGGGGGGGGTTAGAGCTAGAAATAGCA	1	bc
AGCACATCAT	GAAACACCGGTTCCCGTTGTATGTTAGTGGGGTTAGAGCTAGAAATAGCA	1	bc
CTTGCACTTC	GAAACACCGGTTCCCGTTAGCTCGTAGTGGGGTTAGAGCTAGAAATAGCA	1	bc
GAGTTAGCTG	GAAACACCGGTCTTCGTACGTGGTGAGTGGGGTTAGAGCTAGAAATAGCA	1	bc
GGCCAGCAAG	GAAACACCGGTGGTCTTAGCTAGCAGGTGGGGTTAGGGCTGGAAAGAGCA	1	bc
ATACCCATCC	GAAACACCGGTTTAGAATGGAGGGATTAGAGCTATAAATAGCAAGTTAAC	1	bc
GGATCAGAAA	GAAACACCGGTGTTAATAGTATGCTCGTGGGGTTGGGGCAAGAAATAGAA	1	bc
TTCTTATAAA	GAAACACCGGTCGCGAAAATGTGGGGTTGGAGCTAGAACTAGCAAGTTAA	1	bc
TAATTAAACC	GAAACACCGGTGCTAATAGTTAGCTCGTGGGGTTAGAGCTAGAAATAGCA	1	bc
TTGTTCTGCG	GAAACACCGGTCGCGAATATGTGGGGTTAGAGCTAGAAATAGCAAGTTAA	1	bc
CGTCCGCAAA	GAAACACCGGTGTTCTTTGCTCGTGGGTGGGGTTAGAGCTAGAAATAGCA	1	bc
CACAACATGA	GAAACACCGGTTTCGTATGGAGGGATTAGAGCTAGAAGTAGCAAGTTAAC	1	bc
CAATCCTCAA	GAAACACCGGTGTGAACAGTGGGTTTTGGGGTTATAGCAGTAAATAACAC	1	bc
ATCACTGTAG	GAAACACCGGTACTAGTTGCTTACGGGGGGGAGTAGAGCTAGAAATAGCA	1	bc
GAATTAGTAG	GAAACACCGGTGCTAACAGTTAGCTTGGGGGGTTAGAGCTAGAAATAGCA	1	bc
AAAACCGCCA	GAAACACCGGTGTACTTTGTTGGACCGTGGGGTTAGAGCTAGAAATAGCA	1	bc
CAGTGAAGTG	GAAACACCGGTTATCGTTACGGGTTTGAGGGGTTGGAGTTACAAGTAGAA	1	bc
CACCCCCTCC	GAAACACCGGTAATATAAAGCTACCGGTGGGGTTAGAGCTAGAAATAGCA	1	bc
GGAACATATT	GAAACACCGGTCCTCGTTGGCTCGTCGTGGGGTTAGAGCTAGAAATACCA	1	bc
GAGCCGAGAG	GAAACACCGTTTATAGTTCTGGATTTGTGGGGTTGGAGCTAGAAATAGCA	1	bc
AACTGCGCGA	GAAACACCGGTTGTGGAGAAGTCGGTGTGGGTAGAATAAGAAGTTAAACT	1	bc
AACTCACCAC	GAAACACCGGTTCAACCGGCGTCTTTGGTTGGGTTAAGGCAAAAAATAGC	1	bc
ATGTCACTCG	GAAACACCGGTTAGCGGAGAGGATGTTTGAGAAATAGCAAGTAAACTAAG	1	bc
TACACGCTAT	GAAACACCGGTGTTGGATCGAAGTTAGAGGTGGTAATACCAGAAAAAGCA	1	bc
ATGCCCGTAT	GAAACACCGGTCCTAGTAGCTGAGTGGGGTTAGTACTAGAAATAGCACCT	1	bc
AAATTCACGC	GAAACACCGGTCGCGAAAATAGGGGGATAGGGCTAGAAATAGGAAGTTGA	1	bc
CAACGAAAAA	GAAACACCGGTGCTGGTGGATCTGGAGAGGGCATAGTAATAGAAATAGAA	1	bc
GTCTCTCACA	GAAACACCGGTACTAGTTACTTACGGGTGGGGTTAGAGCTAGAAATAGCA	1	bc
AAATTGATAA	GAAACACCGGTTGTGGGGAACTCGGTGTGGGTGAAATAGCAAGATTACCT	1	bc
GCATCGAAGA	GAAACACCGGTTTAGTCTGGGGGGTCTAGGGCGAGATATAGAGAGATAAC	1	bc
AGTTAATCGA	GAAACACCGGTGCGCGGAGTAGCAAGTTGAGCTATGGCTAGTAACTTATC	1	bc
AGACAAGATT	GAAACACCGGTCTTCCTTGCACCAACGTGGGGTTGAGCTAGGAAATGCAA	1	bc
AAAATATCTA	GAAACACCGGTGAGCATGATAACGCAGAGAGCAAGTAAACCTAAAGCTAG	1	bc
CGGCCAAGTG	GAAACACCGGTCGTCGTTCGGAAGGTGTGGGGTTAGAGCCAGAAATAGCA	1	bc
TAAAACAACT	GAAACACCGGTTTAATTCGGGGTTAGAGGTGGAAATAGCAAGTTACCGTA	1	bc
GCAACAAATA	GAAACACCGGTGAGCATGATAACGGCCGTGGGGTGAGAGCTAGAAATAGC	1	bc
TCAACATATA	GAAACACCGGTGAGCATAGTAACGTCAATAGCAAGTTAACCTAAGGCTAG	1	bc
TGTCGGGTTT	GAAACACCGGTCTTCATAGCATCTACGAGCAAGAGAGCTAGAGGTAACTA	1	bc
TGTCAAGCGT	GAAACACCGGTCTTCCTGGAATCTACGTGGGGTAGAGCTAGAAACAGCAA	1	bc
GCGTCCCGCG	GAAACACCGGTGATGCTTGCGGATTTGTGGGGATAAGGAAGGAAACAGAA	1	bc
GTAATAACAA	GAAACACCGGTTTGCTTTATAACGTTGCGAGTTAACATAAGTCTATTGCG	1	bc
AGACCACCAC	GAAACACCGGTGTTCTTTGATCGAGGGTGGGGTTAGAGCTAGAAATAGCA	1	bc
ATGACAAACG	GAAACACCGGTCCTAGAAGCTGAGTGGGGTTAGAGCTAGAAATAGCAAGT	1	bc
TTGTCTGATA	GAAACACCGGTCTTCCTGGAATATACGTGGTGTAGAGCTAGAAATAGCAA	1	bc
ACGACAGTAG	GAAACACCGGTCCTAGAAGCTGAGTGGGGTTAGAGCTAGAAATAGCAAGT	1	bc
GGCAGTTCCA	GAAACACCGGTGCTAATAGTTAGCTCGTGGGGTTAGAGCTAGAAATAGCA	1	bc
GACGGCTCCA	GAAACACCGGTGAGGTGCATCACCGGGGGGGGTAGAGGTAGGAATAGGAA	1	bc
AATTCCGCAG	GAAACACCGGTTTTAGGAAATTCTGAGTGGGGGTAGTAGTAAGTTTAGCA	1	bc
TGGCAAGACT	GAAACACCGGTCTTCGTGACTTCTACGTGGGGTAGAGCTAGAAATAGCCA	1	bc
CCATCGGCCG	GAAACACCGGTTTTAGTAAATGGTGATTGGGGTTAGAGCTAGAAATAGCC	1	bc
AAACCAGCCC	GAAACACCGGTGACAAAAGTATGTCAGTGGGGTTAGAGCTAGAAATAGCA	1	bc
GAGTAACGAG	GAAACACCGGTTATCGTTACGGATTTGTGGGGTTAGAGCTAGAAATAGCA	1	bc
AAGAATGTCA	GAAACACCGGTCCTAGAAGCTGAAGGGGGGTATAGCGATAGATATCGAAA	1	bc
TGCAACCTAC	GAAACACCGGTGGCAGCCAGCCACTTGTGGGGTTAGAGCTAGAAATAGCA	1	bc
ACCATACTAC	GAAACACCGGTTTTCGATCATAGGTCGTGGGGTTAGAGCTAGAAATAGCA	1	bc
GAGACTGTAA	GAAACACCGGTCCTAGTTACTTACGGGTGGGGTTAGAGCTAGAAATAGCA	1	bc
CGGCGATCAA	GAAACACCGGTCGTCGTTGGTAGGGCGTGGGGTTAGAGCTAGAAATAGCA	1	bc
TGTACTGCTT	GAAACACCGGTCTTCCCGGAATCTACGTGGGGTAGAGCTAGAAATAGCAA	1	bc
GGCACTGCCA	GAAACACCGGTACTCGTTACTTCCGAGTGGGGTTAGAGCTAGAAATAGCA	1	bc
AACAGGGAAA	GAAACACCGGTTTTCGATCATAGGTCGTGGAGATAGAGCTATAAATAGCA	1	bc
GAAATAATAG	GAGACACCGGTTTTAGTTCTTAGGTCGTGGGGTTAGAGCTAGAAATAGCA	1	bc
CGGGGGATTA	GAAACACCGGTCGTGGTTCGTAGGGCGTGGGGTTAGAGCTAGAAATAGCA	1	bc
AAGTCACTCG	GAAACACCGGTTATCGATCAGGGTTTGTGGGGTTAGAGCTAGAAATAGCA	1	bc
TTATTCCCCT	GAGACACCGGTTTCGTTAATGGTTAGATCTGGTTATAGCAAGATATACTA	1	bc
GAGGCCGAGG	GAAACACCGGTTATCGGTCCGGATTTGTGGGGTTAGAGCTAGAAATAGCA	1	bc
GATTTTGTAC	GAAACACCGGTACTCGTTACTTCCAGGTGGGGTTAGAGCTAGAAATAGCA	1	bc
GAAATAAACC	GAAACACCGGTGAAGATAATCAAAAAGGGGGGTAGAGAGCTGAAAAGCAA	1	bc
GTACTCCATC	GAAACACAGGTGAGCATGATAACGTCCATAGCATGTTAACCTAAGGCTAG	1	bc
GGTTCAGCTT	GAAACACCGGTCTTCCTGGAATCTACGTGGGGTTGGGCCTAAAAAAGGAA	1	bc
AATCAGGACG	GAAACACCGGTGCTCTTTGTGGGACCGTTGGGTTAGAGCTAGAAATAGCA	1	bc
GACTCTGCCT	GAAACACCGGTTTTAGTAAATGGGGAGTGGGGTTAGAGCTAGAAATAGCA	1	bc
TAAACAAACA	GAAACACCGGTGGTGTTAGAATCAGCGAGGGGAAGTAAACATAAGGAGAA	1	bc
TAGCCAAGTG	GAAACACCGGTTATCGTTACGGATTTGTGGGGTTAGAGTTAGAAATAGCA	1	bc
AGGCTATGTA	GAAACACCGGTACTAGTTACTTACGGGTGGGGTTAGAGCTAGAAATAGCA	1	bc
TACAGCCGCT	GAAACACCGGTTTACTTATGGGATAGGGCTAGAAATAGCAAGTTAAACTA	1	bc
ATTTTGTCAA	GAAACACCGGTCGCGGGGAACTCGGGGTGGGAGAAATAGCAAGTTAACAT	1	bc
CAGCCGGTCA	GAAACACCGGTCGAAGATCGTAGGGGGTTGGGTTAGAGCTAGAAATAGCA	1	bc
TAAAGCCGAC	GAAACACCGGTTTGCTTAGAGGTTAGAATTGGAAATAGCAATTTAACCTA	1	bc
CCCTGGACAA	GAAACACCGGTTGGCTTTACTCCTTTGTGGGGTTAGAGCTATAAATAGCA	1	bc
GAGACAAGTA	GAAACACCGGTTATCATTACGGATTTGTGGGATTAGAGCTAAAAAAAGCA	1	bc
CCTTCGCCCA	GAAACACCGGTTAAAACGGCATCTTTTGTGGGGTTAGAGATAGAAGTCGC	1	bc
TAATATACCA	GAAACACCGGTTCTAGTTACTTCCTCGTGGGGTTAGAGCTAGAAATAGCA	1	bc
ATAATGGATG	GAAACACCGGTTATCGAGACTACGTCCAGAGCTAGTTAATATAAGTCTAA	1	bc
GAGCCACGTG	GAAACACCGGTTTTCGTTGCTTATACGTGGGGTTAGACTTAGAAATAGCA	1	bc
TTCGCAAAAC	GAAACACCGGTCGCGAAAGTGTGGGGTTAGAGATAGAAATAGCAAGATAA	1	bc
TCGTAAAAAA	GAAACACCGGTGGGGGGAGAGCAAGAAAGAGCAATTGAACCTAAGGCTAT	1	bc
GTAATCTCTC	GAAACACCGGTGAGCATGATAACGTCCGTGGGGTTAGAGCTCGAAATAGC	1	bc
GAATATGCAG	GAAACACCGGTATTAGTAAATGGTGAGTGGGGTTAGAGCTAGAAATAGCA	1	bc
GTCTATTCAC	GAAACACCGGTCGCGGAAATGTGGGGTTAGAGCTAGAAATAGCAAGTGAA	1	bc
TGCCACTACT	GAAACACCGGTGTCCCCCGACCACTTGTGGGGTAGGAGTAGGAAATAGAA	1	bc
AGTTCAGATA	GAGACACCGGTCTTGCTGGAATCTACGTGGGGTAGAGCTAGAAATAGCAA	1	bc
GTCATCTACA	GAAACACCGGTGTGCGGAGATTATGCGTGAGAAATAGCAAGTAACCTAAG	1	bc
TGCTCAGCTT	GAAACACCGGTCTGCCGGGAATCTACGTGGGAAAGAGCTAGAAACAGAAA	1	bc
TAATTCCTAC	GAAACACCGGTTTACTTAGGGGTTAGAGCTAGGAATAGCAAGTTTACCTA	1	bc
CGGTGGGATA	GAAACACCGGTCGTAGTAGGTAGGGCGTGGGGTTAGAGCTAGAAATAGCA	1	bc
CAATCATCAG	GAAACACCGGTGCTAGAAATAGCAAGGTAACCTAAGGCTAGTCGGTTATT	1	bc
CGGCTAGATT	GAAACACCGGTCTTCCTGGACTCTACGTGGGGTAGAGCTAGAAATAGCAA	1	bc
TATACATAAA	GAAACACCGGTGTACTTAGGGGGTAGTGCTGGAGGTAGTAGGATAACCTA	1	bc
AGCCAACAGC	GAAACACCGGTGTTCTTTGATTGTGCGTGGGGTTGAGCCTGAAACTCGAA	1	bc
ATGCCCTTCT	CTCCCCCCCGGTCCTCTCCTCTGAGTGGTTTTCTCGCTAGAACTCTCCCG	1	bc
ATATAACAGT	GAAACACCGGTGTGCGGCGATTATGTGTGAGAAATAGCAAGTAACCTACG	1	bc
AAATTCAAGA	GAAACACCGGTGCTGATAACTAGCTCGTGGGGTTAGAGCTAGAATACGCA	1	bc
GACTTTTTTC	GAAACACCGGTACTAGTTACATACGGGTGGGGTTAGAGCTAGAAATAGCA	1	bc
AATACCTAAT	GAAACACCGGTTTACTTAGGGGGTAGAGCTGGAAATAGCAAGATAACCTA	1	bc
GTCTTATATC	GAAACACCGGTGAGCATGATAACGTCCGTGGGGTTAGAGCTAGAAATAGC	1	bc
GATGGCGCGA	GAAACACCGGTTGGATGCCTCACGGTGGGGGTGAGATCTAGAGATAGCAT	1	bc
ACTACCGCCG	GAAACACCGGTGCCCTTAGTGCGACCGTGGGGTTATAGCTAGAAATAGCA	1	bc
AAACAGGCAA	GAAACACCGGTGGTCGGGAATCCAGGGTGGGGGTAAAAGTAAAAAAACCT	1	bc
AGATCATAAA	GAAACACCGGTGCTCGAAATAGCAAGTTAACCTAAGACTAGTCCGTTATC	1	bc
GTACAGTAAC	GAAACACCGGGGTGTATGCTAACGGCCGTGGCTAGTTAACCTAAGACTAG	1	bc
TTATAGCAAC	GAAACACCGGTCGTGAATATGTGGGGGTAGGGTTAGAAATAGAAAGATAA	1	bc
GAGGGCGTAA	GAAACACCGGTGAGATGCATCAACGGTGGGGTTAGAGCTAGAAATAGCAA	1	bc
GCCTGTGTCC	GAAACACCGGTGCTAGGTACTTACGGGTGTGGTTAGAGCTAGAAATAGCA	1	bc
GCGTCGCGCG	GAAACACCGGTTCTCGTTGCGGATTTGGGGGGTTAGGGCTGGAAATAGAA	1	bc
GGGCACTTCC	GAAACACCGGTTCCCGTTAGCTCGTAGTGGGGTTAGAGCTAGAAATAGCA	1	bc
AAGACAGCTA	GAAACACCGGTGTTCTTTGCTCGAGGGTGGGGTTAGAGCTAGAAATAGCA	1	bc
GGCAAAGGTT	GAAACACCGGTCGGCTTTCGGATGGCGTGGGGATAGAGCTATAAGTAGCA	1	bc
GCGATATCAA	GAAACACCGGTGAGCATGATAACGTCGATAGCACGTTAACCTAAGGATAG	1	bc
TGCCCAGCGT	GAAACACCGGTCTTCCTGGAATCTACGTGGGGTAGAGCTAGAAATAGCAA	1	bc
CCGCGAGCTT	GAAACACCGGTGCTAGCGGTTTCGAAGTGGGGTTAGAGCTAGAAATAGCA	1	bc
AGAAGCCCCA	GAAACACCGGTTGTGGGGAACTCGGTGTGGGAGAAATAGCAAGTTAACCT	1	bc
AGCTCTTCGT	GAAACACAGGTGCGCGGAAACTCTGCGTGGGAAATAGCAAGTAACTAACG	1	bc
ATGAACGAAG	GAAACACCGGTCCTAGAAGCTGAGGGGGGGTAGAGCTGGAAGTAACAAGT	1	bc
CCATCAAACA	GAAACACCGGTGCTAATGGCTAGTTCGGGGGGTTAGAGCTAGAAATAGCA	1	bc
AATCCAGATC	GAAACACCGGTGACAAACGTATGTCAGTGGGGTTAGAGCTAGAAATAGCA	1	bc
AGGTGGGCAG	GAAACACCGGTTGTGGGTCGTAGGGCGTGGGGTTAGAGCTAGAAATAGCA	1	bc
CGGTCATGCA	GAAACACCGGTTATCGGTATGGACGTGTGGGGTGAGAGCTAGAAATAGCA	1	bc
AATCCGATAA	GAAACACCGGTTTAGTATGGAGGGATTAGAGCTAGAAATAGCAAGTTAAC	1	bc
TTATTAACCC	GAAACACCGGTCGAGAAAATGTGGGGGTGGGGCTAGAAATAGAAAGGTAA	1	bc
GGTGCCTCAA	GAAAAACGTGTGCTGGACTTAGCAAGTTAACCTAAGGTTAGTCCGGTATC	1	bc
ACCCGCCTAC	GACACACCGGTACTAGTTACTTACGGGTGGGGTTAGAGCTAGAAATAGCA	1	bc
AAAATCAAAG	GACACACCGGTTTACTTTCGTAGTTCGTTTAGTTAGAGCTAGCAATCGAA	1	bc
GAAATCCATA	GAAACACCGGTTTGCATGCTTACGTCCTTGGGTTAGAGCCAGAAGGATCA	1	bc
AAATACACAT	GAAACACCGGTCTTCCTGGAATCTACGTGGGGTAGAGCTAGAAATAGCAA	1	bc
CCGAGAAAAA	GAAACACCGGTTGGGTTAAATCCTTTGAGGGGATAGAGATATAAATAGAA	1	bc
AGACCGGATT	GAAACACCGGTCTTCCTTGCTTGTGGGTGGGGTAGAAATAGAAATTGGAA	1	bc
ATGAGAGTAG	GAAACACCGGTCCTAGAAGATGAGGGGGGGTAGAGCTAGCAATAGCAAGT	1	bc
ACTCCCCTCT	GAAACACCGGTGACGCGAGGATGGTGGTGGGGTTAGAGCTAGAAATAGCA	1	bc
TGCTCAGTAA	GAAACACCGGTCCTCCTTGCATCCAGGTGGGGTTGAGGCAGAAAAAGGAA	1	bc
AAAGGAAAAA	GAAACACCGGTGGGGTTAGAGCTAGAAATAGCAAGTTAACCCAAGGCTAG	1	bc
ATCTATGTCA	GAAACACCGGTACTAGTTACTTACGGGTGGGGTTAGAGCTAGAAATAGCA	1	bc
TCACAAGATT	GAAACACCGGTCCTCCTGGAATCTACGTGGGGAAGAGCTAGAAATAGCAA	1	bc
AATTCCTCGA	GAAACACCGGTGCTAGACGTAGCAAGTTAACCTAAGGCTAGACCGTTATC	1	bc
CACACTGCCT	GAAACACCGGTACCCGTTAGCTCGAAGTGGGGTTAGAGCTAGAAATAGCA	1	bc
CGACGGGTGA	GAAACACCGGTCGTCGTTCGTAGGGCGTGGGGTTAGAGCTAGAAATAGCA	1	bc
AACAACCACG	GAAACACCGGTGGCAGCCAGCCACTTGTGGGGTTAGAGCTAGAAATAGCA	1	bc
TAGTTCATCA	GAAACACCTGTGCTAGAAATATCAAGGTAACCTAAAGCTAGTCCGTTATC	1	bc
TCATCAAACG	GAAACACCGGTGGGGTTAGATCTAGAAATAGCAAGTTAACCTAAGGCTAG	1	bc
GAGACCAGAG	GAAACACCGGTTATCGTTACGGATTTGTGGGGTTAGAGCTAGAAATAGCA	1	bc
AGAACAACCT	GAAACACCGGTTGCCGTTAGCTCGTAGGGGGGTTAGAGCTAGAAATAGCA	1	bc
TAATTAATCC	GAAACACCGGTTGAATGAATCCAAGGGTGGGGTTGGGCTTGAAATAAGCA	1	bc
TCTTCGGAAT	GAAACACCGGTCCTCCTGGCGTCTTTTTGGGGGTTATCGCTAGATATCGC	1	bc
TACGCAAACA	GAAACACAGGTGGGGTTAGAGCTAGAAATAGCATGTTAACCTATGGCTCG	1	bc
ATTCTCTCAC	GAAACACCGGTGACAAACGTATGTCAGTGGGGTTAGAGCTAGAAATAGCA	1	bc
AACTAACCCC	GAAACACCGGTGTGCGGAGATTATGCGTGAGAAATAGCAAGTAACATAAG	1	bc
AGGTGGGATG	GAAACACCGGTCGTCGTTCGTAGGGCGTGGGGTTAGAGCTAGAAATAGCA	1	bc
AACAAATCTA	GAAACACCGGTGTGCGGAGATTAAGCGTGAGAAATAGCAAGTAACCTAAG	1	bc
TACTAAGTAC	GAAACACCGGTAATAGATACTTACAGGTGGGGTTAGAGCTAGAAATAGCA	1	bc
CCCAGCTGCG	GAAACACCGGTAGAATGGATCCACGGGTGGGGTTAGAGCTAGAAATAGCA	1	bc
TAAAAGCAAC	GAAACACCGGTTTTCTTAGCTAGCGGGTGGGGTTAGAGCTAGAAATAGCA	1	bc
GACCCATAAC	GAAACACCGGTGACAACCGTATGTCAGTGGGGTTAGAGCTAGAAATAGCA	1	bc
AGGTTGCCAC	GAAACACCGGTGGTCTTTGCTCGTGGGTGGGGTTAGAGCTATAAATAGCA	1	bc
TTGATAGTTA	GAAACACCGGTGAGCATGATAACGTCCATAGCAAGTTAACCTAAGGCTAG	1	bc
CACCCATCCC	GAGACACCGGTGACAAACGTATGTCAGTGGGGTTAGAGCTAGAAATAGCA	1	bc
TCCGCCGAGA	GAAACACCGGTGGGGTTAGAGCTCGAGTTAGCAAGTTAAACTAAGGCTAG	1	bc
AATGAACGTC	GAAACACCGGTCCTAGAAGCTGAGTTGGGTTAGAGCTAGAAATAGCAAGT	1	bc
ATACCATCCC	GAAACACCGGTGACAAACGTATGTCAGTGGGGTTAGAGCTAGAAATAGCA	1	bc
ATATCACCCA	GAAACACCGGTTGGGAGCGATTGTTTGTGGGAATAAAGCTAGAACTCGCA	1	bc
AGTCCATTAA	GAAACACCGGTGCTAGAAATAGCAAGTTAACCTAAGGCTAGTCCGTTATC	1	bc
TCGAGCGTCA	GAAACACCGGTGAAGCGCGGCCGCGGGTGGGGTAGGGCTAGGAATAACAA	1	bc
GCGTTATATA	GAAACACCGGTTGGCATGATTCCTTTGGGGGGGTAGAGCTATGAATAACC	1	bc
GAACGAAAAC	GAAACACCGGTGCTATTAGTTAGCTCGTTGGATTAGAGCTAGAAATAGCA	1	bc
CGATCAACGA	GAAACACCGGTGCAGTAAGTAGCAAGTTGAGCTAGGGCTAGCCCGTTAAC	1	bc
CACTTAATGC	GAAACACCGGTTTTCGATAATAGGTCGTGGGGTTAGAGCTAGAAATAGCA	1	bc
TAATCAAGAG	GAAACACCGGTTATCGTTACGGGTTTGTGGGGTTAGAGCTAGAAATAGCA	1	bc
GTATAACATA	GAAACACCGGTGGGCGGTGGTTGGGCTGGGGATATAGCAAGTAACCGCAG	1	bc
TTCTGCTGCA	GAAACACCGGTTGAGTGGATGTGGGGTTGGAATTACAAGTAAGACGATGT	1	bc
AACACATTAA	GAAACACCGGTTTTCGATCATAGGTCGTGGGGTTAGAGCTAGAAATAGCA	1	bc
GGTCAAGGTT	GAAACACCGGTACTCCTGGAATCTACGTGGGGTAGAGCTAGAAATAGCAA	1	bc
GAATCAGAAT	GAAACACCGGTTTACTTAGATGACGAGTGGGGTTAGAGCTAGAAATAGCA	1	bc
AGCACGGCCT	GAAACACCGGTTCCCGTTAACTCGTTGTGGGGTTAACACTAGAAATAGCA	1	bc
TTCTTAAAAA	GAAACACCGGTCGCGAAAAAGTGGGGATAGAGATAGTAATAGCAAGTTAA	1	bc
CTCTGCTGCC	GAAACACCGGTCGCGAAAATGCGTGGTTGGAGCTAGAAATAGCAAGATAA	1	bc
TTCCAGCCAA	GAAACACCGGTGGTCTATGCTCGAGGGGGGGGTTAGAGCTAGAAATAGCA	1	bc
CCCAACGCCC	GAAACACCGGTAGAATGGATCCACGGGTGGGGTTAGAGCTAGAAATAGCA	1	bc
ATGTCGCACC	GAAACACCGGTTCAACCGGCGTCTTTTGTGGCGATAGAGCTAGAAATAGG	1	bc
GTAGCAGAGA	GAAACACCGGTGAGATGCCTCACCGGTGGGGTTAGAGCTAGTAATAGCAA	1	bc
GGGGCAGAAA	GAAACACCGGTGAGATGCGTCACCGGTAGGGTTAGATCTAGAAAGACCAA	1	bc
CCCCGATCAC	GAAACACCGGTGCGAACGTTCCGCTGTGGGGTTTAGAGCTAGAAATGCCA	1	bc
ATACTAACAT	GAAACACCGGTTGTATGTGCTGGTTTGTGGGGTTAGAGCTAGAAATAGCA	1	bc
AAACCCCGCA	GAAACACCGGTTTAACCTGCGGGGATTGGGGCGAGAGAGAGAGAGATAGC	1	bc
AGTCGGGTTT	GAAACACCGGTCGCCGTTCGAAGGGAGGGGGGTTAGAGCTAGAAATAGCA	1	bc
TACAACCACG	GAAACACCGGTGGAATCCAGCCACTTGTGGGGTTAGAGCTAGAAATAGCA	1	bc
TGTCCTTCAT	GAAACACCGGTTCCCGTTAGCTCGTAGTGGGGTTAGAGCTAGAAATAGCA	1	bc
CTCCCATCCC	GAAACACCGGTCTTCCTGGATTCTATGTGGGGTAGAGCTAGAAATAGCAA	1	bc
GACACTGTCA	GAAACACCGGTACTAGTTACTTACGGGGGGGGTTAGAGCTAGAAATAGCA	1	bc
GTCTTATCTC	GAAACACCGGTCGCGAAAATGTTGGGTTAGAGCTAGAAATAGCAAGTTAA	1	bc
CGTCCATAAT	GAAACACCGGTGCTAGTAATAGCATGGTGAACTGCGAGTAATACGTAGTC	1	bc
AGATCATCCA	GAAACACCGGTGCTAGAAATAGCAAGTTAAGCTAAGGCTAGGCCGTTATC	1	bc
AAATATATAA	GAAACACCGGTTTAGGTTGGAGGCATTAGAGCTTGAAATAGCAAGTTAAC	1	bc
GAGACCCAAG	GAAACACCGGTTTATTTAGGGGTTAGAGCTAGAAGTAGCAAGTTAACCTA	1	bc
AAATTAGCAA	GGAACACCGGTGTTCTTTGTTTGTTGGTGGGGTTAGAGCTAGAAATAGCA	1	bc
AAGACCTCAG	GAAACACCGGTCCTAGAAGCTTGGCGGGGGTAGTGCTAGTAATAGTAAGT	1	bc
AGATAATTAA	GAAACACCGGTGCTGTAAAGAGCAAGTTAGCCTAAGGCTAGTCAGTTATC	1	bc
GCCATAAACT	GAAACACCGGTGCTAATAGTTAGCTCGTGGGGTTAGAGCTAGAAATAGCA	1	bc
CGCAGCGACG	GAAACACCGGTCGTCGTCCGTAACTTGTGGGGTTAGAGCTAGAAATAGCA	1	bc
GTAATACTCT	GAGAGACCTGTGTACAAGGTTACGTCCATGGTAGGTTAATCTAATGCTGG	1	bc
GACTCAGTCA	GAAACACCGGTTCTAGGTACTTACGGGTGGGGTTAGAGCTAGAAATAGCA	1	bc
GTAAGAGAGA	GAAACACCGGTGAGCTGCATCAAGTGGTAGGAATAGCAATAGAAACTACG	1	bc
TATATGCTAT	GAAACACCGGTTTTCGATCATAGGTCGGGGGTTTAGAGCTAGAAATAGCA	1	bc
GCGAAAAAAC	GAAACGCCGGTGGCATCCAGCCCCTTGTGGGGTTAGAGCTATAAATAGCA	1	bc
TGAATATCAT	GAAACACCGGTTCGAGTAGGCACGTAGTGGGGTTAGAGCTAGAAATAGCA	1	bc
AAACCCGCCT	GAAACACCGGTTTTAGTCGATGGTGAGTGGGGTTAGAGCTAGAAATAGCA	1	bc
CCCCGACATC	GAAACACCGGTTCAACCGGCGTCTTATGTGGGGTAAGAGCAGGAATTAGC	1	bc
TATTTGTCAA	GAAACACCGGTTGTGGTGGACTCGGCGTGGGAGATATAGCAAGTTATCGT	1	bc
GTCATACTCC	GAAACACCGGTGATCTTAATAACGTCGAGGGGATATTGCCAGAAATAGCA	1	bc
GACGGCGTGA	GAAACACCGGTTTGCGTTCATCTATAGTTAGGATAGTGATCGAAGTCTCA	1	bc
ATGTAAAGGG	GAAACACCGGTGATCGGAGCGTATTCGTGGGAAATAGCAAGTAACCTAAG	1	bc
TCATCACCAA	GAAACACCGGTGGCAATTCGATTTGAGTGGGGTCAGAGCTAGAACTCGCA	1	bc
GGACTGCATA	GAAACACCGGTGTTCATGCTAACGTCCGTGGTTAGAGATATAGATAGCGC	1	bc
CACCGCGCTT	GAAACACCGGTGCTAGCGGTTTCGGAGTGGTGTTAGAGCTAGAAATAGCA	1	bc
AACCCCTCCC	GAAACACCGGTAATCAACGTATGTCCGTGGGGATTGAGCTAGAAATAGCA	1	bc
AAGCCCGTAG	GAAACACCGGTTCTAGAAGCAGGGTAGGGGGGGTAGAGCTAGAAATAGCA	1	bc
CCCATGATAC	GAAACACCGGTTTTCTTTACTCCTTTGTGGGGTTAGAGCTATAAATAGCA	1	bc
GAGTGGGGTG	GAAACACCGGTTATCGTTACGGATTTGTGGGGTTAGAGCTAGACATAGCA	1	bc
GAATGAGATA	GAAACACCGGTGCTAGTAGTTAGCTAGTGGGGTTAGAGCTAGAAATAGCA	1	bc
GAAACCCTCG	GAAACACCTGTACTATAAAGTACCCAGTGGGGTTAGAGCTAGAAATAGCA	1	bc
AGACAGAGCT	GAAACACCGGTGGTCTTTGTGTCTGGGTGGGGTTAGTACTAGAAATAGCA	1	bc
CTCTCACCGC	GAAACACCGGTTCAACCGGCTTCTTTTGTGGGGTTAGCGCTAGAAATAGC	1	bc
GGATAGCAAA	GAAACACCGGTGCTATTTACTTAAGGGTGGGGTTAGAGCTAGAAATAGCA	1	bc
TTATTAAACA	GAAACACCGGTGGGGTTAGAGCTAGAAATAGCAAGTTAACCTAAGTCCAG	1	bc
GATACTACCG	GAAACACCGGTGCTCTTTATGGGACCGTTGGGTTAGAGCTAGAAATAGGA	1	bc
AACTAGGAAA	GAAACACCGGTACTCGTTACTTACGGGTGGGGTTAGAGCTAGAAATAGCA	1	bc
TAAAGGCCAT	GAAACACCGGTTGTCTTGAAGTGGAGGTCGGGGAAATGCAAGTTTACATA	1	bc
AGAACCACCT	GAAACACCGGTTCTAGGCGGTTAGTTGTGGGGGTAGAGCTAGAAATAGCA	1	bc
GTCTTACCTA	GAAACACCGGTGTGCGGCGTTTATGCGTGAGATAGCACGTGTACCTAAGG	1	bc
TCATCAATCT	GAAACACCGGTGCCGCTAGGCCGGTGGTGGGGTTATAGCTAGAAATAGCA	1	bc
ATAACGCTCG	GAAACACCGGTGCTCTATGCTCGAGTTGGGGGGTAGAGGCTAAAATTAGC	1	bc
AAACACCAAA	GAAACACCGGTTTACTTAGGTAGTAGAGGTGGAAATAGCTAGAAAAACTC	1	bc
CCCCGGAACC	GAAACACCTGTCCAACGGGTGCCCGTTGGGGGGTTAGAGTCATAAAAAGC	1	bc
AATTAAGCAG	GAAACACCGGTGCCCTTTAGGGGACCGTGGGGTTAGAGCTAGAAATAGCA	1	bc
CCATCGAACA	GAAACACCGGTTCAGCCGGCGTCTTTTGTGGGGTTAGAGCTAGAAATAGC	1	bc
AAATTACACA	GAAACACCGGTGCTAATCGTTAGCTCGTGGGGTTAGAGCTAGAAATAGCA	1	bc
CACCGTGCTT	GAAACACCGGTGCTCGCGGTTTCGAAGTGGGGTTAGAGCTAGAAATAGCA	1	bc
GTAATAGACG	GAAACACCGGTGAGCATGATAACGTCCGTGGGGTTAGAGCTGGAAATAGC	1	bc
TAAGGAAATA	GAAACACCGGTGGGGTTAGAGCTAGAAATAGCAAGTTAACCTAAGGCTAG	1	bc
GAAGGCGAAA	GAAACACCGGTGAGATGCCTCAAAAGTGGGGTTAGAGCTAGAAATAGCAA	1	bc
ATCTACTCCA	GAAACACCGGTCGGGGAAGTGTGGGGATAGAGCTAGAAATGGAACGTTAA	1	bc
CAATGTGAAA	GAAATACCGGTACTAGCTACTTAAAAGAGGGGTTAGAGCTAGAAATAGCA	1	bc
CAGTCCACAA	GAAACACCGGTTGGCTTTACTCATTTGTGGGGTTAGAGCTATAAATAGCA	1	bc
ATTCAACCGT	GAAACACCGGTCTTCCTGGAATCTATTTGGGGTAGAGCTAGAAATCGCAA	1	bc
CTCTCGCGCT	GAAACACCGGTTCAAACGGCGTCTTTTGTGGGGTTAGAGCTAGAAATAGA	1	bc
AACTCACCGC	GAAACACCGGTGAGCGGCGATTGTCCGTGAGGATAAACCTATAAACTACG	1	bc
TATTGAGCCA	GAAACACCGGTTATCGGGACGTATTTGTGGGGGTAATAGTAAGATTACCT	1	bc
ATAATCTCCG	GAAACACCGGTGCCCATGATATCGTCCAGGGGATGTTAACAGAAATCGCG	1	bc
CGGTCATTTA	GAAACACCGGTGCTAGATATAGCAAGTTAACCTAAGGCTAGTCCGTTATC	1	bc
AAAAACACAA	GAAACACCGGTTAAAAAAGGAGGTAAGGTTAGAAAGAGCAAGAAAAACTA	1	bc
GTCTAAGCGG	GAAACACCGGTGCGCGGAGATTGTGCGTGGGAAATATCAAGTAACCTAAT	1	bc
GACTAAGCGA	GAAACACCGGTTTTCGTAGAGTACGGGTGGGGTAGAGCCAGTAACCTCAA	1	bc
TAAGCCATAA	GAAACACCGGTTTAGTATGAAGTGGTTAGAGCTAGAAATAGCAAGTTAAC	1	bc
CACCTCCTCC	GAAACACCGGTAGAATAGATCCACGGGTGGGGTTAGAGCTAGAAATAGCA	1	bc
GGTAACTCCC	GAAACACCGGTACTCGAAATAGCAAGGTGACCTTAGGGTAGGCCGTTACC	1	bc
ACCTGGCGGA	GAAACACCGGTCGTCGTTCGTAGGGCGTGGGGTTAGAGCTAGAAATAGCA	1	bc
ACCCGGCGAC	GAAACACCGGTGGTCTGGACCCCCGGGTGGGGTTAGAGCTAGAAATACCA	1	bc
ATCCTGTACA	GAAACACCGGTCGCTTAAGTGTGGGGTTAGAGTTAGACATAACAAGTTCA	1	bc
TGATCTTACT	GAAACACCGGTGCCAGTTAGCTCGTAGTGGGGTTAGAGCTAGAAATAGCA	1	bc
AGCACCTTAG	GAAACACCGGTCCTAGAAACTGACTGGGGGGAGAGGTACAAGAAGCAAGT	1	bc
CCGCTAACTT	GAAACACCGGTTGGCTTTACTCCTTTGGGGGGTTATAGCTATATATCGCA	1	bc
CCAATACGCC	GAAGCACCGGTAGACTTGATCCGCGGGTTGGGTTAGAGCTAGAAATAGCA	1	bc
CAATCCCCAA	GAAACACCGGTTTACTCAGAAGTTTGTGCTGTTAAAACTAAAATTACCAA	1	bc
TAATGCATCC	GAAACACCGGTAGAATGGATCAACGGGTTGGGTTAGAGCTAGAAAAAGAA	1	bc
GAATTAGCTA	GAAACACCGGTGAGCATGAAAACGGCCAGGGCATGTTAACATAAGGAGCG	1	bc
TTGACCGCCT	GAAACACCGGTCCTAGAAGCTTCGTGGGGTTAGAGCTAGAAATAGCAAGT	1	bc
TGTCAAGAAC	GAAACACCGGTGTTCCTGGCATCTACGTGGGGTTAGAGTTGAAATAGCAA	1	bc
TAATCCCCCT	GAAACACCGGTTTACTTAGTGAATAAGGCTGTAAGTGGCAGGTTAACCTA	1	bc
GCGTGCGACC	GAAACACCGGTTAAATGCCTCTCCGGTGGGGTTAGAGCTAGAACTAGCAA	1	bc
TACCCTATGT	GAAACACCGGTTCCCGTTAGCGGGTAGGGGGGTTAGAGCTAGAAATAGCA	1	bc
AATCCAGTAT	GAAACACCGGTCTTCCTGGAAACTACGTGGGGTAGAGCTAGAAAAAGCAA	1	bc
GCTATAACCG	GAAACACCGGTGCCATTTAGTCGACTGTGGGGTTAGAGATAGAAATAGCA	1	bc
AGATTACAAA	GAAACACCGGTGCTAATAGATAGATCGTGGGGTTAGAGCTAGAAATAGCA	1	bc
CAATGTGTAA	GAAATACCGGTACTAGTTACTTGCAGGAGGGGTTAAAGCTAGAAATAGCC	1	bc
GAGCCATCCG	GAAACACCGGTTACAAACGTATGTCAGTGGGGTTAGAGCTAGAAATAGCG	1	bc
TCATGAAGCC	GAAACACCGGTGGCATGAATCAGCGGGTGGGGTTAGAGCTAGAAATATAA	1	bc
AAAATATAAA	GAAACACCGGTGCCCGATAATAGGTCGGGGGGATAGAGCTAGAAATAACA	1	bc
GAACGATATA	GAAACACCGGTGATCATGGTAACGTCCATAGCAAGGTAACCGAAGGAGAG	1	bc
ATGACAAACA	GAAACACCGGTCCTAGAAGCTGAGGGGAGATAGAGCTAGAAATAGGAAGT	1	bc
AACCCGGATT	GAAACACCGGTCCTACTGGAATCTGCGTGGGGTAAAGATAAGAATAGCAA	1	bc
AGTAACGAAA	GAAACACCGGTTGTGGGGAACTCGGTGTGGGGGTAATAGCAAGTTAACCT	1	bc
CACTGGGATA	GAAACACCGGTGCTAGCGGCTTCGAAGGTGGGGTAGGGCCTGAAATTAGA	1	bc
CAACGCAGAC	GAAACACCGGTAGAATGGATCAACGGGTGGGGTTAGAGCTAGAAATAGCA	1	bc
ATGATAGATA	GAAACACCGGTCATCATAATTGCGTGGGGGGAGTGATAGCAATAGCTAGT	1	bc
GAGTCAGACA	GAAACACCGGTTTTAGTAACTGGTGAGTGGGGTTAGAGCTAGAAATAGCA	1	bc
TGGGCCGATT	GAAACACCGGTGTGCTTCCTAACCGGGTGGGGTAGAGCTAGAAATAGCAA	1	bc
GACCGGGTCG	CTAAACACCGGTAGTCGTACGATGCCCGTGGGGTTAGAGCTAGAAATAGC	1	bc
AACACCCTAA	GAAACGCCGGTTATCGATCATTGGCCGTGGGGTTAGAGCTAGAAATAGCA	1	bc
AATCCAGCTT	GAAACACCGGTGTCCCACGAATGTCAGTGGGGTTAGAGTTAGAATAGGCA	1	bc
TAATAACCGA	GAAACACCGGTTTACTTAGGGGATAGGGGTGGAAATAGAAGGAACCCATA	1	bc
AACTTAACAA	GAAACACCGGTGCTAATAGTTAGCTCGTGGGGTTAGAGCTAGAAATAGCA	1	bc
AACAGGGTAA	GAAACACCGGTTTTGGGTCATAGGGCGTGGGGGTAGAGCTAGAAATAGCA	1	bc
CTCATCTGCC	GAAACACCGGTAGACTGGATCCACGGGTGGGGTTAGAGCTCGAAATAGCA	1	bc
TAACATGCCA	GAGGCACCGGTTTTCGATCATAGGACGTGGGGTTGGAGTTGGAATTAGCA	1	bc
AGCAAGCACC	GAAACACCGGTGTTCTTTGCTCGAGGGTGGGGTTAGAGCTAGAAATAGCA	1	bc
GAATTCCACA	GAAACACCGGTACTAATAGTTAGCTCGTGGGGTTAGAGCTAGAAATAGCA	1	bc
GCCAGAAAAA	GAGACACCGGTAATCTTAAAATCACCGAGAGCAAGGTGACAGAAATCTAA	1	bc
GTATTCACCA	GAAACACCGGTCCTAATAGTTCGCTCGTGGGGTTAGAGCTAGAAATAGCA	1	bc
ATCTCAACGG	GAAACACAGGTGAGCGGTGATTATTCGGGAGAGATAGCAAGTGACATAAG	1	bc
ATAAAACCAA	GACACACCTGTTTACTTAGGGGTTAGAGCTAGAAATAGCAAGTTAACCTA	1	bc
GTCAACGTCG	GCAACACCGGTACTCGAAGCTGCGTCGGGTTAATGCTGGAAATAGCAGGT	1	bc
CGCAACCACA	GAAACACCGGTGGCAGCCCGCCATTTGTGGGGTTAGAGCTAGAAATAGCA	1	bc
GACCACATGC	GAAACACCGGTTTAGTATGGAGGGAAGTGGGGTTAGAGCTAGAAATAGCA	1	bc
GTATTATCTC	GAAACACCGGTGAGCATTATAACGTCCTTGGGTTTAGAGCTTGAATTAGC	1	bc
TCCTTAATCC	GAAACACCGGTTGAGTGAATCCACAGGTGGGGTTGGGCTTGGAAATGCCG	1	bc
ATGTCAACAG	GAAACACCGGTCCTCTAAGCTCATTTGTGGCTATAAAGATCAAAATAACC	1	bc
CTCCGACGCA	GAAACACCGGTAGAATGGATCCACGGGTGGGGTTAGAGCTAGAAATAGCA	1	bc
ATAACCTACT	GAAACACCGGTCGCAAGCGGCGGTTTGTGGGGTTAGAGCTAGAAATAGCA	1	bc
TGATCACCAA	GAAACACCGGTTTACTTAGAGGTTATAGGTGGAAATAGCAAGATAACCTA	1	bc
GAACTAGATA	GAAACACCGGTGCTAATAGTTTCGTCGTGGGGTTAGAGCTAGAAATAGCA	1	bc
CAACCAAAAA	GAAACACCGGTGCTATTGGTTTCGAAGGTGGGTTAGTACCATAAAACGCA	1	bc
CGACAGTAAT	GAAACACCGGTGCTCTTTGCTCGAGGGTGGGGTTAGAGCTAGAAATAGCA	1	bc
GGAGGGCAAC	GAAACACCGGTGTTCTTTGGTCGAGGGTGGGGTTAGAGCTAGAAAGAGCA	1	bc
CCCGCACACA	GAAACACCGGTTGGGCTGGAGCTAGATATGGCAAGTTAACCTAAGGCTGG	1	bc
AAGTCGGTAG	GAAACACCGGTATTAGTTACTTAAGGGAGGGGTTAGAGATAGAAATGGAA	1	bc
CCCAGCCTCG	GAAACACCGGTAGTAGGGACTCACTGGTGGGGGTAGAGCTAGAAATAGCA	1	bc
GAAAACGTAC	GAAACACCGGTCATCTAAATATCCCCGTGGGGGTAGAGCTCTAAGTCGCC	1	bc
GATCCTTCAA	GAAACACCGGTGACAAACGTATGCCAGTGGGGTTAGAGCTAGAAATAGCA	1	bc
ACGTTAAACC	GAAACACCGGTTGGCTTTACTCCTTTGTGGGGTTAGAGCTATAAATAGCA	1	bc
GAAATAGACG	GAAACACCGGTGAGCATGATAACGCACATAGCATGGTAACCTAAGTCGAG	1	bc
TTCTTTTAAC	GAAACACCGGTCGCGAAAATGTGGGGTTAGGGCTAGAACCAGAAAGTTAA	1	bc
ATACCCCTCG	GAAACACCGGTCTTAGATGCAGGGATTTGGCTTGAAATAGGAAATTAACC	1	bc
CGCATGCTTG	GAAACACCGGTTGTCGTTCATAGGGCGTGGGGTTAGAGCTAGAAATAGCA	1	bc
TAATGAATCC	GAAACACCGGTGGTGATAGATTCAAAAATGGGGATAAAACTAGAAAAGTC	1	bc
GAAACTTCCT	GAGACACCGGTTCCCGTTAGCTCGTAGTGGGGTTAGAGCTAGAAATAGAA	1	bc
GAATCACACA	GAAACACCGGTGCTAATCGTTAGCTCGTGGGGTTAGAGCTAGAAATAGCA	1	bc
CATAATTCAG	GAAACACCGGTGCCCTTTATGGGACCGTGGGGTTAGAGCTAGAAATAGCA	1	bc
GAGTCACTCC	GAAACACCGGTAATCTAAGGATGTTTTTGGGGTGAGAGCTATAAAAACAA	1	bc
GAACGAGAAA	GAAACACCGGTGCTAGCAGCTAGATAGTGGGATTTGAGCTAAAGCTAGTC	1	bc
CATTAATCCA	GAAACACCGGTGCTCGTAATGGGAAGTCGACCTAAGGCTAGTACGTTATC	1	bc
CGGTGGATAG	GAAACACCGGTCGTCGTAGGTAGGGCGTGGGGTTAGAGCTAGAAATAGCA	1	bc
CCTACTGCCG	GAAACACCGGTGCCCTCTATTGGATCGTGGGGTTAGAGCTATAAATAGCA	1	bc
TGGCCAGACG	GAAACACCGGTCTTCCTGGAATCTACGTGGGGCAGAGCTAGAAATAGCAA	1	bc
GTATTATCTC	GAAACACCGGTGAGCATGATAACGTCGGTGGGGTCAGAGCTTGAATTAGC	1	bc
AAAATAATTA	GAAACACCGGTGAGCATGATAACGTCCATAGCAAGGTAACCTAAGGCTAG	1	bc
AATATTGACA	GAAACACCGGTGATCTTGATCACGGAGTGGGAGAAGAAATAAAAAAACCT	1	bc
TCAATGAATA	GAAACACCGGTGAGCATAATAACGTCCATAGCAAGTTGACCTAAGGCTAG	1	bc
TAACGGGATG	GAAACACCGGTTTACTTAGGGGTTAGAGCTGTGGATAGCAAGTTAACCTA	1	bc
GTCTTTGATA	GAAACACCGGTGAGCATGATAAAGTCCGGGGGGTTAGAGCTAGAAATAGC	1	bc
TCCGCTACCA	GAAACACCGGTTGGGTTAGAGCTAGAAATAGCATGTTAACCTAAGGCTAG	1	bc
GACTTCTACC	GAAACACCGGTGCTAATAGTTAGCTCGTGGGGTTAGAGCTAGAAATAGCA	1	bc
ACGTTACCCC	GAAACACCGGTTGGATTTACTGCTCTGTTGGGTTAGAGCTATAAATAGCA	1	bc
TCGGCTATGT	GAAACACCGGTCGTCGTTCGTAAGGCGTGGGGTTAGAGCTAGAAATAGCA	1	bc
GCAACATCAC	GAAACACCGGTGAGCACGATTGGTTAGTGGGGGTAGAAGTAAGAATAGCT	1	bc
AGCTCTGTAA	GAAACACCGGTCCTAGTTGCTGAGGGAGAGGTATAGAGAGCGAAATAGCA	1	bc
GAACCAGCTT	GAAACACCGGTTTTAGCGGATGGGGAGTGGGGTTAGAGCTAGAAATAGCA	1	bc
GGACGGGATG	GAAACACCGGTCGTCGTTCGTCGGGAGTGGGGTTAGAGGTAGAAATAGCA	1	bc
AGCACTGCCG	GAAACACCGGTGCCCTTTATGGGACCGTGGGGTTAGAGCTAGAAATAGCA	1	bc
