TTCCCCCCCC	GAAACACCGGTCGCGAAAGTTTGCCTGTGGGGTTAGAGCTAGAAATAGCA	1	bc
CCCTAGCAAA	GAAACACCGGTACTAGTTACGTATTTGTGGGGTTAGAGCTAGAAATAGCA	1	bc
GACTTTGCAC	GAAACACCGGTACTAGTTACTTACGGGTGGGGTTAGAGCTAGAAATGGCA	1	bc
ATACGAGAAT	GAAACACCGGTTGTAAGAGATGGGTTGTGGGGTTAGAGCTAGAAATAGCA	1	bc
GTACCATACA	GAAACACCGGTGAGCATCATAACGTTATCAAGTTAACCTTAGGCTTGTCC	1	bc
AGTTCAGTAA	GAAACACCGGTGTGGATAGAACGTTTTGGGGTTAGAGCTAGAAATAGCAA	1	bc
GAAAGATATC	GAAACACCGGTGAGCATGATAACGTTGTCAAGTTAGCCTAAGGCTAGTCC	1	bc
CCCCCCCTGC	GAAACGCCGGTTTAGTATGGCGGTTTAGTGGGGTTAGAGCTAGAAATAGC	1	bc
CAGTTACAAC	GAAACACCGGTGGGCTTTACTCCTTTGTGGGGCTAGAGCTATAAATAGCA	1	bc
TCCCCCCATT	GAAACACCGGTATAACTGAACTACACGTGGGGTTAGACTAAAAAAAACAA	1	bc
CAACCCCGTT	GAAACACCGGTCGTCGTCCGTAGGGCGTGGGGTTAGAGCTAGAAATAGCA	1	bc
AGACCCAAAA	GAAACACCGGTGTTCTTTGCTCGCTGGTGGGGTTAGAGCTAGAAATAGCA	1	bc
TGTCCAGTCC	GAAACACCGGTCTTCCTGGAATATACGTGGGGTAGAGCTAGAAATAGCAA	1	bc
AAGCGAGCAC	GAAACACCGGTGACAACCGTTTGTCAGTGGGGTTATAGCTAGAAATAGCA	1	bc
AACTTGTCAA	GAAACACCGGTTAGAACACAACGTTTTGGGGTTTGAGCTAGAAATAGCAA	1	bc
GATCCAAGCC	GAAACACCGGTTTTAGCTAGAAATAGCAAGTTAAACTAAGGCTAGCCCGT	1	bc
ATCCAACCAC	GAAACACCGGTGTTCTTTGCTCGAGCGTGGGGTTTGAGCTAGAAATTGCG	1	bc
TAATCCAGCC	GAAACACCGGTCCTAGAAGCTGAGTTGTGGGGTTAGAGCTAGAAATAGCA	1	bc
ATCTAACCGA	GAAACACCGGTGGCAATTGGATATGAGTGGGGTTAGGGCTAGAAATAGCA	1	bc
GCATATATAC	GAAACACCGGTGGGCATGACACCGTTGGGGGGTTAGCGCTATGCAAGGCA	1	bc
CAGCCAAGCT	GAAACACCGGTTTTCGCTAGAAATAGCAAGTTAACCTAATGCTAGTCCGT	1	bc
CGACCATAAA	GAAACACCGGTGAGAACAGCACGATTTGGGGTTAGAGCTAGAAATAGCCA	1	bc
CCACGCGACT	GAAACACCGGTGATAGCGGTTTCAGAGTGGGGTTAGAGCTAGAAATAGCA	1	bc
ATCCGCCTCT	GAAACACCGGTTGTAATCGATTGTTTGTGGGGTTAGAGCTAGAAATAGCA	1	bc
ACGATCATCA	GAAACACCGGTGAGCACAGAACGTTTTGGGGTTAGAGCTAGAAATAGCAA	1	bc
ACCTCACCCC	GAAACACCGGTTTAACCGGCGTCTTTTGGGGGGTTAGAGCTAGAAATAGC	1	bc
TTCTACTACG	GAAACACCTGTGGCAGCCAGCCACTTGTGGGGTTAGAGCTAGAAATAGCA	1	bc
CTGCGCTCTG	GAAACACCGGTCGCCGATCTTAGGGCGTGGGGTTAGAGCTAGAAATAGCA	1	bc
TACTCTGAAA	GAAACACCGGTTTTCATGGCATATTGGTGGGGTTAAGCTAGAAATAGCAA	1	bc
CAAATCCAAC	GAAACACCGGTTGACTTTGCTAACTAGTGGGGTTAGAGCTAGAAATAGCA	1	bc
GAAGGCGATA	GAAACACCGGTGAGATGACTCACCTGGGGGGCTAGGGATAGAGCTAGAAA	1	bc
TGCCATTAAC	GAAACACCGGTTTCCTTTGCTCGAGGGTGGGGTTAGAGCTAGAAATAGCA	1	bc
GAAATGTAAA	GAAACACCGGTTAGCATGATCACGTTGGCGGAGCAACATCAAGCTAGCCT	1	bc
CTCTCACCGA	GAAACACCGGTGTGCGGAGGTCATGCGTGGGATATAGCAAGTAACATCAG	1	bc
CGGCGGGAGA	GAAACACCGGTGGGCGTTCGAAGGGCGTGGGGTTAGAGCCAGAAAGAGCA	1	bc
ATCTAACCGA	GAAACACCGGTGAGCACAGAATGTTTTTGGGATATAGCTATAAATCTCAA	1	bc
CACCGTGTTA	GAAACACCGGTCGTCGTTCGTAGGGCGTGGGGTTGGAGCTAGAAATAGCA	1	bc
CGATCCTGAA	GAAACACCGGTGAAGAGTGAAGGGGTTTGGGCTAGAGATAGCAAGAGAAA	1	bc
AATTAACCAA	GAAACACCTGTGGGGGGGAACTATGTGTGGGAAATAGAGAGAGATAACAT	1	bc
GACTAGCGCC	GAAACACCGGTACTAGCTGCTTATTTTGTGTGGTAAAAGTAAGAAAAAGC	1	bc
AGCACTGCCG	GAAACACCGGTGGGGGTAGAGTCGTAAAGGGTTAGGAAACATAAGGATAG	1	bc
GTAAGGGATA	GAAACACCGGTGAGCACGATAACGATAGCAAGTTAACCTAAGGCTAGTCC	1	bc
GATTTATATA	GAAACACCGGTGAGCATGCTATCGTTATGAGGTTAACCTAAGGCTAGGCC	1	bc
GCGGCAAGCA	GAAACACCGGTGGGGTTAGAGCTAGGAATAGCAAGTTAACCCAAGGCTAG	1	bc
GCAATCCAAA	GAAACACCGGTGAGCATGATAACGTTAGCAAGTTAACCTAAGGCTAGTCC	1	bc
GGCAAATCTA	GAAACACCGGTGTGCGTGATTACTTCGTGGGGTTAGACCTAGAAATAGCA	1	bc
TAATCAGTCT	GAAACACCGGTTTTTGTAAATGGACGGTTTAGATCTAGAAATATCAAGTT	1	bc
AAACCACAAA	GAAACACCTGTTGCAATCGGTTGTTTGTTGGGTTAGAGCTAGAAATAGCA	1	bc
GCGGGCTAGC	GAAACACCGGTGAGATGCCTCACCGGTGGGGCTAGGGTCAGAGCTAGAAA	1	bc
ATCCACCCCC	GAAACACCGGTTGTGAAAATATCCCGGTGGGGTTAGAGCTAGAAATAGCA	1	bc
GGCACATAAG	GAAACACCGGTGGCAGCCAGACACTTGGGGGGTTAGGGCTAGAAATAGAA	1	bc
ATATAACAGC	GAAACACCGGTGTGCGGAGATTATGCGTGAGAAATAGCAAGTAACCTAAG	1	bc
CGTCGTGCTG	GAAACACCGGTCGTCTTTCGTAGGGCGTGGGGTTAGAGCTAGAAATAGCA	1	bc
CGGTCATCCG	GAAACACCGGTGAGCGCTACGTGTTTGTGGGGTAAGAGTTAGAAATAGCA	1	bc
AACATAATAA	GAAACACCGGTTGTTAGAAATCGCAAGTTAGCCTAAGACTAGTCCGTTAT	1	bc
AAGTCGGTCA	GAAACACCGGTTCTAGAAGCTGCGTTGTGGGGTTAGAGCTAGAAATAGCA	1	bc
CGGCCCCTTG	GAAACACCGGTCTACGTTCGTAGGTCGTGGGGTTAGAGCTAGAAATAGCA	1	bc
ATGAAAGCCG	GAAACGCCGGTCTTAGAAGCTGAGGTGTGGGGATAGAGCTAGAAACAGCA	1	bc
GCCAAAAGCT	GAAACACCGGTGGTCGCCGTGGAGAGGTGGGGTTAGAGCTAGAAATAGCA	1	bc
AGACGGGTGG	GAAACACCGGTCGTCGATCGTAGGGCGGGGGGTTAGAGCTAGAAATAGCA	1	bc
CCGTCACCCC	GCAAGACACCGGGTTAACCTTTACTCCTTTGTGGGGTTAGAGCTGTAAAT	1	bc
AGATAAGATA	GAAACACCGGTCTTCCTGGAATCTACGTGGGGTAGAGCTAGAAACAGCAA	1	bc
