TTCACCGTCC	GAAACACCTGTCGCGAAAATGTGCTGGGGGGGAGAGAGCTAGAAATAGCA	1	bc
AATCAGCAGC	GAAACACCGGTGTTCTTTGCTCGAGGGTGGGGTTAGAGCTAGAAATAGCA	1	bc
TCGATACTCT	GAAACACCGGTGACGCGAGGTCGGTTGTGGGGTTAGAGCTATAAATAGCA	1	bc
GCCAAAAGCT	GAAACCCGGGGGTCCCCGGGGAGGGGTTGGGTTAGAGCTTGAAATAGCAA	1	bc
GGATCATCTA	GAAACACCGGTGAGCACAGTACGGTTTGGGGTTAGAGCTAGAAATAGCCA	1	bc
CCGTATACCC	GAAACACCGGTTCGCGCTACTCCTTTGTGGGGTTCAAGCTATAACTAGCA	1	bc
TCACCAATGA	GAAACACCGGTGTGGTTAGAGCTAGAAATAGCAAGTTAACCTAAGGCTAG	1	bc
GGGCGCCAGA	GACGAAACACCGGTTAGATGCCTCAAAGTGGGGTTAGAGCTAGAAATAGC	1	bc
CGGTGCTAGA	GAAACACCGGTGAGATGCCTCAAAGTGGGGTTAGAGCTAGAAATAGCAAG	1	bc
GACAAATATA	GAAACACCGGTGAGCATGATATCGTTAGCAAGTTAACGCAAGGCTAGTCC	1	bc
ATGCCCCACG	GAAACACCGGTCGTAGGCGCTGAGTTGTGGGGTTAGAGCTAGAAATAGCA	1	bc
AATTAGCTAC	GAAACACCGGTGGCATTTCGTTCTGAGTGGGGTTAGAGCTAGAAATAGCA	1	bc
AACACGCCCG	GAAACACCGGTTTTCGAACATAGGTCGTGGGGTCAGAGCTAGAAATAGCA	1	bc
CATAATTCCT	GAAACACCGGTGCCCTTTATGGGACCGTGGGGTTAGAGCTAGAAATAGCA	1	bc
AAATCGAAGA	GAAACACCGGTTTAACCTGGGGGTTTTGTGGGGTTAGAGCTAGAAATAGC	1	bc
CGACCACAAC	GAAACACCGGTGTTCTTTGATCGAGGGTGGGTTTAGACCTAGAAATAGCA	1	bc
TTAACACTCG	GAAACACCGGTGACGCGAGCACGGTGGGGGGGTTAGAGCTAGAAATAGCA	1	bc
TGAACAGACT	GAAACACCGGTGACGCGGGGACGGAGGTGGGGATAGAGCTAGAAATAACA	1	bc
CCAATATCAA	GAAACACCGGTTAGCATGACAACGTTAGCGAGTTAAACCTATGCAAGTCC	1	bc
ATACAGCCGC	GAAACACCGGTGTTCTTTGCTCGATGGTGGGGTTATAGCTAGAAATAGCA	1	bc
CGGCTAACAT	GAAACACCGGTTGGCTTGACTCCTTTGTGGGGTTATAGCTATAAATAAGA	1	bc
ATATTACACA	GAAACACCGGTTGTAATCGATGGCTCGTGGGGTTAGAGCTAGAAATAGCA	1	bc
GCGTCAAACC	GAAACACCGGTTATCGTTGCGGATTTGGGGGGTTTGAGCTAGAAAAAGCA	1	bc
TACTCACGAG	GAAACACCGGTTTACTTAGCTAATTAGTGGGGTTAGAGCTAGAAATAGCA	1	bc
AACAGGGTTG	GAAACACCGGTTCTAGAGGATTGGTCGTGGGGTTAGAGCTAGAAATAGCA	1	bc
CCGTCCCTCC	GAAACACCGGTTCAACCGGCTGCTTTTGTGGGGTTAGAGCTAGAAATAGC	1	bc
GGATACTCCG	GAAACACCTGTTTTAGCCAGCCACTTGTGGGGTTAGAGCTAGAAATAGCA	1	bc
TCGTTATCTC	GAAACACCGGTTGGCTTTACTCCTTTGTGGGGTTAGAGCTATAAATAGCA	1	bc
GAGAAACCCC	GAAACACCGGTAATCTAAAGATCTCCGTGGGGATAGAGCTAGAAATAGCA	1	bc
CCGCTAACTT	GAAACACCGGTCGGCTTTACTCCTTTGTGTGGTCAGAGCTATAAATAGTA	1	bc
AAGACGGCAA	GAAACACCGGTGTTGTTGGCTCGGGGGTGGGGGTAGTGGTAGGTTTAGCT	1	bc
TGTTCAACTT	GAAACTCCGGTTATCATTACACATTTGGGGGGTTGCGGTATGAAATTGCA	1	bc
TGACCAGTTC	GAAACACCGGTTGAGAAGATCTAGAAGTGGCAAGGTGATCGAAGTAGAGT	1	bc
TGCACCCACT	GAAACACCGGTTTACTTAGTTAACTAGTGGGGTTAGAGCTAGCAATAGCA	1	bc
GAGGCCAACG	GAAACGCCGGTGAGATGCCTCAAAGTGGAGTTAGAGCTAGAAATAGCACG	1	bc
TTACTCTCGC	GAAACACCGGTCTCGAATGTAGGCTTAGGGGGGTTAGACTTAGAAAAAGC	1	bc
ATCTCATACT	GAAACACCGGTTGCAAGAGAGGGTTTGTGGGGTTAGAGCTAGAAATAGCA	1	bc
TCAATCTTCA	GAAACACCGGTGACGCGGGGACGGTGGTGGGGTTAGAGCTAGAAATAGCA	1	bc
GTCTATGTCC	GAAACACCTGTCCTAGAAGCTGAGTTGTGGGGTTAGAGCTAGAAATAGCA	1	bc
GAAACATATC	GAAACACCGGTGAGCATGATAACGTTAGGAAGTTAACCTAAGGCTAGTCC	1	bc
ATGAGCGAGG	GAAACACCGGTCAGATACCTCAAAGTGGGGCTAGAGCTAGCAATAGCAAG	1	bc
ATCTCCCCGT	GAAACACCGGTGTGCGGAGATTATGCGTGAGAACTAGCAAGTAACCTAAG	1	bc
TTACTCCCCC	GAAACACCGGTTGTGAAAATTGGCCTGTGGGGTTAGAGCTAGAAATAGCA	1	bc
CGCTAATCAG	GAAACACCGGTGGCCGCTAGCCATTTGTGGGGTTAGAGCTAGAAATAGCA	1	bc
TGACTAGATC	GAAACACCGGTTGGGAAGAGCAAGAAATAGCAAGTTAATCTAAGGCGAGT	1	bc
GACTCTTCCG	GAAACACCGGTTCTCGTTACGGCTTTGTGGGGTTAGAGCTAGAAATAGCA	1	bc
GAGTGGGAAA	GAAACACCGGTGAGATGGCTCACAGTGGGGTTGAAACTACAAGTAACAAG	1	bc
CGGCGCGTCT	GAAACACCGGTCACCGTTCGAAGGGCGTTGGGTTAGAGCTAGAAATAGCA	1	bc
