GAGGCGAGAC	GAAACACCGGTGAGATGCTAGAAATAGCAAGTTAACCTAAGGCTAGTCCG	1	bc
AGCCAACCGC	GAAACACCGGTGTTCTGTGATTATGGGTGAGAAATAGCATGTAACCTAAG	1	bc
AGCACGTCCC	GAAACACCGGTTCGCGTTAGCTTGTAGATGGGATAGAGCTATAAGGAGCG	1	bc
GAGTCAATCG	GAAACACCGGTTATCGTTACGGACTTTGGGGGGTAAGAGCTGGAAATACC	1	bc
GGACCGCACC	GAAACACCGGTGATCTTTGCTCGTGTGTGGGGTTAGAGCTAGAAATAGCA	1	bc
GCCACATACC	GAAACACCGGTTCGCATGATAACGTTAGCAAGTTAACCTAAGGCTAGTCC	1	bc
CACCTATTAG	GAAACACCGGTTTTCGATCATAGGTCGTGGGGTTAGAGCTAGAAATAGCA	1	bc
CCCCTACACC	GAAACACCGGTAGAATTGATCCACGGGTGGGGTTAGAGCTAGAAATAGCA	1	bc
ATCTTGTCCG	GAAACACCGGTCGCGAAACTGTGCCGGTGGGGTTAGAGCTAGAAATAGCA	1	bc
AACAGGTCTA	CTAAACACCGGTTAGCATGATAACGGCGTGGGAGTAGAACTAAGATTAGC	1	bc
CGGCTATTTG	GCAACACCGGTTTTCATGATTCGGTCTTGTGCTTGGATCTCTAAATAACA	1	bc
GACTCACACA	GAAACACCGGTTATCGTGACGGCTTTTGTGGGGTTAGAGCTAGAAATAGC	1	bc
CGATCACCAA	GAAACACCGGTTATCTCTAGTAATAGCATGTTAACCTAATGCTAGTCCCA	1	bc
GTAACACCCT	GAAACACCGGTTGTAAGCGAGGGATTGTGGGGTTAGAGCTAGAAATAGCA	1	bc
GCATTACAAC	GTAACTCCGGTGCTATTGGTTCACTCGTGGGGTTAGAGCTAGAAATAGCA	1	bc
CCGCCCATAC	GAAACACCGGTTTAGTATGGTAGTTTAGTGGGGTTAGAGCTAGAAATAGC	1	bc
CCCCCAGACC	GAAACACCGGTAGTATGGATCCACGGGTGGGGTTAGAGCTGGAATTACCA	1	bc
GTTCCATCTC	GAAACACCGGTGAGCAACATATCGCCGTGGGGTTAAAGCCTGAAATAGCC	1	bc
CTACTATTTA	GAAACACCGGTCGGCGTTCGTAGGACGTAGGGTTAGAGATATACATAGCA	1	bc
TCAGAGCAAC	GAAACACCGGTGTGGTTTGCGCTAGGGTTGGCATAGTGACCTAAGGCTCG	1	bc
CCACCACCCT	GAAACACCGGTTGTAAGTGCTGGTTTGTGGGGTTAGAGCTAGAAATAGCA	1	bc
ATCACCGCGG	GAAACACCGGTGCGAGGAGATTATGCGTGGGGATTGACCTGGAACCTGCA	1	bc
CAACGACGCC	GAAACACCGGTGGTATGGATTCAGGGGTGGGGTTAGAGCTAGAAATAGCA	1	bc
CGACCGCACC	GAAACACCGGTTCACCTTGCGTCTGTTTGGGGGTAGAAGTTGGAAATTGA	1	bc
AAGTTGACAG	GAAACCCCGGTTTTCGTTCCTAGTTTGTGGGGTTAGAGCTAGAAATAGCA	1	bc
ATAACAGACA	AGGAAGAAGAAACGGGTTTAGTAAATGGTGGGAGGAGCTAGAGATAGTAA	1	bc
ATCCAACCCT	GAAACACCGGTGTGCGGAGATTATTTGTGAGAATTAGCAAGTAACTCAAG	1	bc
GGAACCTTCG	GAAACACCGGTGACGCCAGGACGCTGGTGGGGTTAGAGCTAGAAATAGCA	1	bc
GACTATATCA	GAAACACCGGTAGTGATTATTAAAGAGTGGGGTAGAAGTAACAATAACCA	1	bc
AACCGCCTCC	GAAACACCGGTACAATGTATCCACGCGTGGGGTTAGAGCTAGAAATAGCA	1	bc
GGGCTATCTG	GAAACACCGGTCATCGTTAGAAGGTCGTGGGGTTAGAGCTAGAAATAGCA	1	bc
GAAATATACC	GAAACACCGGTTGAGATAATAAAAAAGTGGGGTAGAGCTAGAAATAGCAA	1	bc
GGTCTATATT	GAAACACCGGTCATCATGATAACGGCGTGGGGTTAGAGCTAGAAATAGCA	1	bc
CACCTAGTAT	GAAACACCGGTTTTCGATCATAGGTCGTGGGGTTAGAGCTAGAAATAGCA	1	bc
TAACCCGATT	GAAACACCGGTCTTGTTGGGATGTAGAAGTGGCAAGTTATACTAAGGCTA	1	bc
ACACGCATGC	GAAACACCGGTTTAGTATATAGATTTAGTGGGGTTAGAGCTAGAAATAGC	1	bc
TCTACCCCTT	GAAACACCTGTGACGCGGGGACGGTGGTTGGGTTAGAGCTAGAAATAGCA	1	bc
ATAGAGGAAC	GAAACACCGGTGTTCTTTGCTCGAGGGTGGGGTTAGAGCTAGAAAGATCA	1	bc
TAGTTCGTGC	GAAACACCGGTGAGATGCTAGAAATAGCAAGTTAACCTAAGGCTAGTCCG	1	bc
TACAATCTCT	GAAACACCGGTCGCGTAAATGTCCCGGTGGGGTTAGAGCTAGAAATAGCA	1	bc
GGAGAGGAAA	GAAACACCGGTGTTATTCGTTAGAGGGTGGGGCTAGAGATAGAGATAGAA	1	bc
GACTCACGCT	GAAACACCGGTGGCCATTCTAGCGAGGGGTGGGGATAGCTATAGATATCG	1	bc
GAGCCATAAC	GAAACACCGGTGACAAACTTATGTTAGTGGGTTTGGCGCTAGCAATTGCT	1	bc
GACTATGTAA	GAAACACCGGTACTAGTTACTTACGGGTGGGGTTAGAGCTAGAAATAGCA	1	bc
CCTTGGCCCC	GAAACACCGGTTGTGGGGAACTCGGTGTGGGAGAAATAGCAAGTTAACCT	1	bc
CGACCAGCTT	GAAACACCGGTCTTCCTGGAATCTACGTGGGGTAGAGCTAGAAATAGCAA	1	bc
ACATAACAGA	GAAACACCGGTGAGAGGAGATTATGCGTGAGAAATAGAAAGTAACCTAAG	1	bc
AAAAGCGAAA	GAAACACCGGTTGAGGGGGACAAGGAGTGGGAGTAAAAGTAAGATAAGCC	1	bc
ACGTTACAAA	GAAACACCGGTTGGCTTTACTCCTTTGTGGGGTTAGAGCTATAAATAGCA	1	bc
AATTTATAAA	GAAACACCGGTGAGAATCGTAAGTTCGTGGGGTTAGAGCTAGAAATAGCA	1	bc
GATTTACATA	GAAACACCGGTGACCATTATATCGTTGGGGGGTTAACGTTAGGCTTATCC	1	bc
AGCTAGCCAC	GAAACACCGGTGTTCTTTGCTCGTGGGTGGGGTTAGACCTAGAACCTGCA	1	bc
ACGCACTTCC	GAAACACCGGTTCCCGTTAGCTCGTAGTGGGGTTAGAGCTAGAAATAGCA	1	bc
AAACCACAAA	GAAACACCGGTGGTCTTTGGACCTGAGTGGGGTTAGAGCTAGAAATAGCA	1	bc
GTCACATCCA	GAAACACCGGTGCCCATGATATCGTCGTGGGGTTAGAGCTAGAAATAGCA	1	bc
AATTCGCACC	GAAACACCGGTCAAACAGGCATGTTTTGTGGGGGTAGAGCTAGGCATATC	1	bc
AGCTACTCCC	GAAACACCGGTCGTGATTACTTGCGGGTGGGGTTAGAGCTAGAAATAGCA	1	bc
CGCGCTTCGT	GAAACACCGGTTCCCGTTAGCTCGTAGTGGGTTTAGCGCTAGCAAGAGCG	1	bc
TCAGTCACCA	GAAACACCGGTTGCCTTTCCTCCTTTGTGGGGTTAGAGCTATAAATAGCA	1	bc
CACCTGCTAA	GAAACACCGAATTTCGATCATAGGTCGTGGGATTAGGGCTAGAACTAGCA	1	bc
CACATAGATT	GAAACAACGATTTTCGATCATAGCTCGTGGTGTTAGAGCTAGAACTAGCA	1	bc
AACTATGCAA	GAAACACCGGTGTTCTTTGCTCGAGGGTGGGGTTAGAGCTAGAAATAGCA	1	bc
AATCGCTCCC	GAAACACCGGTGGAATAGGTCTATCAGTGGGGTTAGAGCTAGAAATAGCA	1	bc
ACGTTACACC	GAAACACCGGTTGGATTTGCTGCTTTGTGGGGTTAGAGCTAGAAATAGCA	1	bc
CGTTCATCAA	GAAACACCGGTGAGAACAGAACGTTTTGGGGTTAGAGCTAGAAATAGCAA	1	bc
ATAAACCACT	GAAACACCGGTTGTCTAAGATTGCTTGTGGGGTTAGAGCTAGAAATAGCA	1	bc
GTATTGTATC	GAAACACCGGTGCGAATGATAACTTCTGGGGGTTAAGGCTTAGAATAGCA	1	bc
CCTAGCGCCG	GAAACACCGGTGCCCTGGATCCAACGGTGGGGTTAGAGCTAGAAATAGCA	1	bc
TACACCTCAT	GAAACACCGGTTTCCATCGTTTGGTAGTGGGGTTCAGCTTGGAATTGGAA	1	bc
AACACCCCAT	GAAACACCGGTTTACTTAGTTAATTAGTGGGGTTAGAGCTAGAAATAGCA	1	bc
TACAGCCGCC	GAAACACCGGTAGAATGGATCAACGGGTGGGGTTAGAGCTAGAAATAGCA	1	bc
CACCAGCACC	GCAACACCGGTGATCTATGCTCCCCGGTGGGGTTAGAGCTAGAAATAGCA	1	bc
