CAAACACTCT	GAAACACCGGTGGGGGTAGAGCTAGAAATAGCAAGGTAACCTAAGGCGAG	1	bc
AAATGGTCTA	GAAACACCGGTTGTGTGGAAATCGGTGTGGAAGAAATAGCAGGGTAACCT	1	bc
AATAAAGACT	GAAACACCGGTGCCCGTGATTGCACCGTGGGGTTAGAGCTAGAAATAGCA	1	bc
GAATGTGATA	TTTGGTATCGTGGCAACATCGGTCTTGGGTAATTACGGGAGGGGTTGGGC	1	bc
AGCTATCCCT	GAAACACCGGTTCCCGTTAGCTCGTCGTGGGGATAGACCTAGAACTAGCA	1	bc
AGCGGGCGAG	GAAACACCGGTGAGATGCCACACCGGGGGGGCTTGGGGTAGAGCTAGAAA	1	bc
GGATCATCCA	GAAACACCGGTGAGAACAGAACGTTTTGGGGTTAGAGCTAGAAATAGCAA	1	bc
TGCTCAGACT	GAAACACCGGTCTTACTGGAATCTACTTGGGGGAGAGCTAGAAATAGCAC	1	bc
AGTTCTTCCA	GAAACACCGGTGCCCTCTATGGGATCGGGGGGTTAGAGTTAGAAATAGCA	1	bc
GAATTGCAAC	GAAACACCGGCGCTCTTTGTTCGCTCGTGGGGTTAGAGCTAGAAATAGCA	1	bc
AGTTAGCCAA	GAAACACCGGTTTTCTTTAATCCAGGGTGGGATTAATACCAACTTAACCT	1	bc
TGTACATCCA	GAAACACCGGTGAGCACAGAACGTTTTGGGGTTAGAGCTAGAAATAGCAA	1	bc
AATTCCACCC	GAAACACCGGTTGCAAGCGATGGTCTGTGGGTATAGCTCGAAATATCACT	1	bc
CCTCTCCAAA	GAAACACCGGTGGCAATTCGATCTGAGTGGGGTTAGAGCTAGAAATAGCA	1	bc
AAACAATCCC	GAAACACCGGTGCCCTCTATGGGACTGTTGGGTTAGACGTTGAAATAGCA	1	bc
ATGACGCTAG	GACACACCGGTCTTCTAAGCTGAGTTGTGGGGTTAGAGCTAGAAATAGCA	1	bc
AAGAGCGAGG	GAAACACCGGTGAGATGCACCACAGGGGGGGCTAGGGTTAGAGAAAGAAA	1	bc
AAGTGGAGCA	GAAACACCGGTTGTGGGGACCTCGTTGTGGGATTAGTAGCAAGTTAACCT	1	bc
CCAGCATCAA	GAAACACCGGTGAGAACAGAACGATTTGGGGCTAGAGAAAGAAAGAGCAA	1	bc
AGCCATGTTC	GAAACACCGGTGCTCTTTGCTCGCGGGTGGGGTTAGAGCTAGAAATAGCA	1	bc
CCCAACACCC	GAAACACCGGTGGCCGCCAGCCACTTGTTGGGTTAGAGCTAGAAATAGCA	1	bc
ATACCAAAAA	GAAACACCGGTGGGGAGAGATGGATTAATGGGATGGAAATCTAAGTCTAA	1	bc
ATTTGGCCAC	GAAACACCGGTTGTGGGGAACTCGGCGTGGGAGAAATAGCAAGTTAACCT	1	bc
AACAAACTAC	CTAAACACCGGTAATCTACAGATCCCAGTGGGGATAGAGCTAGAAATAGC	1	bc
TATTCAGTCC	GAAACACCGGTTGAGCTAATCTAGCAGGGTGGTAGAGCTCGAAATCGCAA	1	bc
GCCGACAACG	GAAACACCGGTGGCAGTCAGCCTCTAGTGGGGTTAGTGATAGAAATAGCA	1	bc
CCGGGCGAGC	GAAACACCGGTTAGATGTCTCACCGGTTGGGCTAGGGCTAGACCTATAAA	1	bc
CATTCTTCCT	GAAACACCGGTTCCGGTTAGCTCGTAGTGGGGTTAGAGCTAGAAATAGCT	1	bc
GATACACATA	GAAACACCGGTGGCCATTCGATCTGCGTGGGGTTAGAGCTAGAAATAGCA	1	bc
ACCTCGGCAA	GAAACACCGGTTGTAGGGACCTCTGTGGGGGGGTAATAGCAAGATAACCT	1	bc
ATCCCTCCCT	GAAACACCGGTTGCAAGCGACGGTTTGGGTGGCTAGAGCTAGTAATACTA	1	bc
GTCTTCTGCG	GAAACACCGGTTGCGAAAATGGGTTGGTGGGGTTAGAGCTAGAAATAGCA	1	bc
CGGCGGGTTG	GAAACACCGGTCGGGGTTAGAGCTAGAAATAGCAAGTTAACCTAAGGCTA	1	bc
GTCTGTGAGA	GAAACACCGGTACTAGTTACCTACGGGGGGGGTTAGGGTTAGAAATAGCA	1	bc
AGTAAGCACC	GAAACACCGGTGTTCTTTGCTCGAGGGTGGGGTTAGAGCTAGAAATAGCA	1	bc
AGTAATTACG	GAAACACCGGTGGCAGCCATCCACTTGTGGGGTTAGAGCTAGAAATAGCA	1	bc
ATTTCACAGC	GAAACACCGGTGTGCGGCGATTATGCGTGAGAAATAGCAAGTAACCTAAG	1	bc
TAGACCCACG	GAAACACCGGTTTTCGTAGCTGAGTTTGGGGGGTTAAAGCTAGAAATAGA	1	bc
AACCCCCTCC	GCAACACCGGTAATCTAAAGATCCCCGTGGGGATAGAGCTAGAAATAGCA	1	bc
AGCAAGCACC	GAAACACCGGTGATCTATACTCGCGGGTGGGGATAGAGCTAGAAATAGCA	1	bc
ATAAACGTAG	GAAACACCGGTCCTAGAAGCTGAGTTGTGGGGTTAGAGCTAGAAATAGCA	1	bc
AGATAGCCCC	GAAACACCGGTGTTCTTTGCTCGAGGGTGGGGTTAGAGCTAGAAATAGCA	1	bc
GAATAAGTCC	GAAACACCGGTACTAGTTACTTAAGGGTGGGGTTGAGCCAGGAAAAGGAA	1	bc
TAACCCATCC	GAAACACCGGTTTAGTATGGAGGTTTGGGGGGGTTAGAGCTAGAAATAGC	1	bc
GGCTACTCAG	GAAACACCGGTGGCAGCCAGCCACGTGTGGGGGTAATGGTAAGATTAGCA	1	bc
AGTACTGCCT	GAAACACCGGTGCCCTTTATGGGACCGTGGGGTTAGAGCTAGAAATAGCA	1	bc
AATTAACCAA	GAAACACCGGTGGCAAGTGAATATGCGTGGGGTTTGGGCAGGAAATGGCA	1	bc
GGGCACGAGC	GAAACACCGGTGAGATTCCTCACCGGTGGGGCTTGGGTTAGAGCTAGAAA	1	bc
TACACTGTAA	GAAACACCGGTACTAGTTACTTACTAGTGGGGTTAGAGCTAGAAATAGCA	1	bc
TCAGCCATCA	GAAACACCGGTGGGGTTAGAGCTAGAAATAGCATGTTAACCTAAGGCGCG	1	bc
AAATTAGCCC	GAAACACCGGTCCTAGAAGCTGAGTTGTGGGGTTAGAGCTAGAAATAGCA	1	bc
TTGAGCGAGC	GAAACACCGGTTAGATTCCTCACCGGTGGGGCTAGGGTTAGAGCTAGAAA	1	bc
TGTTCATCCC	GAAACACCGGTGAGAGCAGAACGTTTTGGGGTTAGAGCTAGAAATAGCAA	1	bc
CGCCGTTAAC	GCAACCCCGGTTCGCTTTACTCCTTTGTGGGGTTAGAGCTATAAATAGCA	1	bc
TCATCAGCCT	GAAACGCCGGTTTTAGGAGATGGTGGGGTTAGAGCTAGCAATAGCTAGTT	1	bc
GATAAATCTA	GAAACACCGGTGCCCTTGATGGGGCCGTGGGGGTTGAGCTAGGAATAAGA	1	bc
ACAGAACCGA	GAAACACCGGTGGGCGGAGATTATGCGTTAGAAAGATAAAGTAAGCTCAG	1	bc
CATTCGGCCA	GAAACACCGGTTGAGGGGAACTCTTTGTGGGGGAAATAGCAAGTTAACCT	1	bc
GAAACCATGC	GAAACACCGGTAATCTAAAGATCTTCGTGGGGGTAGAGCTAGAAATAGCA	1	bc
AATGCAGCAA	GAAACACCGGTTGTGGGGAACTCGGTGTGGGAGAAATAGCAAGTTAACCT	1	bc
GCATATATAA	GAAACACCGGTACTAGTTACTTACGGGTGGGGTTAGAGATAGAAATCGCA	1	bc
ATACTAAAAT	GAAACACCGGTTGTAAGCGATGGTTTGTGGGGTTAGAGCTAGAAATAGCA	1	bc
CATTGGGTAC	GAAACACCGGTTGTGGGGAACTCGGTGTGGGAGAAATAGCAAGTTAACCT	1	bc
CCATGGGATC	GAAACACCGGTGCTAGCGGTTTCGAAGTGGGGTTAGAGCTAGAAATAGCA	1	bc
GTACTGTACA	GAAACACCGGTGAGCATGATAACGGCGTGGGGCTAGAGCTAGAAATAGCA	1	bc
CTCACCCTCC	GAAACACCGGTCCTAGAAGCTGAGTTGTGGGGTTAGAGCTAGAAATAACA	1	bc
GCGTCGCGCG	GAAACACCGGTTTTCGCTAGAACTATCAAGTTAACATAAGTCTAAACAGC	1	bc
TCAGCCCACA	GAAACACCGGTGGGGCTATAGCTAGAAATAGCAAGTTAACCTAAGTCTCG	1	bc
ATAACCCCGT	GGCTAAACACCGGTGACGGGAGGTTGGGGGTGGGGTTTGGGCAGTAAACT	1	bc
AACATGCTAG	GAAACACCGGTTATTCGAAATAGCAAGTTAACCTAAGGCTAGTCCGTTAT	1	bc
CGCCCTTCCA	GAAACACCGGTTGGCTTTAGTCCTTTGGGGGGGTAGAAGCATGAAAAAGC	1	bc
TCCTCAGATT	GAAACACCGGTTTTACTGGAATCTACGGGGGGGATAGCTAGAAAAAGAGA	1	bc
CCGTTAAGCG	GAAACACCGGTGGGCTTAACTCTTTTGAGGGGATAGTGACATAAATATCA	1	bc
CCACCAATGC	GAAACACCGGTTTAGTATAGTGGTTTGGGGGGGTTGGGCCTAGAATTAGA	1	bc
AACTATCAAC	GAAACACCGGTACTAGTTACTTACGGGTGTGGTTAGAGCTAGAAATAGCA	1	bc
GTGAACCTGA	GAAACACCGGTGAGATGCCGCACCGGGGGGGCTAGGGTTAGAGCTAGAAA	1	bc
GCAACACGCT	GAAACACCGGTGGTCGCCGAGGAGTGGTGGGGTTAGAGCTAGAAATAGCA	1	bc
AAATCACCAG	GAAACACCGGTTTTAGTTGATGGTGGGGGTGGAGCTAGAAATAGCAAGTT	1	bc
AATCGTCCCG	GAAACACCGGTAGCCTTGATCCGACCGTGGGGTTAGAGCTAGAAATAGCA	1	bc
GTAACCAACA	GAAACACCGGTGCTAATAGTTAACTCGTGGGGTTAGAGCTAGAAATAGCA	1	bc
TACTCTGAAA	GAAACACCGGTACTAGTTACTTACGGGTGGGGTTAGAGCTAGAAATAGCA	1	bc
