CATTCCCACC	GAGACACCGGTGGCAATTCGATCTGCGTGGGGTTAGAGCTAGAAATAGCA	1	bc
CGATCAAAAA	GAAACACCGGTGAGAATAGAACGATTTGGGGCTAGATCTAGAAATAGCAA	1	bc
GTAGAGCAAC	GAAACACCGGTGTTCTTTGCTCGAGGGTGGGGTTAGAGATAGAAATAGCA	1	bc
AGACGGGATT	GAAACACCGGTCGTCGTTCGTAGGGCGTGGGGTTAGAGCTAGAAATAGCA	1	bc
ATCATACTCT	GAAACACCGGTTGTAAGTGATGGTTCGTGGGGTTAGAGCTAGAAATAGCA	1	bc
TCGGTAAACA	GAAACACCGGTGGGGTTAGAGCTAGAAATAGCATGTTAACCTAAGGCTAG	1	bc
AAATGAATAC	GAAACACCGGTTGAGAGAAACAAAAAGTGGGGGAGAGAGAGAAATAGCAA	1	bc
GATTTACACG	GAAACACCGGTTATCGTTACGGCTTTGTGGGGTTAGAGCTAGAAATAGCA	1	bc
GAATCCGGCC	GAAACACCGGTATTATTAAATGACGAGGGGGGGTAGCGTTAGAAATAGCT	1	bc
CCACCAAAAC	GAAACACCGGTGGGGTTAGAGCTAGAAATAGCAAGTTAACCTAAGGCTAG	1	bc
CTGACACACG	GAAACACCGGTGGCGATTCGATTTGAAATAGCATAGTACTCGAAGTATCA	1	bc
CCCCACTACC	GAAACACCGGTGGCAGCCAGCCACTTGTGGGGTTAGAGCTAGAAATAGCA	1	bc
TAATGCGTCC	GAAACACCGGTTGAGTTATTCAAAAAGCAGGGTAGAGCTAGAAATAGCAG	1	bc
AGAAGGCGTG	GAAACACCGGTGAGATGCTAGGAATAGCAGGTTAACCTAAGGGTAGTCCG	1	bc
CACCCCCGCA	GAAACACCGGTAGAGTATATCCGCGGGAGGGGTTAGAGCAAGAAGTTGCA	1	bc
CACCGCAGCA	GAAACACCGGTAGAATGGATCCACGGGTGGGGTTAGAGCTAGAAATAGCA	1	bc
AACTAGGACG	GAAACACCGGTGCAATCGACGGGTTTGTGGGGGGTTAGAGAGAGAGATAG	1	bc
AAACCAATAC	GAAACACCGGTTTCGAATGGATGTTTGGGGGGGTTAGGGCTGGAAAAACA	1	bc
ATGCTAACAC	GAAACACCGGTTGGCTTTACTCCTTTGTGGGGTTAGAGCTATAAATAGCA	1	bc
TCCGAAGTAA	GAAACACCGGTACTAGTTACTTACGGGTGGGGTTAGAGCTAGAAATAGCA	1	bc
GAAACGAGAT	GAAACACCGGTGCTAATAGTTAGCTAGTGGGGTTAGAGCTAGAAATAGCA	1	bc
AACAACCAAC	GAAACACCGGTAATCTAAAGATCCCCGTGGGGTTAGAGCTAGAAATAGCA	1	bc
AGTAATGAAG	GAAACACCGGTGCCCTTTATGGGACGGTGGGGTTAGAGCTAGAAATAGCA	1	bc
GAATCACAAC	GAAACACAGGTTATCTTTGCGGGTTTGTGGGGTTAGAGCTAGAAATAGCA	1	bc
AAGCTAACAC	GAAACACCGGTTACATATGCTTGTTTGTGGGGTTAGAGCTAGAAATAGCA	1	bc
ACAACAAACA	CTAAACACCGGTGGTGGTAGAGCTAGAAATAGCAAGTTAGCCTGAGACTA	1	bc
CACTTACAAG	GAAACACCGGTTGTAATTCGATCGGAGTGGGGTTAGAGTTAGAATTACCA	1	bc
CCCCCCTCCC	GAAACACCGGTAGAATGCGTCCACGGGTGGGGTTAGAGCTAGAAATAGCA	1	bc
TCAGCCTACA	GAAACACCGGTGGGGTTAGAGCTCGAAATAGCAAGTTAACCTAAGTCTCG	1	bc
GACTTCAACA	GAAACACCGGTGCTAATCGTTAGCTCGTGGGGTTAGAGCTAGAAATAGCA	1	bc
AACATGCTAG	GACACACCGGTTTTCGATCATAGGTCGTGGGGTTAGAGCTAGAAATAGCA	1	bc
AATACTGCAC	GAAACACCGGTGCCCTTTATATGACCGTGGGGTTAGAGCTAGAAATAGCA	1	bc
GACACACTAC	GAAACACCGGTAATGTAAAGATCCGCGTGGGGATAGAGATAGAAATAGCA	1	bc
CCATCATATC	GAAACACCGGTTCACCTGGCGTCTTTTTGTGGTGGTAGTAGTAAAAATAG	1	bc
AATCTATAAA	GAAACACCGGTGCTAATAGTTAGCTCGTGGGGTTAGAGCTAGAAATAGCA	1	bc
GGAAACCTAC	GAAACACCGGTAATCTAAGGATCACCGTGGGGATAGAGCTAGAAATAGCA	1	bc
CGTCGTGCTG	GAAACACCGGTCGTCGTTCGTAGGGCGTGGGGTTAGAGCTAGAAATAGCA	1	bc
GACGCCGTCC	GAAACACCGGTAATCTAAAAATCCCCGTGGGGATGAAGCTAGAAATACAA	1	bc
CGGCCAGTAG	GAAACACCGGTGAGAACAGAACGGTTTGGGGTTAGAGCTAGAAATAGCAA	1	bc
GAGAAAGCCG	GAAACACCGGTTCCCTTTACGGATTAGTGGGGGTAGAGCCAGAAGTAGTT	1	bc
GAGTCACGGA	GAAACGCCGGTGAGCGGAGATTATTCGTGGGAAATAGCAAGTAACCTAAG	1	bc
CATACTACCG	GAAACACCGGTGCCCTTTATGGGACCGTGGGGTTAGAGCTAGAAATAGCA	1	bc
CTGACAATAG	GAAGCACCGGTTGGCTTTGCTCTTTTGCGGGGTTAGAGAAATAAATAGCA	1	bc
CATACTGAAG	GAAACACCGGTGCCCTTTCTAGCTGAGTGGGGTTAGAGCTAGAAATAGCA	1	bc
CCCTCTATCC	GAAACACCGGTTGGCTTTACTTCTTTGTGGGGTTAGAGCTATAAATAGCA	1	bc
CCCAAGCTCC	GAAACACCGGTAATCTAAAGATCCCTGTGGGGGTAGAACTAAGAATAGGC	1	bc
GAACAACCCG	GAAACACCGGTGTTACTTAATCGAGAGTGGGGTTAGAGCTAGAAATAGCA	1	bc
AACATGCTAG	GAAACACCGGTTTTCGATCATAGGTCGTGGGGTTAGAGCTAGAAATAGCA	1	bc
TACACTCCAT	GAAACACCGGTTTACTTAGTTAACTAGTGTGGTTAGAGCTAGAAATAGCA	1	bc
GCCCCACGCT	GAAACACCGGTGGTCGCCGTGGAGAGGTGGGGTTAGAGCTAGAAATAGCA	1	bc
CCCCACTACC	GAAACACCGGTAGAATGGATCCACGTGTGGGGTTAGAGCTAGAAATAGCA	1	bc
GTCTCAGCCT	GAAACACCGGTTTTAGTAAATGGTGAGTGGGGTTAGAACTAGAAATAGCA	1	bc
AAATAATGCA	GAAACACCGGTGCCCTTTATTGGACCGTGGGGATAGAGATAGAAATAGCG	1	bc
AATTGGGCAA	GAAACACCGGTTGTGGGGAACTCGGTGTGGGAGAAATAGCAAGTTAACCT	1	bc
TCAAAACATA	GAAACACCGGTGAGCTTAGCGCTAGCGTGGGGATGTAGCTAGAAATAGCA	1	bc
AACCAACGGA	GAAACACCGGTGTGAGGAGACTACGCGTGAGAAATAGCAAGTAACCTAAG	1	bc
TCATCACTCC	GAAACACCGGTTGAGCTAGTCAAAAGGTGGGGTTGAGATAGAAAAAGCGA	1	bc
TCATCACAAC	GAAACACCGGTGGGGTTAGAGCTAGAAATAGCAAGTTAACCTAAGGCTAG	1	bc
TATTTAGCAC	GAAACACCGGTTGCGATCATCTGAAAGTGGGGTAAAGCTAAAAATAACCA	1	bc
CCCTCAAAAC	GAAACACCGGTTCAATCGGCGTCTTTTTGTGGGTATAGCGATAGATAGCG	1	bc
GAAACATCCT	GAAACACCGGTTTTCGTAAATGCGGAGTGGGGTTAGAGCTAGAAATAGCA	1	bc
CCAGGGGTTA	GAAACACCGGTCGTCGTTCGTAGGGAGAGGGGTTAGAGATAGAAAGAGCA	1	bc
CCGACAATAC	GAAACACCGGTCGGAGTGGGGCTATAGCTGGGATAAGCCAGTTAACATCA	1	bc
TACTCTCTAA	GAAACACCGGTACTCGTTACTTACGGGTTGGGTTAGAGCTAGAAATAGCA	1	bc
GCAATACTTA	GAAACACCGGTGACGCGAGGACGGTGGTGGGGTTAGAGCTAGAAATAGCA	1	bc
CAGTTAGTAA	GAAACACCGGTACTCTTTACTTATGGGTGGGGTTAGAGCTAGAAATAGCA	1	bc
TATTCCTAAC	GAAACACCGGTGGCAATTCGATCTGAGTGGGGTTAGAGCTAGAAATAGCA	1	bc
ATATTACCAA	GAAACACCGGTGCTAATAGTTAGCTCGTGTGGTTAGAGCTAGAAATAGCA	1	bc
GAATCCCAAG	GAAACACCGGTTTTAGTAAATGGCGAGTGGGGTTAGAGCTAGAAATAGCA	1	bc
ATACCACACT	GAAACACCGGTTGGCGGCGATGATGCGTGGGATTTAACCTGTAAACTAAA	1	bc
GACCACCTGA	GAAACACCGGTAGAATGTATCCACGGGTGGGGTTAGAGCTAGAAATAGCA	1	bc
CCTCTAACTC	GAAACACCGGTTGGCCTTACTCCTTTGTGGGGTTAGAGCTATAAATAGCA	1	bc
CCTCCAACAT	GAAACACCGGTCTTCCTGGAATCTACGTGGGGTAGAGCTAGTAATAGCAA	1	bc
GACTACCCCG	GAAACACCGGTGATCTAGCTAGCACCGGGGAGTTAAACTTAGGCTTGTCA	1	bc
TCTTCACATT	GAAACACCGGTCGCCCTGGAATCTACGTGGGGTAGAGCTAGAAATAGCAA	1	bc
TTCTTCCCCC	GAAACACCGGTCATCTAAAGATCCCCGTGGGGATAGAGCTAGAAATAGCA	1	bc
CATACCTAAC	GAAACACCGGTGACATACGTATGTCAGTGGGGTTAGAGCTAGAAATAGCA	1	bc
TAAATCAAAC	GAAACACCGGTTTACTTAGTTAACTAGTGGGGTTAGAGCAAGAAATAGCA	1	bc
GTGGATGAAA	GAAACACCGGTGAGATGCTAGAAATAGCGAGTTAACCTCAGGATAGTCCG	1	bc
