TCAGCACATC	GAAACACCGGTCTTGTTAGAGTTAGAAATAGCAAGTTAACCTAAGGCTAG	1	bc
ATCTCCGTGA	GAAACACCGGTGTTAGGGGATTATGAGCGAGAAATAGCAAGTAAACTTAA	1	bc
CGTTGGGCTG	GAAACACCGGTCGTCGTTCGCAGGGCGTGGGGTTATAGCTAGAAATAGCA	1	bc
GCATTAAATA	GAAACACCGGTGAGCATGACTACGTTGTGGGGTTAGAGCTAGAAATAGCA	1	bc
TGTCCATATT	GAAACACCGGTCTTCCTGGAATCTACATGGGGTAGAGCTAGAAATAGCAA	1	bc
CGCTAGCAAC	GAAACACCGGCGCTCTCTGCTCGTTGTGGGGGTTTGAGCTTGAAATAGCA	1	bc
GTCTCAACCC	GAAACACCGGTCACGGTCATGGGCCGTTGGGGTTAGAGCTAGAAATGGCA	1	bc
AATCACTCCC	GAAACACCGGTGACAAACGTATGTCAGTGGGGTTAGAGCTAGAAATAGCA	1	bc
ACACTCACAA	GAAACACCGGTTGCAATTCGATCTGAGTGGGGTTAGAGCTAGAAATAGCA	1	bc
TCAACCCTCT	GAAACACCGGTGACGCGAGGACGGGGGTGGGGTTAGAGCTAGAAATAGCA	1	bc
GACGCATCCG	GAAACACCGGTTTCAGCAAATAGTTGGGTTAGATCTAGATATACCTAGTT	1	bc
CCCCGGGGCG	GAAACACCGGTCGAATGGATCCACGGGTGGGGTTAGAGCTAGAAATAGCA	1	bc
AAATGAGCAG	GAAACACCGGTTTTAGTAAATGCGGAGTGGGGGTAGAGCTAGAAATAGCA	1	bc
ATGTCACTAA	GAAACACCGGTGGGGTTAGAGCTTGAGATAGCAAGTCCACCTAAGGCTAG	1	bc
GGATCAACAA	GAAACACCGGTGATAACAGAACGCTTTGGGGGTAGAGCTAGAAATAGCAA	1	bc
GCCTCTGTCA	GAAACACCGGTACTATTTACTTACGGGTGGGGTTAGAGCTAGAAATAGCA	1	bc
ATGATCACAG	GAAACACCGGTGGGGTTAGAGCTAGAAATAGCAAGTTAACCTAAGGCTAG	1	bc
AACTCGCCCC	GAAGCACCGGTTCAACCGGCGTCTTTTGTGGGGTTAGAGCTAGAAATAGC	1	bc
AGTTCCTCCA	GAAACACCGGTGCCGACAATGCGTTTTGGGGGTTAGACTTAGAAATACCA	1	bc
AGAATTAAAG	GAAACACCGGTACTAGTTACTTACTGGTTGGGTTAGAGCTAGAAATAGCA	1	bc
CATCCACGCA	GAAACACCGGTAGAATGGCTCCACGGGTGGGGTTAGAGCTAGAAATAGCA	1	bc
GAAACCAAAA	GAAACACCGGTTTACTTAGTTAACTAGTGGGGTTAGAGCTAGAAATAGCA	1	bc
TGCACGGCTG	GAAACACCGGTTCTCGTTAGAGCTAGAAATAGTTAGCTAACCTAATGCCA	1	bc
AAAATACTAA	GAAACACCGGTTTTCGATCATAGGTTGTGGGGTTAGAGCTAGAAATAGCA	1	bc
GACTCACGCA	GAAACACCGGTGAGCGGTACGGATTTGTGGGGATAAAGATAGAAATAACG	1	bc
GCCAACCGCC	GAAACACCGGTGGACTCCATGCACGGGTGGGGTTAGAGCTAGAAATAGCA	1	bc
ACGTAACCAC	GAAACACCGGTTGGCTTTACTCCTTTGTGGGGTTAGAGCTATAAATAGCA	1	bc
TGTTCCGGCT	GAACCCCGGGTCTCGTTACGGTTTCGTGGGGGTAGGGCTAGCAATCGCAA	1	bc
ATCTCTGCCT	GAAACACCGGTGTGCGGTGATTCTACGTGTGGAATAGCAAGCAACCGCAA	1	bc
AAACTGCACG	GAAACACCGGTTTTCGATCATAGGTCGTGGGGTTAGAGCTAGAAATAGCA	1	bc
TTCACTCACT	GAAACACCGGTTGTCGTCAATTGTTGAAATAGTTAGATCACCTAAGACCA	1	bc
TTGTGCGCCA	GAAACACCGGTCGCGAAAATGATGTGGTGGGGTTAGAGCTAGAAATAGCA	1	bc
AATTACGCAC	GAAACACCGGTAGTGGGGAACTCGGTGTGGGGGAAATAGCAAGATAACCT	1	bc
AACTTGCCAA	GAAACACCGGTTGTGGGGAACTGGGCGTGGGAGTAGAAGCAGGATAAGCA	1	bc
TCAACCCTCT	GAAACACCGGTGAGAACAGAACGTTTTGGGGTTAGAGCTAGAAATAGCAA	1	bc
ATTTCGCAAA	GACACACCGGTGGTAATTCGTTTTGAGCGGGGTTAGAGCTAGAAATAGCA	1	bc
TAAAAACACT	GAAACACCGGTTTACTTAGTTAACTAGTGGGGTTAGAGCTAGAAATAGCA	1	bc
CTTTGCGCGA	GAAACACCGGTGAGATGCCAGAATAAGCAAGTAAACCTAAGGCAAGTCCG	1	bc
ATTTCGCAAA	GAAACACCGGTGGTAATTAGAGCAGGGTGGGGTTAGAGCTAGAAATAGCA	1	bc
TGAACTCCCC	GAAACACCGGTTCCCGTTAGCTCTAGAAATAGCAAGTTAACCTAATGCTA	1	bc
TAATAACACC	GAAACACCGGTGTTGTTTGTTCGAGGGTGGGGTTAGAGCTAGAAATAGCA	1	bc
ACTTCACAAC	GACACACCGGTGGCAATTCGATCTGCGTGGGATAGCGCTCGTAATCGAAC	1	bc
ACGTTAATAA	GAAACACCGGTTTGCTTTACTCCTTTGTGGGGTTAGAGCTATAAATAGCA	1	bc
AACTCGCCCC	GAAACACCGGTTGAGGGGAAGTCTTTTTGGGGGTTATAGCTAGTTATCCC	1	bc
AATCCCAAAA	GAAACACCGGTTTAGTATGGAGGTGGGGGTAGAGCTAGAAATAGCAAGTT	1	bc
CATTGAGAGA	GAAACACCGGTGGCAAGTCGGTATTAGCAGGGTTAGCTATAGCTAGACCG	1	bc
TTCCGCGCCC	GAAACACCGGTCCCGAAAGTTTGCCGGTGGGGTTAGAGCTAGAAATAGCA	1	bc
GAATTATATC	GAAACACCGGTGAGCATGATAACGTCGTGGGGTTAAGGCTAGAAATAGAA	1	bc
CCATCAGCCC	GAAACACCGGTTTTAGCAAATACTTTGGTTAGAGCTAGCGATAGCTAGCT	1	bc
ATAACACAAA	GAAACACCGGTTGTAAGCGATGGTTTGTGGGGTTAGAGCTCTAAATAGCA	1	bc
GCCTCTGTCA	GAAACACCGGTGGTGGCCGTGGAGAGGTGGGGTTAGAGCTAGAAATAGCA	1	bc
AGTGGGCGCG	GAAACACCGGTGAGATGCCAGAAATAGCAAGATAACCTAAGGCTAGTCCG	1	bc
TGCACTGCAA	GAAACACCGGTTCCAGTTAGCTCTAGAAGTAGCAAGATAACGTAAGACTA	1	bc
GTAAGCCATA	GAAACACCGGTGAGCTAACAAAAATAGCAAGGTTACCGAAAGGTAGGCCG	1	bc
GGAACTTACT	GAAACACCGGTGCGCGTGAGCTCTAGTAATAGTATGTTTACCTAAGGCAA	1	bc
TCCGCAAACC	GAAACACCGGTTCAACTAGCGCTATTTGTGGCGAGTTAGCCTAAGGCTGG	1	bc
TTCCTCAGCC	GAAACACCGGTTTTCGTAAATGGTGAGTGGGGTTAGAGCTAGAAATAGCA	1	bc
GATTCACGCT	GAAACACCGGTTACCGTTCCTGCTTTGTGGGGTTAGAGCTAGAAATAGCA	1	bc
GCGGGCGCAA	GAAACACCGGTTAGATGCCAGACATAGCAAGTTAACCTAAGGCTAGTCCG	1	bc
GCGCCCAGCG	GAAGAAACACCGGGTATCGTTACGGCATTGTTGGGGTAGAGCCTAAAAAT	1	bc
GAATTAAAAA	GAAACACCGGTGCTCATAGTTAGCTCGTGGGGTTAGAGCTAGAAATAGCA	1	bc
GCAACAAATG	GAAACACCGGTGAGCATGGTGCCGTAGAGGGGATAGAGCTAGAAATATCA	1	bc
GAACCAGAAG	GAAACACCGGTGTTAGTAAATAGAGGGGGGAGAGCTAGAAATAGAAAGCA	1	bc
ACGTCAACAT	GAAACACCGGTTGGCTTTACTCCTTTGTGGGGTTAGAGCTATAAATAGCA	1	bc
TCAGCACACC	GAAACACCGGTGGGGTTAGAGATAGAAATAGCAAGTTAACCTAAGGCTAG	1	bc
GCGAGCGAGT	GAAACACCGGTGAGATGCGAGAAATAGCGAGTTAACCTAAGGATAGTCCG	1	bc
TTGATCGTCC	GAAACACCGGTCGAAGTAATCAAATTGGGGGGGTGAGCGCTAAATATAAC	1	bc
ATGTCCGACA	GAAACACCGGTGGGGTTAGATCTAGAAATAGCAAGATAACCTAAGTATAG	1	bc
TTCCGGTCCC	GAAACACCGGTCGCCGATATGTGGCGGTGGGGTTAGAGCTAGAAATAGCA	1	bc
TCATAGGAAA	GAAACACCGGTTGTGGGGAACTCGGTGTGGGAGAAATAGCAAGATAACCT	1	bc
GACTCTAGAG	GAAACACCGGTTTTCGTTACTTATTTGTGGGGTTAGAGCTGGAAATAGCA	1	bc
TTGTCAATCG	GAAACACCGGTTCTGGTAACTGAGTTGTGGGGTTAGAGCTAGAAATAGCA	1	bc
CTCCAACCGT	GAAACACCGGTGTGCGGGGATTATGCGTGGGAATTAGCATGTAACTTACG	1	bc
