AATATGTTAA	GAAACANCGGTTTTTGATAATAGGTCGTAGCGTTAGAGCTAAAAATAGCA	1	bc
AGACCACAAA	GAAACANCGGTGTTCTTTGCGCGAGGGTGGGGTTAGAGCTAGAAGTAGCA	1	bc
TCACCCATAA	GAAACACCGGTGTCGTTAGAACTGGAAGTAGGAATTTAACTTGAACTGAC	1	bc
ACCCCGCCCG	GAAACANCGGTAGAATGGATCCACGGGTGGGGTTAGAGCTAGAAATAGCA	1	bc
ACTACTGACG	GAAACANCGGTGCCCTTTATGGGACCGTAGGGTTAGAGCTAGAAATAGCA	1	bc
GAGAAAATCC	GAAACANCGGTAATCTAAAGGGCCCTGTGGGGGTTGGGCTTAGAAAAAGA	1	bc
AAAAACGCCT	GAAACACCGGTGCCCCTTATGCGACCGGGTAGAGCTAGCAATAGATAGTT	1	bc
GAAATCCAAA	GAAACACCGGTTTACTTAGTTAACTAGTGGGGTTAGAGCTAGAAATAGCA	1	bc
AAACGCGTTT	GAAACANCGGTGCTGTCGGGTTCTGGGGGTGGATCTAGCTATAACTAGCA	1	bc
GCCAAGAACC	GAAACANCGGTGCACTAAGCGTTTTGAACCGGAGGGGGGGCTAGAGCTAG	1	bc
ATTCCACCCA	GAAACACCGGTTATAGACGTAGAAATATCCAGTTAACGTTAGGATTGTCA	1	bc
TCAACCACAC	GAAACANCGGTGGGGATAGAGCTAGAAATAGCAAGGTAACCTAAGTCTAG	1	bc
CACCGTGAAA	GAAACACCGGTACTAGCGACTTAGAGGTGGGGTTAGAGCTAGAAATAGCA	1	bc
GACATGGCAG	GAAGCANCGGTTTTAGTTAATGGGGAGTGGGGTTAGAGCTAGAAATAGCA	1	bc
GTAACCGAAC	GAAACANCGGTGTTATTTGCTCGAGGGAGGGGTTAGAGCTACAAATAAAC	1	bc
GTGTAACCGG	GAAACANCGGTTATCGTTACGGATTTTGTGGGGATAGCGCTAGAACTAGC	1	bc
CCCTCGAAAA	GCAACANCGGTGGGACTGGCGTTTTAAATCGCAAGGGAAGTTAGAGCTAG	1	bc
CAGATGCCAG	GAAACANCGGTTTTCGATCATAGTTTGGCGGTATATAGCTAGTAATACTA	1	bc
TAAACATAAA	GAAACACCGGTGGGGATAAAGATAGCTATAACTAGTTAACTTACCTCAGG	1	bc
TCAGGAATCA	GAAACANCGGTGGGGTTACAGCTAGAGAGAGCAAGTTCACATAAGGATAA	1	bc
TAAACCAGAA	GAAACANCGGTTTCATTAGTTAACTCGTGGGGTTAGAGCTAGAAATAGCA	1	bc
TGACAGCTCC	GAAACANCGGTGTTCTTTGCTCGAGGGTGGGGTTAGAGCTAGAAATAGCA	1	bc
AACCACCTGC	GAAACANCGGTGTTCTAAGGATGTCCGTGGGGATAGAGCTAGAAATAGCA	1	bc
GCATCAACAG	GAAACANCGGTTTTCGTTAATGGTGAGGGGGTTTAGAGCTAGAAATAGCA	1	bc
TAAGTAAACA	GAAACACCGGTTGGGATAATGCTAAAATGGGCAAGAGCAAGAAATGGAAA	1	bc
AAAACGCAAC	GAAACANCGGTGTTCTTTGCTCGTGGGTGGGGTTAGAGCTAGAAATAGCA	1	bc
GAACGAGCTG	GAAACANCGGTGCTAGCGGATTCGAAGTGGGGTTAGAGCTAGAAATAGCA	1	bc
TGTAACGATT	GAAACANCGGTCTTCCTGAAATCTAAGGTGGGGTAGAGCTAGAGATAGCA	1	bc
TACAAAGATT	GAAACANCGGTAATCTAGGGATCTCCGTGGGGATAGAGATAGTAAGGGTA	1	bc
TAGTCAGCTG	GCAACANCGGTCTTCGTGGCATCTAACGTGGGGTTGAGCTAGAAATAGCA	1	bc
AACAGAGTAG	GAAACACCGGTGCTAGATGATTGGGAATGGGGTTAGAGCTAGAAATAGCA	1	bc
GATCCAGATG	GAAACANCGGTCTTCCTGAAATCTAACGTGGGGTAGAGCTAGAAATAGCA	1	bc
ACCTGATGAA	GAAACANCGGTGGGATGGATCCACGGGTGGGGTTATAGCTAGAAACTGCT	1	bc
AATTTCGCCG	GAAACANCGGTTCCCTTTATGGGACTATGGGTTTAGAGCTAGATATAGCA	1	bc
AGTTCGCAAA	GAAACANCGGTGTCATTTGGTTGTGGGTGGGGTTAGAGCTAGAAATAGCA	1	bc
TAGTCAATCT	GAAACANCGGTCATCGTTACGGTTTTTCTGGGGCTATATCTAGTTATAGC	1	bc
AATTCAAACG	GAAACACCGGTTATCGTTACCGTTTTTGTGGGGATATAGCTAGATATCGC	1	bc
AGTTAGTAAA	GAAACANCTTGGGGTTATAGCTAGAGATAGCAAGATAACCTGAGGCTGGT	1	bc
AAATTAATGA	GAAACANCGGTGCAAATTGGTGGAGCTGGGATTAGCAAGGTAACTTAAGG	1	bc
GTGCCAATCG	GAAACGNCGGTTATCGATACGGATTTTGTGGGGTTAGAGCTAGAAATAGC	1	bc
CTCTCATCGA	GAAACACCTGGGGGCTAGAGCTAGACGTAACAAGTTAACCTAAGGCTAGT	1	bc
CCATCAGCCC	GAAACANCGGTTTTAGTTACTGCTTTATCTGTTTAGAGCTAGATAACCTA	1	bc
ATCCACCCCC	GAAACANCGGTGGAATGCATCCACGTGTGAGATCTAGCAATAACACTTCA	1	bc
CGGTGGACAG	GAAACANCGGTCGTCTTTCGTAGGGCCGCTGTGTTAGAGCTAGTGATAGA	1	bc
ACCACACAAA	GAAACANCGGTGTTGGATCATCGATCGTGGGGATATAGCTATAAATAGCA	1	bc
AACACGTCAA	GAAACANCGGTTTTCGATCATAGGACGTGGGGTTAGAGCTTGAAACAGCA	1	bc
CAACCGCACA	GAAACANCGGTTTAGCCTGGGAGTGGAACCGGAGCTAGGGATAGAACTAT	1	bc
AAACCCGCGG	GAAACANCGGTGCACTATGGGGGAAAGTGGGGTTAGAGCTAGAAATAGCA	1	bc
GGTTCAGCAG	GAAACANCGTGTGTTTAGAGCTAGAAGTAGGAAGTTAACCTAAGGCTAGT	1	bc
AAACTAAAAG	GAAACANCGGTGCTAATAGTTAGAGCGAGAAGTAGGAAGTTAACATAAGG	1	bc
CAACCGGACT	GAAACANCGGTGCTAGCGGTTTCGAAGTGGGGTTAGAGCTAGAAATAGCA	1	bc
CCGCTCCCCC	GAAACACTGGTAGAATGGATCCACGGGTCGGGTTAGAGCTAGATATAGCA	1	bc
TAAAACGTCT	GAAACANCGGTCACGCGAGGACGGTGGTGGGGTTAAACCTAAAAATAGAA	1	bc
TATATCGGGT	GAAACANCGGTTTAGGTAGTCAACTTGTGGGGTTAATGGCAGATATAGCT	1	bc
TAATGGGTAA	GAAACANCGGTTGTGGGGAACTCGGTGTGGGAGAAATAGCAAGTTAACCT	1	bc
CAATTAGCCT	GAAACACCGGTTTTAGTAAATGGTGAGTGGGGTTAGAGCTAGATATAGCA	1	bc
GGTACAAGCC	GAAACACCTGTTATCGGTCCTGAGTTTGTATGTGTAGATCGAGATGTATC	1	bc
GAAACAGAAG	GAAACANCGGTTTTCGTAATTAGTGAGTGGGGTTAGAGCTAGAAATAGCA	1	bc
TCAAACCACG	GAAACANCGGTGACGCCAGGACGGTGGTGGGGTTAGAGCTAGAAATAGCA	1	bc
AACTCATCAG	GAAACANCGGTTTCCGATCACAGGTCGTGGCGTTAGAGCCTGAAACAGCA	1	bc
CCACCAAGAA	GAAACANCGGTGGTATTGGTTCCGGAGTGGGGTTAGAGCTAGAAATCGCA	1	bc
AATCCCGCAA	GAAACACCGGTTGTGGGTGGCTGGGAGTGGGAGTAATAGCAAGTTTACCT	1	bc
AATATGCCAA	GAAACANCGGTTTTCGATCATAGGTCGTGGGGTTAGAGCTAGAAATAGCA	1	bc
TGCACTCTGT	GAAACANCGGTTCCCGTTAGCTCGTAGTGGGGTTAGAGCTAGAAATAGCA	1	bc
CCATCCCCCC	GAAACANCGGTGACGCTTGGACCGTGGGGGGTATATAGCAAGATATCGTA	1	bc
TAAAACGCCT	GAAACACCGGTGTCCTTAATTAAATAGTGGGGTTAGAGCTAGAAATAGCA	1	bc
AAGTTCATCA	GAAACANCTGGGGGATAGAGCTAGAAATAGCAAGTTAACCTAAGGCTAGT	1	bc
AATCCTGCCC	GAAACACCGGTGCCCTTTATGGGAACGTGGGGTTAGAGCTAGAAATAGCA	1	bc
TTCTTCTCCC	GAAACANCGGTCGCGAAAATGTGCCGGTGTGGTTCGAGCTAGAAATAGCA	1	bc
GACATCCACA	GAAACANCGGTAATCTAAAGATCCTCGTGGGGTTAGAGCTAGAAATAGCA	1	bc
GTCAGATTTA	GAAACACCGGTGAGCATAGTAACATCTAGGGCGCAGAGCTAGAAAGAGAA	1	bc
AGTACATCGA	GAAACANCTGGAGAATAGGGATAGAAATAGCAAGTTAAACTGAGGATAGT	1	bc
ACCTCGGAAA	GAAACACCGGTTGAACCGGCGTCTTGAAGGGATGGGGGGCATGGTGCTAG	1	bc
TCCACAAAAC	GAAACACCGGTGGGGTTAGAGCTAGAAATAGCAAGTTAACCTAAGGCTAG	1	bc
TTAACATCTA	GAAACACCGGTTAGCGTTAGATCGTCGTGGGGTTAGAGCTAGAAATAGCA	1	bc
AGAAAGGACC	GAAACANCGGTGTTATTTGCTGGGGGGTGGGGTTAGAGGTTGAAATAGAC	1	bc
ACCAGCCTAC	GAAACACCGGTTTTCGATCATAGGTCGTGGGGTTAGAGCTAGAAATAGCA	1	bc
AACACGCACG	GAAACANCGGTTTTAGATCATAGGTCGTGGGGTTAGAGCTAGAAATAGCA	1	bc
ACGACCCTCG	GAAACANCGGTCCCACGAGCACGGGGTAGGGCTTAGAACAGGAAATAGCA	1	bc
GAAACATCCA	GAAACACCGGTTTTCATAATTAGAGCTAGAAGTTGGAACTTGGCCTAGCG	1	bc
AAACAACCCT	GAAACANCGGTTGCAAGCAATGGTGTGTGGGGTTAGAGCTAGAAATAGCA	1	bc
CACAGAGCTT	GAAACANCGGTGCTAGCGGTTTCGAAATGGTATTAGAACTATAAATAGCA	1	bc
ATAATGAGCA	CAAAACANCGGTTGTGGGGAACTCGGTGCGGGAGAAGTAGCAATGTAACT	1	bc
TGATTAGTCT	GAAACANCGGTTGAGATAATCAAAAAGTGGGGTAGAGCTAGAAATAGCAA	1	bc
TAAACGCTAG	GAAACANCGGTTTTCGATCATAGGTCGTGGGGTTAGAGCTAGAAATAGCA	1	bc
ATAAAAGCCA	GAAACACCGGTGACCATTATAGGGCCGTGGGGTTAGAGATAGCAATAGCA	1	bc
AAGTTAACCC	GAAACACCGGTTGACTTTATTCAATTGTCGGGCTATAGCAAGTTAAACTA	1	bc
GGACTACATA	GAAACACCGGTGTTCTTTGCTAGGGGGTGGGGTTAGAGCTAGAAATAGCA	1	bc
AATAAGGTAA	GAAACACCGGTAATCTAAAGATCCCCGTGGGAAAAGAGCTAGAAAAAGCT	1	bc
TGGTAAACAC	GAAACANCGGTTGCCTTTAATCCTTTAGTTATAAATAGCAAGTTAACATA	1	bc
TCAGGAAATT	GAAACANCGGTGGGGGTAGAGCTAGAAATAGCAAGTTAACCTAAGTCTAG	1	bc
GATAATAGCG	GAAACANCGGTTCTCGTTACGGAATTTGTGGGGTTAGAGCTAGAATTAGC	1	bc
AATTGTTCCA	GAAACANCGGTTGTGGGGAACTCGGTGTGGGCGAAATAGCAAGTTAACCT	1	bc
TGAACCCCCA	GAAACANCTTTGACGCGAGGACGGTGGTGGGGTTAGAGCTAGAAATAGCT	1	bc
AACACCCTAT	GAAACACCGGTTTCCGATCATAGGTCGTGGGGTTAGAGCTAGAAATAGCA	1	bc
ACTACCTCCA	GACACACCGGTGGCGCGGAGACGGTGGTGGGGGTAGAACTAGAAATACCA	1	bc
CCCTAACCGC	GAAACACCGGTGGGCTGAGCTTCTGCGTGTTAAAAATCCAATATCATCCT	1	bc
GAATATGCAG	GAAACACCGGTTTTAGTAACTGGTGAGTGGGGTTAGAGCTAGAAATAGCA	1	bc
CCGTGGACAG	GAAACACCGGTCGTCGTTACTAGGGCCGTGGGGTTAAAGCAATAAATAGA	1	bc
TCCACTAACA	GAATCACCGGTGCGCGTAGAGCTAGAAATAGCAAGTAACCCTAAGGCTAG	1	bc
CCACCGCAAC	GAAACACCGGTGCTCTTGGCGCGAGGGAGGGGTTGGTGCTATAAAGCTCG	1	bc
GATCTAACAC	GAAACACCGGTGCTAATAGTTAGAGCTAGAAATAGCAAGTTAACCTAAGC	1	bc
GATAAACTAC	GAAACACCGGTAATCTAAAGATCACAGTGGGGATAGAGCTAGAAATAGCA	1	bc
CTTTAATCGA	GAAACACCTTGGGGTTAGAGCTAGAAATAGCAAGTTAACCTAAGGCTAGG	1	bc
TCACGAAATA	GAAACACCGGTGCGGGAGGAGCTAGAAATAGCAAATTAACCTAAGTCTAT	1	bc
CATCGATCAT	GAAACACCGGTGCTAGCGGTTTCGGAGGGGGGTTAGAGATAGAACTAGCT	1	bc
TTCCGCAGCC	GAAACACCGGTAGAATGGATCCACGGGTGGGGTTAGAGCTAGAAATAGCA	1	bc
AGATTACTCC	GAAACACCGGTTGAGATTGTCAAAGAGTGGGGTAGGGCTTGGAAATACAA	1	bc
GACCAGCACC	GAAACACCGGTAATCTAAAGATCCGCGTGGGGATAGAGCTAGAAATAGCA	1	bc
GAGTTACGTG	GAAACACCGGTTATCGTTATGGGAGCTGTGGGGAGAGAGCTAGACATAGG	1	bc
TGTAATGCTT	GAAACACCGGTGCCCTTTGTGGCTAACGTGGGGTAGAGCTAGAAATAGCA	1	bc
CCCCGACACA	GAAACACCGGTAGAATGGATCCACGGGTGGGGTTAGAGCTAGAAATAGCA	1	bc
TCCTTCACAA	GAAACACCGTGGGGTTAGAGCTAGAAATAGGAAGTTAACCTAAGGCTAGT	1	bc
TCAATAAAAC	GAAACACCGGTGGGGTTAGAGCTAGAAATAGCAAGTTAACCTAAGGCTAG	1	bc
AAATCATCGA	GAAACACCGTGTGGGTATGGCTGGAAATAGCATGATAACCTAAGACTAGT	1	bc
ACACCAACAA	GAAACACCGGTGACAAACGTATGACAATGGGGTTAGAGCTAGAAATAGCA	1	bc
TGATTAGTTC	GAAACACCGGTCTTCCTGATATCTAACGGGGGGTGAGCTAAGAATTACCA	1	bc
GCATTACACA	GAAACACCGGTGATACTAGTTAGAGCTAGAAATAGCAAGTTAACCTAAGG	1	bc
AACTTAATAC	GAAACACCGGTTGTGGAACTCAAAACGTGGGGTAAAGCTAGGAATAGCAA	1	bc
AACATGGCCG	GAAACACCGGTTTTCGATCATAGACCGTGGGGTTAGAGCTAGAAATAGCA	1	bc
CATCGACACC	GAAACACCGGTAGAATGGATACACGGGTGGGGTTAGAGCTAGAAATAGCA	1	bc
AATAAAGAAT	GAAACGCCGGCGCCAGTTGGGGTAGAGCGAGAAATAGCAAGGTAATCTAA	1	bc
GACATGCCCG	GAAACACCGGTTTTAGTAAATGGTGAGTGGGGTTAGAGCTAGAAATAGCA	1	bc
GACACACTTC	GAAACACCGGTAATCTAAAGATCCCCGTTGGGATAGAGCTAGAAATAGCA	1	bc
ATGACCGTCG	GAGACACCGGTCACATAAGGATCGCGGTGGGAATAGTGCAAGAAACAAGA	1	bc
GGTTCAACAG	GAAACACCTTGGGGTTAGAGCTAGAAATAGCAAGTTAACCTAAGGCTAGT	1	bc
GTGACATGTA	GAAACACCGGTTAGCATTACTGGTTTTGTAGGTATCAAGCTAGACATAGC	1	bc
GACAGCCTTT	GAAACACCGGTAATCTAAAGATCCCCGTGGGGATAGAGCTAGAAATAGCA	1	bc
GAATGCTATC	GAAACACCGGTTTTCGTTCATAGGCCGTGGGGTTAGAGCTAGAAATAGCA	1	bc
CATCCGCAAC	GAAACACCGGTGTTCTTTGCTCGAGGGTGGGGTTAGAGCTAGAAATAGCA	1	bc
CATCCAGCAT	GAAACACCGGTGCTAGAGGTTTCGATAGCAAGTTAGAGCAAGAAATAGCA	1	bc
CAACCATCCC	GAAACACCGGTGCCAGCGGTCTCGAAGTGGGGGTTAGGGTTGGAAAACCA	1	bc
AAAAAATATA	GAAACACCGGTGAGCTTGATGAGAGCGAGGGGTTAGAGCTAAAACTAGCA	1	bc
AACTGGCACC	GAAACACCGGTTCAACCGGCGTCTTGAACCGGTGGGGGGGTTAGAGCTAG	1	bc
GCATTCAACC	GAAACACCGGTGCTAATAGTTAGAGCTAGAAATAGCAAGCTAACCTAAGG	1	bc
AAACCCCTCC	GAAACACCGGTGACGCGAGGACGGTGGTGGGGTTAGAGCTAGAAATAGCA	1	bc
GAAAGAGAAA	GAAACACCGGTTGGGGTGAACTCGGCGAGGAAGAGCTAGCAAGTTAACCT	1	bc
AAAAAACTCC	GAGGCACCGGTAATCTAAAGATCCCCGTGGTGATAGAGCTAGAAATAGCA	1	bc
GTCATATAAG	GAAACACCGGTTTTCGAGAATAGGGGGTGGGGTTAGAGCTAGAAAGAGAA	1	bc
AGGCCGGAAC	GAAACACCGGTGTTCTTTGCTCGAGGGGGGGGTTAGAGCTAGAAATAGCA	1	bc
