TTGACCGCTT	GAAACANCGGTCCTATAAGCTGTGGGGAAAGAGCTAGAAATAGCAAGTGA	1	bc
AGATAACAAA	GAAACANCGGTGGCAATTCGATCTGAGTGGGGTTAGAGCTAGAAATAGCA	1	bc
AAAATCTGTA	GAAACANCGGTTTAGTATGGTAGAGTAAGAATTAACATGTCAACCTAAGC	1	bc
AAGAGAGCCG	GAAACANCGGTCTTAGTACGTAGGGAGTGGGGTTAGAGCTAGAAATAGCA	1	bc
TACTCCTCCG	GAAACANCGGTCATCGTTACGGGTTTTTTGGGTTTAGAGCTAGAAATAGC	1	bc
AAACCCCTTT	GAAACACCGGTTTAGTGTGGTGGGTTAGAGTTAGAAATAGCAAGTTAACC	1	bc
AACTCGCAAC	GAAACACCGGCTCAACCGGCGTCTTGAACCGGTGGGGGGGTTAGAGCTAG	1	bc
AAGATAATAG	GAAACANCGGTTTTCGTTCATAGTTTGTTGGGTTAGAGCTAGAAATAGCA	1	bc
TGTTCAGACG	GAAACACCGGTCTTACTGGAATCTAACGTGGGTTAGAGCTAGAAATAGCA	1	bc
AAAAAACACC	GAAACACCGGTAATATAAGGATCCCTGTGGGGATAGAGCTAGAAATAGCA	1	bc
CATTCATCCC	GAAACACCGGTTCAACAGGCGTGTTAATCGGGTTAGAGCGAGAAAGATAA	1	bc
AATCATGACG	GAAACANCGGTGCTCTTTATGGGAGCGTGGGGTTAGAGCTAGAAATAGCA	1	bc
AATACAGCAG	GAAACANCGGTGATAAAAGCATGGTAGTGGGGGGAGAGAGAGAAAAAGCA	1	bc
CATCCCCCAC	GAAACANCGGTGGAAAGGGTCTGTGGGTGGGGTTAGAGCTAGAAATAGCA	1	bc
TGTAAAGACT	GAAACANCGGTCTTACTGGAATATAACGTGGGGTAGAGCTAGAAATAGCA	1	bc
TAGGCAGCAA	GAAACANCGGTGTTCTTTGCTCGAGGGTGGGGTTAGAGCTAGAAATAGCA	1	bc
AGAACCAAGA	GAAACANCGGTGTAGGCTAGAGGGTAGTGGGGTTAGAACTTGGAATAGCC	1	bc
ACCCGGCGAC	GAAACANCGGTATTCTGTACTCGCGGGTGGGGTTAGAGCTAGAAATAGCA	1	bc
TTCTTATCAA	GAAACANCGGTCGCGAAAAGGTGGCGGTGGGGTTAGAACTAGAAATAGCA	1	bc
AACTCGCACG	GAAACANCGGTGCCACCTGTGTCTTGATCCGGTGGGGGGTTTAGAGAGAG	1	bc
CCTTTTTAAC	GAAACANCGGTTGGCTTTACTCCTTTAGCTATAAATAGCAAGTTAACCTA	1	bc
AATACACAAG	GAAACANCGGTGTTAATTCGAACTGAGTGGGGTTAGAGCTAGAAATAGCA	1	bc
ATGCACCTAC	GAAACANCGGTGTTCTTTGCTCGAGGGTTGGGGTAAGAATAAGAAAGTTA	1	bc
ATAAAAACCA	GAAACANCGGTTTACTTAGTTAACTAGTGGAGTTAGAGCTAGAAATAGCA	1	bc
GAGTAAATCC	GAAACANCGGTAATCGATAGATCTCCTGTGGGATAAAGCTAGAAATAGCA	1	bc
CAGAGGGAAG	GAAACANCGGTCGTCTTACGTAGGTCGTGGGGTTAGAGCTAGAAATAGCA	1	bc
AATTGGGACC	GAAACACCGGTTGAACGGGAGTCTTGAAGGGGGGGGGGGCTAGGTGCCAG	1	bc
AGGAGTGCCG	GAAACACCGGTAGTCGTTAGTAGGGCGTGGGGTTAGAGCTAGAAATAGCA	1	bc
ATCTACCCCT	GAAACANCGGTGTGCGGAGATTATGCGTGGGAAATAGCAAGTAACCTAAG	1	bc
AGACAGCCGA	GAAACANCGGTGTTCGGTGATTGTGGGTGGGGATAAAGATAGAAACTGCA	1	bc
GAACTAACAC	GATACCNCGGTGCCAAACGTTTGTCAGTGACATTGGAGCTAGACATAGCG	1	bc
ACCACCCTCC	GAAACANCGGTCCTAGCGGCTGCGTGATCCGGGCTGGAGGTAGCAGCTTA	1	bc
AGTCCGGAAG	GAAACANCGGTCTTCGTTGAAACTAAGGGGGGGTAGAGCTAGAAATAGCA	1	bc
GGGAGAGATG	GAAACANCGGTGGTAGTAGGGAGGGCGTGAGGTAAGTGATCGAAATCGAG	1	bc
AAACCAGCAG	GAAACANCGGTGATAGACGATTGTCAGTGGGGTTAGAGCTAGAAATAGCA	1	bc
ACCCCGCCAC	GAAACANCGGTGTTCATTGCTCGAGGGTGGGGTTAGAGCTAGAAATAGCA	1	bc
TCCCGAGATC	GAAACANCGGTAGTATTGAACTACGGGGTGGGGTTAAAGTAAAAAATAGA	1	bc
TGAGCAGATA	GAAACACCGGTCTGCCTGGAATCAAAAGTGGCAAGGTGCCAGAAGGAGAG	1	bc
ATATTACCGC	GAAACANCGGTGTGGGGAGTCTATGAGTGGGAAATAGCTAGAAATCTAAG	1	bc
AGACGAGACT	GAAACANCGGTTGTAGGCGATGGATTGTGGGGTTAGAGTAAGAAATGGCA	1	bc
CATCGATCTC	GAAACANCGGTGACAAACGTATGTCAGTGGGGTTAGAGCTAGAAATAGCA	1	bc
CGCAATCACT	GAAACACCGGTGACAAAGGGATGAAAGTGGGAATAAGGATGTAAACATAA	1	bc
GCGTCGCGCG	GAAACANCGGTTAACGCTGCGGCTTTTATGGGGGTGGGGCTTAAAATAAG	1	bc
GAAACAGAAG	GAAACANCGGTTTACTTAGTTGACTAGTGGGGTTAGAGCTAGAAATAGCA	1	bc
ACACCCAGAC	GAAACANCGGTTTAGTATGGCGGGATAGAGGTAGAAATAGCAAGTTAACC	1	bc
ATGAAGCTAG	GAAACANCGGTGTGCTTTGATCGAGGAAGGGCTTAGAGATAGAAAGAGCA	1	bc
AACCCACCCC	GAAACANCGGTAACAAACGGATGTCAGTGGGGTTAGAGCTAGAAATAGCA	1	bc
AAACCAAACC	GAAAACNCGGGTGGATGGGACGGGAAGTAGCGTGATAGCCTGAAACAACA	1	bc
CCCCCGGAAC	GAAACANCGGTTCAACCGGCGTCTTGAACCGGTGGGGGCTATAGAGCTCG	1	bc
GGTGTAAATA	GAAACANCGGTCCTAATGGTTACTACCGTGGGGTAGAGCTAGAAATAGCA	1	bc
TAATACCAAA	GAAACANCGGTATAACTTGTTAACTAGTGGGGTTAGAGCTAGAAATAGCA	1	bc
CTCTAAGCGT	GAAACANCGGTGTGCGGAGATTATGCGTGAGAAATAGCAAGTAACCTAAG	1	bc
TCGGCGGGCT	GAAACANCGGTTGTCGTTCGTAGGGCGTCGGGTTAGAGCTAGAAATAGCA	1	bc
AATGGAGTAC	GAAACANCGGTGACAAACGCATGGGAGTGGGGGTAGAGCTAGAAAAAGCA	1	bc
CGGAGTGCTG	GAGACANCGGTCGTCGTTCGTAGGGCGTGGGGTTAGAGCTAGAAATAGCA	1	bc
AAAAATGAAG	GAAACACCGGTTTACTTAGTGAAATAGTGGGGTTAGAGCTAGAAATAGCA	1	bc
AATAATGCCG	GAAACANCGGTGCCCTTTATGGGACCGTGGGGTTAGAGCTAGAAATAGCA	1	bc
CCACCGCATC	GAAACACCGGTTCAACCGGCGTCTTGAAACGGTGGGGGGTTTAAATCTAG	1	bc
CAATGGGCTT	GAAACANCGGTGCTAGTGGGTGTAGAGCGAGGAAAAACAAAGTAACCTCA	1	bc
CGTCGGTCTG	GAAACANCGTTCGGCGTTCGTAGGGAGTGGCGATAGAGCTAGAGATAACA	1	bc
AATACCCCAC	GAAACACCGGTGACAAACGTATGGCACTAGAGTTAGCGCTAGAAATAGAA	1	bc
AAAAGGGATT	GAAACACCGGTGATAGAGGGGTTAGAGCTGGAAATAGCAAGTTAACCTAA	1	bc
AATTTATTCC	GCAACACCGGTGACAAACGTATGACAGTGGGGTAAGAGTAGAAAAAAGAA	1	bc
AACAACCTCC	GAAACACCGGTGACAAACGTATGTCAGTGGGGTTAGAGCTAGAAATAGCA	1	bc
AATAATGCCT	GAAACACCGGTGCTCTTGAGGTTACAGCTGGAATTGGGCTAGAAACAGCA	1	bc
CGCAAGGACG	GAAACACCGGTCGTAGCTCGCCGGGCGTGGGGTTAGAGCTAGAAATAGCA	1	bc
GGATAATAAA	GAAACACCGGTGCTCTTTGCTAGAGCGTGGGGTTAGAGCTAGAAATAGCA	1	bc
CGGCTAGATA	GAAACACCGGTCTTCGTGGGTAAGACGGGGGGTAAGAGCTAGAAATAGCA	1	bc
TAACCAAATT	GAAACACCGGTCTTACTGGAATCTAACGTGGGGTAGAGCTAGAAATAGCA	1	bc
TTCTTAGCTC	GAAACACCGGTCTTCCTGATGTCTCGGGGGGGGTAGAGCTAGAAATAGCA	1	bc
AAAAAGCAAT	GAAACACCGGTTTACTTAGGTAAAGAGTGGGGTTAGAGCTAGAAATAGCA	1	bc
AAACGATTAT	GAAACACCGGTGATAAACGTATGTCAGTGGGGTTAGAGCTAGAAATAGCA	1	bc
GAGACGAGAG	GAAACACCGGTTATCGTTAAGGATTTTGTGGGGTTAGAGCTAGAAATAGC	1	bc
AGCTAGCACC	GAAACACCGGTGTTCTTTGCTCGATGGTGCGGTTAGAGCTAGAGATAGCA	1	bc
TATTGAGCTT	GAAACACCGGTTGTGCGGAACTCAGTGTGGGAGCAATAGCAAGTTAACCT	1	bc
TAATTAAAAA	GAAACACCGGTGTAATTAGTTAAATAGTGGGGATAGAGAAAGAAATAGAA	1	bc
CGAACCTAAT	GAAACACCGGGTTACTTAGTTAACTAGTGGGGTTAGAGCTAGAAATAGCA	1	bc
GACAACCTCC	GAAACACCGGTAATCTAGCGATCCCCGTGGGGATAGAGCTAGAAATAGCA	1	bc
CGCCGTGTCT	GAAACACCGGTCGTCGTTCGTAGGGCGTGGGGTTAGAGCTAGAAATCTCA	1	bc
TAACCCATAC	GAAACACCGGTTTAGTATGGAGGGATAGAGCTAGAAATCGCAAGATAACT	1	bc
GAATCAAGAA	GAAACACCGGTTATCGTTACGGATTTTGGGGGGTTAGAGCTAGAAATAGC	1	bc
CACTGGGATT	GAAACACCGGTTCTAGCGGCGTCCAGGAGGGGTTAGAGCTAGAAATAGCA	1	bc
GATCCGACAC	GAAACACCGGTTATCGCTACGGATTTTGTGGGGTTAGAGCCAGAAATAGC	1	bc
GTGATATCTC	GAAACACCGGTTGGCTTTACTCCATTAGCTATTAACAGCAAGTCAACCTA	1	bc
TACCTATCCC	GAAACACCGGTGCCAGTGGGGTTACAGCTAGAAAAAGCCAGGTAATCTCA	1	bc
CAATCACACT	GAAACACCGGTTCAACGGGAGTCTTGGACGGGTGAGGGCGAGAGAGCGCG	1	bc
AATCCACATG	GAGACACCGGTGACAAGCGTAGGTTTGTGGGGTTAGAGCTAGAAATAGCA	1	bc
CGCCGTGTAG	GAAACACCGGTCGTCGTTCGTAGGGCGTGGGGTTAGAGCTAGAAATAGCA	1	bc
CATATAGCTT	GAAACACCGGTGCTAGTTGTATGAGAGCGGGGATTGACAAGGTAACCGAA	1	bc
AGATCCACGA	GAAACACCGGTTTAGTATGGAGGGATAGAGCTAGAAATAGAAAGTAAACC	1	bc
GTTTTACATA	GAAACACCGGTGAGCATGATTAGAGCTAGAAATAGCAAGTTAACCTAAGG	1	bc
