AAAAAATCAA	GAAACACCGGTGACAGTGATAGAAACAGCAAATAAAACTAAAGCTAGTGG	1	bc
AGAACTGACG	GAAACACCGGTGCCCTTTATGGGACCGTGGGGTTAGAGCTAGAAATAGCA	1	bc
TCCACAACCA	GAAACACCGGTGGGGTTAAAGTTAGAAATAGCAAGTTAACCTAATGTTAG	1	bc
CCCTGGGATC	GAAACACCGGTTCACGCGGCGACTTGAAGCGGTGGGAGGGATAGAGATAA	1	bc
CAGCGAGTTC	GAAACACCGGCTGGCGTTCGAAGGGCGGGGAGTTAGAGCTAGCCAAAGCA	1	bc
TAATGAGTTC	GAAACACCGTCTCGTGGGGTAGAGCTAGAAATATCAAGTTAACCAAAGGA	1	bc
GCCGCGGTTT	GAAACACCGGTCGTCTTTCGTAGGGCGTGGGGTTAGAGCTAGAAATAGCA	1	bc
AAAAGGGCCA	GAAACACCGGTGATGGGAGACTGGGGGGGTGAGAGCTAGAAAGATAAAGT	1	bc
TATTCTGAAA	GAAACACCGGTGGCAATTCGATCCGAGTGGGGTTAGAGCTAGAAATAGCA	1	bc
AAGACCAGCG	GAAACACCGGTTATCGTTACGGATTTTGTGGGGTTAGAGCTAGAAATAGC	1	bc
AAATTAGCAA	GAAACACCGGTTGGGGGGAACTCGGTGAGGGAGAGATAGCAAGTTAACCG	1	bc
TATACCCCCT	GAAACACCGGTTTTAGAAGCTGAGGGTAGAGGTAGAAGTAGGAAGTTAAC	1	bc
CATTCAAATT	GAAACACCGGTGGCCATTCGATCTGAGTGGGGTTAGAGCTAGAAATAGCA	1	bc
AACATCATGA	GAAACACCGGTTTTGGATCATAGGAAGTGGGGTTAGAGCTAGAAATAGCA	1	bc
TATTGCTCAA	GAAACACCGGTTGCGGGGATCTCGGGGTGGGGGAAGTAGCAAGTTAACCT	1	bc
ACTACTGAAA	GAAACACCGGTGGGGTTAGTGCTAGAGTTGGCTTAGAGCTATAAAGATCA	1	bc
TTAATATAAT	GAAACACCGGTGAGCATGATTAGAGCTAGAAATAGCAAGTTAACCTAAGG	1	bc
CGGAGTGCTG	GAAACACCGGTCGTCGTTCGTAGGGCGTGGGGTTAGAGCTAGAAATAGCA	1	bc
ATTATACCCC	GAAACACCGGTCGCGAAAGCTAGAAATAGCAAGTTAACCTAAGGATAGTC	1	bc
CGAGGGATTG	GAAACACCGGTCGGGGTACGGCGGGCAATAGCATGGAAATAGAAAGCGAA	1	bc
GAGACCGTCC	GAAACACCGGTCCTCTAAGGATCGATGTGGGGGGAGAGATAGAAATAGCA	1	bc
TACACCCTAC	GAAACACCGGTATTCTAAAGATCACCGTGAGAATAGAGCTAGAAATAGCA	1	bc
TAATTGGTCG	GAAACACCGTTCGGTGGTCGAAGGCTGTGATTATCAAGCTAACCTAAGCC	1	bc
AATATGGTAA	GAAACACCGGTTTTCGAGAAAACGTCGTGGGGGTAGTACCAGGATTACCT	1	bc
AAAACCTTTA	GAAACACCGGTTTAGAATAGTAGGGCGAGAAATTGGAGCTAGACCTAACG	1	bc
AGATAGCACA	GAAACACCGGTGTTCTTTACTCGTTGGAGGGGTTAGAGGTAGAAATAGCA	1	bc
TGTAAAGATC	GAAACACCGGTAATCCAGGAATCTAACGTGGGGTAGAGCTAGAAGTAGCA	1	bc
ACCCGCGGCG	GAAACACCGGTGGAATGGATGCAAGGGTGGGGTTAGAGCTAGAAATAGCA	1	bc
TCGTTGCTGC	GAAACACCTTGAGAATAGAGCTAGGAATAGCGAGTTAGCCTGAGGCTGGA	1	bc
AAGTCAACAG	GAAACACCTTGGGGTTAGAGCTAGAAATAGCGAGTTAAGCTAAGGATAGT	1	bc
ACAGCATCAC	GAAACACCGGTGGGAGTAGAGCAAGTAGTAGCAAGATCAACTAAGGCTAG	1	bc
ATCATGCTGA	GAAACACCGGTGTGCGGTCATAGGTCGTGGGAAATAGCAAGGAACTTACG	1	bc
GTGATATCTC	GAAACCCGGTGTGCCTGATTAGATCTAGCTATAGCAAGTTAACCTAAGGC	1	bc
ATATAAACAA	GAAACACCGGTGTGCTATGCTAGTGGGGGTAGAAGTAGAAGTAACATATA	1	bc
GAACGAAGCT	GAAACACCGGTTCTCGCTGCGGCTTTTGTGGGTTTAGAGCTGGGAATAGC	1	bc
CGGACAGCAA	GAAACACCTTGGGGTTAGAGCTAGAATTAGCAAGTTAACCTAAGGCTAGC	1	bc
TCACCACAAC	GAAACACCGGTGGGCTTAGCTCTAGTAATAGCAAGTTACCCTAAATCTCG	1	bc
CAACCCGTTT	GAAACCCCGGGGGGTTCGAGATATAAATAGCAAGTTAACCTAAGCATAGT	1	bc
GATTGGGGCG	GAAACACCGGTTATGGGGACCTCGGTGTGGGAGAAATAGCAAGTTAAACT	1	bc
GATTAGTATG	GAAACACCGGTGGTGGGCAACTAGTTGTGGGGGTAATAGCAAGTTAACCC	1	bc
AGATTCTCCC	GAAACACCGGTCGCGAAAGCTAGAAATAGCAAGTTAACCTAAGGCTAGTC	1	bc
AATTTAACAC	GAAACACCGGTTGTGGTGAACTCGATGTGGGAGAAATAGCAGGTTAACCT	1	bc
ATGATAGTAG	GAAACACCGGTCCTCGAAACTGGGGTAAGAGATAGCAACAGCAAGTTAAC	1	bc
TCCGCCTAAA	GAAACACCGGTGGGGTTAGGGCTCGAATTAGCATGTTACCCTAAGTCTCA	1	bc
GTAACATACT	GAAACACCGGTGAGAATGGTTAGAGTTAGAAATAGCAAGTTAACCTAAGA	1	bc
TGCCAGCAAG	GAAACACCGGTGTTCTTTGCTCGTGGGTGGGGTTAGAGCTAGAAATAGCA	1	bc
GTACTACACA	GAAACACCGGTGAGCAGGAATAGAGCTAGAAATAGCAAGTTAACCTAAGG	1	bc
AGTCATGCAC	GAAACACCGGTGCTCTTTGTGCGAGGGTGGGGTTAGAGCTAGAAATAGCA	1	bc
GACAACCAAA	GAAACACCGGTAATCTAAAGATCCCAGTGGGGATAGAGCTAGAAATAGCA	1	bc
GAAAAAATCC	GAAACACCGGTAATCTAAAGATACCCGTGGGGATAGAGCTAGAAATAGCA	1	bc
AGTTAGCAAA	GAAACACCGGTGGCAATTCGATCTGGGTGGGGTTAGAGCTAGAAATAGCA	1	bc
ACTTGGACCA	GAAACACCGGTTGTGGGGAACACGGTGTGGGAGCAATGGCAAGTTACCCT	1	bc
AAATCGGCAG	GAAACACCGGTTTTAGTAAATGGAGAGTGGGGTTAGAGCTAGAAATAGCA	1	bc
AATTTAGCAC	GAAACACCGGTTGAGGGGATCTCGATGTGGGAGAAAGAGCAAGTTAGCCT	1	bc
ACAGCACAAG	GAAACACCGGTTTTCGTTCATATAGCGTGGGGTTAGAGATCGAAGGCGCA	1	bc
GAAATAGCTA	GAAACACCGGTGAGCATGATTAGAGCTAGAAATAGCAGGTTAACCTAGGG	1	bc
AGGTCAGACA	GAAACACCGTGGGTATAGGGTTAGTTGTAGCATGATAGCTTGAAACAAGA	1	bc
ATCATACAGA	GAAACACCGGTGAGCATGAATAGAGCTAGAAATATCAAGTTAACCCTAGG	1	bc
GCCAAAAGCT	GAAACACCGGTGGTCGCCGTGGAGAGGTGGGGTTAGAGCTAGAAATAGCA	1	bc
GAGCCGAGTG	GAAACACCGGTTATCGTTACGGATTTTGTGGGGTTAGAGCTAGAAATAGC	1	bc
CAAAGCGATG	GAAACACCGTGGGGATAAAGCTAGGAATAGCAGGTTGAGCTAGGAATAGT	1	bc
CATTCAAACG	GGAACACCGGTGGCAATTCGATCTGTGTGGGGTTAGAGCTAGAAATAGCC	1	bc
AAATGGGAAT	GAAACACCGGTTGAGGGGGACAAGTTGTGGGGGTAATAGCAAGTTAAGCT	1	bc
CATACACATC	GAAACACCGGTGGCAATTCGATCTGCTTGGGGTTAGAGCTAGAAATAGCA	1	bc
AAGAGAGTCG	GAAACACCGGTGCTAGAAGCTGAGGATTGAGCTAGAAATAGCAAGTTACC	1	bc
