AAACCCATGA	GAAACACCGGTTTAGTATGGAAGTGGGGTTAGAGCTAGAAATAGCAAGTT	8
AACATGCTAG	GAAACACCGGTTGTAAATGATAGGTCGTGGGGTTAGAGCTAGAAATAGCA	1
AACATGCTAG	GATACACCGGTTTTCGATCATAGGTCGTGGGGTTAGAGCTAGAAATAGCA	1
AAGAACGCCG	GAAACACCGGTGCTATTTACTGCGTTAGATCTAGAGAGCAAGAGATAACA	1
AATTAACACA	GAAACACCGGTGCCAATTCGAGGTGCGTGGGGTTAGAGCTAGAAATAGCA	1
AGACAGCAAC	GAAACACCGGTGTTCTTTGCTCGAGGGTGGGGTTAGAGCTAGAAATAGCA	27
AGACAGCAAC	GAAACACCGGTGGTGTGGGACTGGGGGTGGGGGTAGTAGCAGAAAAACCA	1
ATACCACACT	GAAACACCGGTTGTAAGCGATGGTTTGTGGGGTTAGAGCTAGAAATAGCA	1
ATGCACGAAC	GAAACACCGGTGTTAGTTGCTCGATGGGTGGGGTAGGGGTTGGAATAGCA	1
CAACGAGATT	GAAACACCGGTACTCTAGGTTTCCAAGTGGGGTTAGAGCTAGAAATAGCA	1
CACTTCCCAC	GAAACACCGGTTGGCTATAATAGTTCATCTGTTTATAGCAAGAAATACCA	1
CATTCACAAA	GAAACACCGGTGGCAATTCGATCTGAGTGGGGTTAGAGCTAGAAATAGCA	1
CCGTTAACAC	GAAACACCGGTTGTCTTTACTCCTTTAGCTATAAATAGCAAGTTAACCTA	1
CGTTCATCAA	GAAACACCTTGGGGTTAGAGCTAGAAATAGCAAGTTAACCTAAGGCTAGT	1
GACAACCTCC	GAAACACCGGTAATCTAAAGATCCCCGTTGGGATAGAGCTAGAAATAGCA	1
GACTATGTAA	GAAACACCGGTACTAGTTACTTACGGGTGGGGTTAGAGCTAGAAATAGCA	1
GTAATATATA	GAAACACCGGTGAGCATGATAACGGGTTAGAGCTAGAAATAGCAAGTTGA	1
TAATTAATCC	GAAACACCGGTTGAGATAATCAAAAATTGGAGTAGAGCTATAAATAGCAG	1
TACTTCATCC	GAAACACCGGTAGTATGTACCAACGGAACCTGGTTCGAGTTCGAAATCAC	1
TGACCAGATT	GAAACACCGGTCTTACTGGAATCTAACGTGGGGTAGAGCTAGAAATAGCA	1
