AGCATGCTTT	GAAACACCGGTCTTCGATCATAGGTCGTGGGGTTAGAGCTAGAAATAGCA	1	bc
AAATTAGCAA	GAAACANCGGTTGTGAGGAACTCGGTGTGGGAGGAATAGCAAGTTAACCT	1	bc
AACTTGCAAA	GAAACANCGGTTTTCGTTCATTGGTCGTGGGGTTAGAGCTAGAAATAGCA	1	bc
TTCTTTGTAA	GAAACACCGGTAGCGGATATGTGCGGGTGGGGTTAGAGCTAGAAATAGCA	1	bc
CCCCGTGTAA	GAAACANCGGTAGAATGGACCCACGGGTGGGGTTAGAGCTAGAAATAGCA	1	bc
TGCACATTCA	GAAACANCGGTTCACGTTAGCTCGTAGTGGGTTACAGCTTGGGGTAGAGA	1	bc
ACGACCCTCT	GAAACANCGGTGCTACAAGCTCAGTTTGAGCGGTTAGAGCTAGAAATAGC	1	bc
GAGTCAGATT	GAAACANCGGTTATCGCTACGGCTTTTGTGGGGTTAGAGCTAGAAATAGC	1	bc
GAATTATATG	GAAACANCGGTGAGCATGATAACGTCCGTGGGGTTGGAGCTGGAAATAGC	1	bc
TTCTACGCCA	GAAACANCGGTAGCGGAAATGTGCGGGTGGGGTTAGAGCTAGAAATAGGA	1	bc
AAAACTTCCT	GAAACANCGGTTCCCGTTAGCTCGTAGAGGGATAGAGCTGGGGATAGAGC	1	bc
GAAATATTGA	GAAACANCGGTGAGCATGATAACGTCCGTGGGGTTAGAGCTAGAAATAGC	1	bc
AGTACTTCCC	GAAACANCGGTTCCCGTTAGCTCGTAGAGGGTTAGAGCTTGGGTAAGAGC	1	bc
AAGACAGAAA	GAAACANCGGTGTTCTTTGCTCGAGGGTGGGGTTAGAGCTAGAAGTAGCA	1	bc
AACTGGGCCC	GAAACACCGGTAGTGGGGAACTCGGTGTGGGAGAAATAGCAAGTTAACCT	1	bc
TACTTGCTAC	GAAACACCGGTTTTCGATCATAGCGCGTGGGGTTAGAGCTAGAAATAGCA	1	bc
AAACTGCTGA	GAAACACCGGTCTAGTATGGAAGGGGGGGTAGAGAGAGAAATAGCAAGTT	1	bc
AACTGACCAA	GAAACANCGGTTGTGGGGAACTAGGCGTGGGAAAAAGAATGAAACAAAAG	1	bc
AATCTACTAG	GAAACACCGGTTTTAAATCATAGGCCGTGGGGTTAGAGCTAGAAATAGCA	1	bc
GTATAAGCGG	GAAACACCGGTTTTAGGAAATGGTGAGTGCGGTTTGAGCTGGAAATTGCA	1	bc
GAGTCGGCAA	GAAACANCGGTTATGGCTACGGATGTTGGGGGGTTAGAGCTAGAAATACC	1	bc
GATTTATATA	GAAACACCGGTGACCATTATAACTTATGTGGGGTTAGAGCTAGAAATAGG	1	bc
TAAATCATCT	GAAACANCGGTTGAGTAAAGTAAGAAATAGCAAGTGAACCTAAGACAAGT	1	bc
GACTGCGCCC	GAAACACCGGTTGTCGGGAGCTCCCCGTGGGAGAGATCTCGAGTTAACCT	1	bc
TCAACAATCA	GAAACANCGGTGGGGTTAGCGCTAGTAATAGCAAGTTAACCTATGGCTAG	1	bc
AATACTGCGA	GAAACANCGGTTCCCTTTGTGGGACGTTTTGGTTGGATCTAGCTATAGCA	1	bc
AGCTCTTCAT	GAAACACCGGTTCCCGTTAGCTCGTTGTGGGTTAGAGATGGAGTTAGCGC	1	bc
TTATTCTCGA	GAAACANCGGTTAAGAATATAGGGAGGTTAGATCGGTGATAGACATAAAA	1	bc
GATTCAGCAA	GAAACANCGGTGTTAGTAAATGGTGAGTGGGGTTAGAGCTAGAAATAGCA	1	bc
TCTTGGGCCA	GAAACACCGGTTGTGGGGGACTCGGTGTGGGAGAAATAGCAAGTTAACCT	1	bc
TCACCAAATT	GAAACANCGGTCGGGCTAGAGTTTAACATAGCAAGTTAATCTAAGGCTAG	1	bc
CCGTCACCCC	GAAACANCGGTTCAATCTGCTCCTTTAGCTGGAGATAGCGATAGAACTAG	1	bc
ATACTCCCCT	GAAACANCGGTCGCAAGCGTTTGCTTGTGGGGTTAGAGCTAGAAATAGCA	1	bc
TGGACTACCC	GAAACACCGGTTCCCGTTAGCTCGTAGACGATTAGAGCTAGGTTTAGAGC	1	bc
ATAGAAACAA	GAAACANCGGTGTGGGGAGAGTAAGAGAGAGCAAAAGCAAGTAAGGAAAG	1	bc
TTCACATCGT	GAAACANCGGTGCCCGTTAGCTCGGAGTGGGGTAGAGCTGGGGATAGAGC	1	bc
ACTACAGTCG	GAAACANCGGTGGTGTTAGAGGTAGCGTGGGGATATAGCTAGAAGTCTCA	1	bc
AGGAAGGAAG	GAACCANCGGTGCTAGAAGCTGTGGTTGTGGGGTTAGAGCTAGAAATAGC	1	bc
GAATGAGCAA	GAAACANCGGTTTTGGTGAACTCGGTGTGGGGGTAGTGGCAGAATAAGCT	1	bc
GAATGTGTTT	GAAACANCGGTGCTAGTTAGTTACGGGCGGGGTTAGAGATAGTAATAGCA	1	bc
TCGACAATCC	GAAACANCGGTGGGGTTTGAGGTAGAAACGGCAAGATAACCTAAGGCTAG	1	bc
TATAACGCAT	GAAACACCGGTGTCCTTAATTAGATCGTGGGGTTAGAGCTAGAAATAGCA	1	bc
GTTAGGTAAA	GAAACANCGGTGAGCATGATAACGTCCGTGGGGATAGAGCTAGATATAGC	1	bc
AACTCTGTAC	GAAACANCGGTGCCAAACGCATGTCAGTGGGGTTAGAGCTAGAAATAGCA	1	bc
TACATAATCT	GAAACANCGGTTTCCGTTAGCTCGTAGTGGGGTAGAGCTGGAGTTAGCGC	1	bc
TCTGGGGCAA	GAAACANCGGTTGGGGTAGACCTGGTGTTGGCAAGATAACCTGTTACTCG	1	bc
TCCCCCAACC	GAAACGNCGGTGGGGTTAGAGCTAGAAATAGCAAGTTAACCTAAGGCTAG	1	bc
CCCCAACCGC	GAAACANCGGTAGACTGGGTCCACGCGTGGGAATAGACATAGAACCAACA	1	bc
CCCTAACCCC	GAAACANCGGTGGGATGGAACCACGGGTGAGAATTAAGAAAGAACCTACA	1	bc
CGTTAAAACC	GAAACANCGGTTGGCTTTACTCCTTTAGCTATAAATAGCAAGTTAACCTA	1	bc
TCCGCAACCA	GAAACACCGGTTCGCGTTAGGTTGGAGAGGGCTAGAGCTCGGGTGATAGC	1	bc
CCCAACATCC	GAAACANCGGTCGAATGGATCCAAGAGTGGGGTATATGCTTGAAATTGCA	1	bc
AACTATGCGA	GAAACANCGGTACTAGTTACTTACGGGTGGGGTTAGAGCTAGAAATAGCA	1	bc
AACTATATAC	GAAACANCGATACTAGTTACTAACGGGTGGGGTTAGAGCTAGAAATAGCA	1	bc
GGCTCTGTTT	GAAACANCGGTCCTACTGGCATCTGGCGGGGGTTAGAGCTAGAAATAGCA	1	bc
GCATTACCAC	GAAACANCGGTTTTTGTAAATGGAGAGTGGGGTTAGAGCTAGAAATAGCA	1	bc
CCTCGCCCCA	GAAACACCGGTAGTATGGATCCACGGGTGGGGTTAGAACTAGATTTAGCA	1	bc
AATCTCACAG	GAAACACCGGTTCGAGGGGAGTACTGATGAGGCGTGGGAGGTAGACTTAG	1	bc
CGTACCGACG	GAAACANCGGGCCGAGAAGCTGAGTTTGTGGGGGTAGAGCTAGAAATAGC	1	bc
CGCCTGTCTC	GAAACANCGGTCGTGGTAATGTGGCCGTGGGGTTAGAGCTAGAAATAGCA	1	bc
GAATTATTCA	GAAACANCGGTTGGGATAATCAAAGCTAGAGGTAGCACTTGAACTTGCAG	1	bc
TAAAAAAACT	GAAACANCGGTGCCGTTAGTGCGAGAGAGAGCTTGGTGCTAGAAGTAGCA	1	bc
GCATCAACAG	GAAACANCGGTGGTGGTAAAGCGAGAAATAGCAAGTTAATCTAAGTCTAG	1	bc
CATTCACCCC	GAAACACCGGTGGCAATTCGATCTGAGTGGGGTTAGAGCTAGAAATAGCA	1	bc
AATTAGGAAC	GCAACACCGGTTGTGGGGAACTCGGTGTGGGAAAAATAGCAGGTTCACCA	1	bc
CTATAACCTA	GAAACANCGGTGTGCGGAGATTATGCGTGAGAAATAGCAAGTAACCAAAG	1	bc
AACATCTCCG	GAACCANCGGTTCTCGATCATCGTGCGGGGGGTCAGAGCTCGACCTAGCA	1	bc
AAATAAACCC	GAAACANCGGTTGAGTAGAGCTAGAAGTAGCAAGTTAACCTAAGGCTAGT	1	bc
GTCTCCCCCC	GAAACANCGGTTCAAAAAACGTCTTGGACCGGTGAGGGGGTGAAAGAGCA	1	bc
TACTCCCACT	GAAACACCCGTTTACTTAGTTAACTAGACCGGTTAGAGCTAGAAATAGCA	1	bc
GACTCTTCAA	GAAACANCGGTACCAGTTACTTCCGAGTGGGGTTAGAGCTAGAAATAGCA	1	bc
ATATAACAAA	GAAACANCGGTGGGCGTAGAGCAAGAATTAGCAAGTTAACTTAAGGTAAG	1	bc
TACTCCTCCT	GAAACANCGGTTCCCGTTAGCTCGTAGAGGGGTAGAGCTGGGGGTAGAGC	1	bc
AATTTATTCC	GAAACANCGGTGAAAAACGTAAGAAAGTGGGGTAAAGCTAGGAATAGCCG	1	bc
AAATTCGCTA	GAAACANCAGTGGGGAAAAAGTGAGGGAGGGGAAAGTGATAGAAAAAGAA	1	bc
AGTCCGCACT	GGCACANCGGTCTTCCTGGAACCTAACGTGGGGTATAGCTAGAAATAGCA	1	bc
GACTGAGAAA	GAAACACCGGTCCTAGCGAATTCCGGGTGGGGCTAGAGCTAGAAATAGCA	1	bc
CAACGAGCTT	GAAACACCGGTTCTAGTAAAGGTAGAGCTAGAAATAGCAAGCTAACATAA	1	bc
GGATATGAAA	GAAACACCGGTGCTATTTGCTTAAGGGAGGGGTTAGAGCTAGAAATAGCA	1	bc
TATCTAACCT	GAAACACCGGTGTACGGAGATTATACGTGAGAAATAGCAAGTAATCGAAG	1	bc
AGCCCTTCTT	GAAACANCGGTCCCCGTTAGCTCGGAGAGGGTTAGAGCTGGGGTGATAAC	1	bc
GAGTCAACAC	GAAACANCGGTTATCGTTATGGATTTTGCAGGTTTAGATCTAGAAAGAGC	1	bc
ACAATGCTCG	GAAACANCGGTTTTCGATCATCGGTCGTGGGGTTAGAGCTAGAAATAGCA	1	bc
ATATTCATCT	GAAACANCGGTCCTAGAAGTTGAGATTGTGGGGATAGAGCTAGAAATCGC	1	bc
AAACTCCTCA	GAAACACCGGTTTACGATCATAGGTCGTGGGGTTAGAGCTAGAAATAGCC	1	bc
TTCAACCCAA	GAAACANCGGTTTAGAAAGTTAACTAGTGGGGTTAGAGCTAGAAATAGCA	1	bc
AAACCCGTTG	GAAACANCGGTTTTGGTTGGTGGGGTAGGGATTGACATATCAAGTTAACC	1	bc
GACTAAGACG	GAAACANCGGTTGTAGTAATTGGCGTGTGGGGTTAGAGCTCGAAATAGCA	1	bc
GTCTAAGTTA	GAAACANCGGTACTCGTTACTTACGGGAGAGATTAGACATAGGACTAAGA	1	bc
GAAACAAGAG	GAAACANCGGATAACTTAACGGATTAGGGGGGGTAGAGGCAGAAAAAGGA	1	bc
CAATGAGCAT	GAAACANCGGTTGTGGCGAACTCGGTGTGGGAGAAATAGCAAGTTAACCT	1	bc
AACACCATCA	GAAACANCGGTTTCGTATGGATGGAGTTTAGTGGGGTTAGAGCAAGAAAT	1	bc
TACACTTAAT	GAAACANTGGTTCCCGTTAGCTCGTAGAGGGGTAAAGCTGAGGTTAAAGA	1	bc
AACATGAAAA	GAAACANCGGTTTTCGATCATAGGTAGTGGGGTTAGAAATAGAAATAGCT	1	bc
GATATGGCAA	GAAACANCGGTTGTGGGGAATACGGCGAGGAAGAGCTAGCTAGCTTAACT	1	bc
GACTCCTCCG	GAAACANCGGTTTCAGTAAATGACTTGTGGGGTTAGAGCTAGAAATAGCA	1	bc
TACAACGTCT	GAAACACCGGTAACTGGTAGTTGGTGCTGGGACTAGCGAGAGAAACTAAA	1	bc
