GAATTAAAAA	GAAACACCGGTGCTAATAGTTAGCTCGTGGGGTTAGAGCTAGAAATAGCA	3	bc
GGCAACTACG	GAAACACCGGTGGCAGCCAGCCACTTGTGGGGTTAGAGCTAGAAATAGCA	2	bc
AGACAACATT	GAAACACCGGTCTTCTTTGAACCAAGGTGGGGTAAAGCTTGCAATAACAA	1	bc
AAGTTACCAA	GAAACACCGGTTGGCTTTACTCCTTTGTGGGGTTAGCGCTATAATTAGCA	1	bc
CGGGCTGTCC	GAAACACCTGTCTTGGTTCGAGGGACGTGGGGTTAGAGCAGGAATAGCAA	1	bc
TCGCTCATCA	GAAACACCGGTGAGAACAGAACGTTTTGGGGGTTAGAGCTAGAAATAGCA	1	bc
CGACAATCAC	GAAACACCGGTGAGAACAGCTCGATGTGGGGTTAAGAGCTGGAAATAGCG	1	bc
TATTCACTAT	GAAACACCGGTGGCAATTCGATCTGAGTGGGGTTAGAGCTAGAAATAGCA	1	bc
CCGCGCTCCC	GAAACACCGGTAGTAATTTATACCTAGAGATATTAAGGCAAGCTAAGGCT	1	bc
AAGTTAGCAA	GAAACACCGGTTGGCTTTACTCCTTTGTGGGGTTAATGCTATAAATACCA	1	bc
CGGTGATGGT	GAAACACCGGTCAAACTTTTATAGAAATGGGGTTTATAGCTAGAAATAAC	1	bc
CAACTAGAGC	GAAACACCGGTGCTAGAGGTTTCGCAGTGGAGGTAGAGCCAGAAATAGCA	1	bc
CCTTTACCCC	GAAACACCGGTTGGCTTTACTCCTTTGTGGGGTTAGAGCTATAAATAGCA	1	bc
CCCCCGCGGC	GAAACACCGGTAGAACGTTAGAGCTAGATATTGGAAGTTAACCTAGGGCT	1	bc
CGGATATCAC	GAAACACCGGTTGGCTTCACTCCTTTGTGGGGGTAGAACTATAAATAGCA	1	bc
CCTTCACCCA	GAAACACCGGTGGCAATTCGATCTGAGTGGGGTTAGAGCTAGAAATAGCA	1	bc
TTCCCTCCGC	GAAACACCGGTAGAATGTTAGAGCTAGAATTAGCAACTTAACCTAAGTCT	1	bc
CCAACCCCAC	GAAACACCGGTTTACTTAATTAATTTGTGGGGTTAGAGCTATAAATAGCA	1	bc
GTAAAACAGA	GAAACACCGGTGTGCGGAGATGATGAGTGAGAAATAGCGCGTAACCTACG	1	bc
CGTTGACTCC	GAAACACCGGTCTTAATTCTACCTGAGTGGGGTTAGAGCTAGAAAAACCA	1	bc
TATTGAGAAA	GAAACACCGGTGGTAATTCGATCTGAGTGGGGTTAGAGCTAGAAATAGCA	1	bc
TCATCAACGA	GAAACACCGGTGTGGGGAGATCTAGAAATAGCAAGTTAACCTAAGGCTAG	1	bc
TACGACCGAA	GAAACAACGGTTGTCTCAGTTGAACAGAGGGCTGTGAGGTTAGGACTGTA	1	bc
GAAATAATAA	GAAACACCGGTAACCATATGCAGGTAAAACTGTCAATACAAAGTGGACAG	1	bc
ACAGAACAGA	GAAACACCGGTTTACTTAGTTAACTAGTGGGGTTAGAGCTAGAAATAGCA	1	bc
TCCTCACACA	GAAACACCGGTTGGGTTAGAGCTTGATATAGCAATATAGCTTAAACTTAG	1	bc
TGTAATATCT	GAAACACCGGTTAGCATGATAACGTAGCAAGTTAACCTCAGGCTAGACCG	1	bc
ATTAGCAAAA	GAAACACCGGTGGGGTTAGAGCTAGAAATAGCAATTTAACCTAAGGCTAG	1	bc
GCGTCGCCCT	GAAACACCGGTGTCCGCTGCCAGCCCCATTGTGGGGTTAGAGCTAGAAAT	1	bc
CACCGTCGCT	GAAACACCGGTAGAATGCTAGAGCTAGAAATAGCAAGTTAACCGAAGGAG	1	bc
CAAGGGCCCT	GAAACACCGGTTTCCCAAAAGGAGCTGTGGGGTTAGAGCTAGAAATATCA	1	bc
GATTTATAAA	GAAACACCGGTGGGCATTATAACTGAGCAAGTTTAGCGATAGCTATACCG	1	bc
GAAAACAGCA	GAAACACAGGTAATCTAAAGATCCCCGCGGGGATAGAGCTAGAAATAGCA	1	bc
CCCCCTCGCT	GAAACACCGGTAGAATGCTAGAGCTAGATATAGCAAGTTAACCTAAGGCT	1	bc
TCCGTTACCA	GAAACACCGGTTGGCTTTACTCCTTTGTGGGGTTAGAGCTAGAAATAGCA	1	bc
AGGACCTCAA	GAAACACCGGTGCGAACAGCTCGTTTTGGGGTTAGAGCTAGAAATAGCCA	1	bc
GTGGAGCCTC	GAAACACCGGTTCGAACAGAGCAATCTTGGGTTAGCGCTTGAAATAGCCA	1	bc
TAACTGTTCT	GAAACACCGGTCTATGTGCTCGGAGGTACTGGATTGAGAAGTGGTAGCAA	1	bc
ACGAAAGCCC	GAAACACCGGTGCCCTTTATGCGTCCGTGGGGTTAGAGCTATAAATAGCA	1	bc
GGATTATAAA	GAAACACCGGGGATCATGATAGAGAAAGAAGTTAACCTTAGGCTAAGCCG	1	bc
AGCCTGCTAC	GAAACACCGGTGTTCTTTGCTCGAGTGTGGGGTTAGAGCTAGAAATAGCA	1	bc
TGTACCTCAA	GAAACACCGGTTAGAACGGGGCGTTTTGGGGGTAGAGCTAGAAATAGCAA	1	bc
TATCCAGTTC	GAAACACCGGTTCCTCGAATTACAGCGGGGGAGGGGTAGAAGTAACAAGT	1	bc
CAATCCGACT	GAAACACCGGTACAACCGTCTCACTTGGTCGTGGGGATAGAGAAATAAAT	1	bc
GTGCATTCAC	GAAACACCGGTGAGAACAGAACGTGTTTGGGGTAGAGCTAGTAAAAACAA	1	bc
ACTTCACACC	GAAACACCGGTTCAACCGGCGTCTTTTGTGGGGTTAGAGCTAGAAATAGC	1	bc
CGACCGCACC	GAAACACCGGTTCAACCGGCGTCTTTTGTGGGTTTAAATCTAGAAATACC	1	bc
ATACCACACT	GAAACACCGGGTGTAAGCGATGGTTTGTGGGGTTAGAACTAGAAATAGCA	1	bc
TCACACCTAC	GAAACACCGGTTGTGTGTGGTCGGTGGTGGGGTTAGAGCTAGAAATAGCA	1	bc
CGGGGGTTCC	GAAACACCGGTTGGCTTTACTCCTTTGTGGGGTTAGAGCTATAAATAGCA	1	bc
TTCTCCTCAA	GAAACACCGGTCAGAACAGTGCGCCTTGGGGGTTGAGCTAGGAAATGCCA	1	bc
AATATATCAG	GAAACACCGGTTACAAACCAATGTGAGAGGGCTTAGAATTAGAAGTAACC	1	bc
TGTCGAGGGT	GAAACACCGGTCTTCCTTGAATCTACGTGGGGTAGAGCTAGAAATAGCAA	1	bc
CGGTCTGTAC	GAAACACCGGTCCAAAGGCGTCGGACGTGGGGTTAGAGCTAGAAATAGCA	1	bc
GGCAACTACG	GAAACACCGGTGGCAGCCAGCCACTTGTGGGGTTAGAGTTAGAAATAGCA	1	bc
TAATACATCA	GAAACACCGGTGACAACCGTATGTCAGCGGGGGTAGAGCTAGAAATAGCA	1	bc
ACCTCCCTCC	GAACCACCGGTAATGTTAGAGCTAGAAATAGGAAGGTAACCGAAGGCTAA	1	bc
CGGAGGGCCG	GAAACACCGGTGCTAGAGGGCGAGTTGTGGGGATAGAACCTGAAACTGTA	1	bc
CGTGTTGTTT	GAAACACCGGTTGGCTTTACTCCTTTGTGGGGTTAGAGCTATAAATAGCA	1	bc
AGACCGCCCC	GAAACACCGGTGTTCTTTGCTCGAGGGTGGGGTTAGAGCTAGAAATAGCA	1	bc
CGCTATTCCC	GAAACACCGGTTGGCTTTACTCCTTTGTGGGGTTAGAGCTATAAATAGCA	1	bc
ACAATATCAC	GAAACACCGGTTAGCATGATAACGTTGCGAGTTAACCGATGTCAAGTCCG	1	bc
CCAAGACACA	GAAACACCGGTAGTATGTTAGAGCTAGAGATAGAGAGTTAACCTAAGGAT	1	bc
AAAACAGCCA	GAAACACCGGTTAGTAAATGGTGAGTTGGGTTAGAAGTAGAAGTAGCAAG	1	bc
TCATCATGCC	GAAACACCGGTGAGAAACCTTTCTAAGTGGGGTTAGAGCTAGAAATAGCA	1	bc
TCATACGGGC	GAAACACCGGTAGAAAGTGAAAGCCTCTATAACGACGGCAGTCGGGGTCG	1	bc
ATATCAGCCT	GAAACACCGGTTGTAGGCAATGGTTTGTGGGGTTAGAGCTAGAAATAGCA	1	bc
CACCGACAAT	GAAACACCGGTGTCAAATCCATCTAAGTGGGGTTAGAGCTAGAAATAGCA	1	bc
AAAGTGCTGG	GAAACACCGGTTTTCGTTCATAGGTCGTGGGGTCAGAGCTAGAAATAGCA	1	bc
TCTATCGAGG	GCAACTTCGGTTATATTTGTAAGTGTGTGGGGTTAGAGCTAGAAATAGCA	1	bc
ATACCACACT	GAAACACCGGTTGTAAGCGATGGTTTGTGGGGTTAGAGCTAGAAATAGCA	1	bc
TAGACAGGAA	GAAACACCGGTTTTCTTTGCTCGAGGGTGGGATTAGAGCTAGTAGTAGTA	1	bc
