GCCAAAACAA	GAAACACCGGTTGTCGGGTACAGCTAGAGGTAGCAATTGCACGTTAAGCT	1	bc
GCCATACTCT	GAAACACCGGTTTTCGGTTATAGCTAGAAATGTCAAGTTAACCTAAGGCT	1	bc
CAGGGGGGTT	GAAACACCGGTCGTCGTTCGTAGGGCGTGGGGGTAGAGCTAGAAATAGCA	1	bc
AAGATGGTCG	GAAACACCGGTTTTAGATCATGGGTCGTGGGGATAGAGCTAGAAATAGCA	1	bc
AAACCGGATC	GAAACACCGGTATAGTATGGGGGGGGAGTGGGGGGGGAACAGGAAGAAAA	1	bc
TCGGTCGTCA	GAAACACCGGTGAGAGCAGAACGAATTGAGGTTAGAGCTAGAAATAGCAA	1	bc
GGGTGGGCAG	GAAACACCGGTCGTCGTTCGTAGGGCGTGGGGTTAGAGCTAGGAAAAGCA	1	bc
GGCTACAACA	GAAACACCGGTGGCAGCAAGCAACTTGTGGGGTTAGAGCTAGAAATAGCA	1	bc
GAATACGCCC	GAAACGCCGGTTTTAGAAAATTGTGAGTGGGGTTAGAGCTAGAAATAGCA	1	bc
TTATCGCAAC	GAAACACCGGTGTTCTTTTCTCGAGCGTGGTGTTCTAGCTAGAAATATCA	1	bc
CTGCTTAGCT	GAAACACCGGTTTACGTTACATCGGTGTGGGGTTAGAGCTATAAATAGCA	1	bc
CAAACACATA	GAAACACCGGTGGGCATTCGAACTGAGTGGGGTTAGAGATAGATAGAGCA	1	bc
ACCTAGCAAC	GAAAAACCGGTTCAACCGGCGTCTTTTGTGGGGTTAGAGCTAGAAATAGC	1	bc
TTAAACCAAC	AACGAAACACACCGGTTTTCTTATTTAACTAGTGGGGTTAGAGGTAGAAA	1	bc
GACTTAGGAA	GAAACACCGGTACTAGTTACTTACTGGGTGGTGTAGGGCTAGAAATAGCA	1	bc
ACACAGGGGG	GAAACACCGGTCCTAGAAGCTGAGTTTGTGGGTTTAGATCTAGAAATAAC	1	bc
GAGCGAGGCG	GAAACATCGGTGATCGCTACGGATTTGTGGGGTTAGAGCTAGAAATAGCA	1	bc
CCGCTAACTT	GAAACACCGGTGGGGTTAGAGCTATAAATAGCAAGTTGACCTAAGGCCAG	1	bc
ATCCCCTCCC	GAAACACCGGTCACAAAAGTGTGCCAGTGGGGTTAGAGCTAGAAATAGCA	1	bc
AAGAGTTAAA	GAAACACCGGTGATCATGCTTACGGGGGGGGGTTAGAGCTAGAAATAGCA	1	bc
ATCCCACACT	GAAACACCGGTTGTATGCGTCGGCTTGTGGGGTTAGAGCTAGAAATAGCA	1	bc
TAACTCATCT	GAAACACCGGTTTATGGGGCAGCGAGTACTTGACTAGGGTGAGAGGCAGC	1	bc
CCACCATCCG	GAAACACCGGTGGCAATAGTTGGGTTAGAGCTAGAAATAGCAAGTTAACC	1	bc
CAATTACACT	GAAACACCGGTTGAGTTAGTTAACATGGGGGGGAGAGTTAGATATAGAAA	1	bc
GACGAAGACC	GAAACACCGGTGTTCGTTGCTCGAGGGTGGGGTTAGAGCTAGAAATAGCA	1	bc
GCATCAAGAG	GAAACACCGGTTTTGGTTGCGGATGTGTTAGGGGTTAGACCTAAATCTCC	1	bc
AGGAGCGTTG	GAAACACCGGTCGTCGTTCGTAGGGCGTGGGGTTAGAGCTAGAAATAGCA	1	bc
ACAAAACAAC	GAAACACCGGTGTTCTCTGCTCGAGGGTGGGGTTAGAGCTAGAAATAGCA	1	bc
GATTTAGATT	GAAACTCGGAATAGCAAGTTAACCTAAGGCGATTCCGTTATCAACTTGAA	1	bc
TAACTTGCTA	GAAACACCGGTTTTCGATCATGGGCCGTGGGGTGAGAGCTAGAAATAGCA	1	bc
AATGAAAGTC	GAAACACCGGTCCTCGCAGCTGAGTTTGTGGGTTTAGATCTAGAACTATC	1	bc
CCTTGGGCCA	GAAACACCGGTTGTGGGGAACTCGGTGTGGGAGACATAGCAAGTTAACCT	1	bc
TCTCTACGCC	GAAACACCGGGGCCAGTGTGGTTGCGTCATGTGGGGTTAGAGCTAGAAAT	1	bc
TACAACCACT	GAAACACCGGTTTACTTAGTTAACTAGTGGGGTTAGAGCTAGAAATAGCA	1	bc
ACCCCCTCCC	GAAACACCGGTAACAAACGTCTATCAGTGGGGTTAGAGCTAGAAATAGCA	1	bc
GAGCGAAGCT	GAAACACCGGTTATCGTGACGGCGTAGTGGGGTTAGAGCTAGAAATAGCA	1	bc
CAATCCGCCT	GAAACACCGGTTTTCCTCACTGGTGGGTGGGGTTAGAGCTAGAAATAGCA	1	bc
CCGCCAATCA	GAAACACCGGTGGCAATAGAATGATTGGGGGGGGGATAGAGATAGAGCTA	1	bc
TAACATTCCA	GAAACACCGGTTTTCGATCATAGGTCGTGGCGTTAGAGCTAGAAATAGCA	1	bc
CCCATACCAC	GAAACACCGGTTTTCTTTCCTACTTTGTGGGGTTAGAGCTATAAATAGCA	1	bc
ATGTCGATCA	GAACCACCGGTTTACGTCTCGTCGGCCTGCTGTTATAGCTAGAAAGATCA	1	bc
GCGGGGTGTC	GAAACACCGGTCGTCGTTCGTAGGGCGTGGGGTTAGAGCTAGAAATAGCA	1	bc
AAAATCTGTG	GAAACACCGCTAGATACTTACGGGTGGGGTTAGAGCTAGAGATAGGAAGA	1	bc
CACGAACGAA	GAAACACCGGTCGCGGTAGGATCTAAGTCTGGGTAGATATAGATATAGCA	1	bc
TGGGGGTCGC	GAAGCACCGGTCGTCGTTCGTAGGGCGTGGGGTTAGAGCTAGAAATAGCA	1	bc
GCCGCACGCT	GAAACACCGGGGCGAGTGGGGTTGTGAAATGTGATGTTAAAGCAAGAAAT	1	bc
AGGAAGCACC	GAAACACCGGTATTCTTTGATCGTGGAGGGGGGTAGCGCGAGTAATAGCC	1	bc
CAGCGTGCAG	GAAACACCGGTCGGCGTCCGTAGCGCTTGGGGTGAGAGCTAGAAAGATCA	1	bc
CGGTGGGGCG	GAAACACCGGTCGTCGATCGTTGGGCCTGGGGTTATTGCTAGAAGTAGCA	1	bc
AACTTCTCGC	GAAACACCGGTTGCGAAAATGTGCAGGGGGGGGTAGAGCTAGGAATAGCA	1	bc
AACCGGCTTG	GAAACACCGGTTTTCGTTCGTAGGTCGTGGGGTTAGAGCTAGAAATAGCA	1	bc
TGTCACGATC	GAAACAACACTTCATACGAAAATCCGTTCTTAGTCTGGACTTAGCTTTAG	1	bc
AAACATAAAC	GAAACACCGGTGTTTTTTTCTCGACGATAGCGTTAGAGCTATAAATAGCA	1	bc
TCAACAAACC	GAAACACCGGTGGGGTTAGAGCTAGAAATAGCAAGTTAACCTAAGGCTAG	1	bc
CATATATTCC	GAAACACCGGTCTCGTATCCATGTATGTGGGGTTAGAGCTAGAAATAGCA	1	bc
TAAGCCAGAA	GAAACACCGGTGTGGTTAGAGCTAGAAATAGCAAGTTAACCTAAGGCTAG	1	bc
ACCTTGCGCC	GAAACACCGGTTCAACCTGCGACTTTGGGGGGGTTAGAGCAGGAAATAGC	1	bc
AATATATCAA	GAAACACCGGTGACAATGGTATGTCAGTGGGGTTAGAGCTAGAAATAGCA	1	bc
TCAGCAACCC	GAAACACCGGTGTGGCTAGAGCTAGAAACAGCAAGTTAACCTAAGGCTAG	1	bc
GATAATAGCG	GACGCACCGGTGGTCGGTTTGGGCTAGAAATAGTAAGTTAACCTATGGCT	1	bc
AAACCCTAGG	GAAACACCGGTTTAATCCGGACGGTTATTGGGTTTAGAGTTAGAATTAGC	1	bc
AAACCAACGC	GAAACACCGGTTTAGAATAGTGGGGTTAGAGCTAGAAATAGGAAGTTAAC	1	bc
GCAAACGCCG	GAAACACCGGTTTTAGTAAATGGACGGAGGGGTTAGCGCTAGATATAGAA	1	bc
TGGGGGATTG	GAAACACCGGTCGTCGTTCGTAGAGCGTGGGCTTAGAGCTAGAAATAGCA	1	bc
AACAAAAGCC	GAAACACCGGTGGTCGGTGAGTGCTAGAAATATCAAGTTAACCTAAGGCT	1	bc
CCATCATCCG	GAAACACCGGTGGCAATAGGATGAGGGGAGTGGGGCTAGAGCTAGAAATA	1	bc
CAACTAAAAC	GAAACACCGGTGCTAATAGTTAGCTCGTGGGGTTAGAGCTATAAATAGCA	1	bc
AGCACTGCAC	GAAACACCGGTTCATGAAAAACATACTTAGACGACGGTCCGGGGGGATAG	1	bc
TAACCCTTCA	GAAACACCGGTTATAACCGTATGCCAGTGGGGTGAGAGCTAGAAACAGCA	1	bc
ACGCAGGGTT	GGAACACCGGTCGTCGCTCGAAGGGCGTGGGGTTAGAGCTAGAAATAGCA	1	bc
GCTCCCTCAC	GAAACACCGGTGCAAACCGTATGTCAGTGGGGTTAGAGCTAGCAATAGCT	1	bc
TAATCAAACT	GAAACACCGGTTTAGTTAATTAAAAAGTGGGGTAGAGCCAGAAATAGCAA	1	bc
TTACATGCTA	GAAACACCGGTTTTCGATCATAGGTCGTGGGGGTAGAGCTAGCTATAGCA	1	bc
TTGTACAGGC	GAAAGACCGAGCAAGTTAACCTAAGGATAGTCCTCTATCAAGTTCGAGCC	1	bc
ATGAGAGTCT	GAAACACCGGTCCTAGCAGCTGAGATTGTGGGGTTAGAGCTGGAAATAGC	1	bc
ATTACCGCAG	GAAACACCGGTGCTAGAAGCTGGGTTTGTGGTGATAGATATAGATATACC	1	bc
AAGACAGTAA	ACCGGACGACGCACCGGTGTTCTTTGTTCGAGGGTGGGGTTAGAGCTAGC	1	bc
AAATGAATCA	GAAACACCGGTTGAGGGAATCACGAAGTGGGGGAGAGATCGAGATAGCAT	1	bc
AAACCAAAAA	GAAACACCGGTGGGGTTAGAGCTAGAAATAGCAAGTTAACCTAAGGCTAG	1	bc
GAACCGCATC	GAAACACCGGTGCGCAAGGTAACGTGCGGCGTGTTGGTGCTGCTACTAGT	1	bc
AAAATGCTTT	GAAACACCGGTTTTCGATCATACGTCGTGGGGTTAGAGCTAGAAATAGCA	1	bc
GACAAGCAGG	GAAACACCGGTGGTTGGTCATAGCACGTGGACCTAGGGCTAGTACGAGCT	1	bc
CAGTTAAGTC	GAAACACCGGTTGTCGTTACGGATTTGTGGGGTTAGAGCTATAAATAGCA	1	bc
TGCACATCAA	GAAACACCGGTTAGAATTGAATCGTTTGGGGTGTAAGCTTGAAAAAGCAA	1	bc
GGACAGTTGC	GAAACTACGATGCGTTAGTAAATCGAGGCGTAGTGCGGTCGCGAGTTTAC	1	bc
TCGCGCGTCT	GAAACACCGGTGATGCGTGGGTTAGCGCTAGAATTAGCATAGTAACATAA	1	bc
TCTCCCTATT	GAAACTAGGGTTCGCAAGTTAACCTAAGGCTAGTCCGTTATCAACTTGAA	1	bc
GTCCCAGAGT	GAAACACGCTGTGGCACGTTTGCCTAAGGTTGTTCTTGTTCTAACTCGAA	1	bc
ATCTCACACC	GAAACACCGGTTCAACCGGCTTCTTTTTGGGGGTTAGAGCGAAAAATAGC	1	bc
TAGCCAGGTA	GAAACACCGGTCGTGGTTCGGCTAGAGATGGGATGGTAACCGAAAGCTCG	1	bc
AACAACTAAG	GAAACACCGGTGGCAGCTAGCCGCTTGTGGGGTTAGAGCTAGAAATAGCA	1	bc
CGGCGGTCAG	GAAACACCGGTGTTCGTTCTTGGGGTGTGGGGTTAGAGTTAGAAATAGCA	1	bc
TGCCAAAAAC	GAAACACCGGTTGTCGGTTAAAGCTAGAAATAGCAAGTTAACCGAAGGCT	1	bc
GCGTCACTCG	GAAACACCGGTTATCGTTACGCGTTTGTGGGGTTAGAGCTAGAAATAGCA	1	bc
TTGGCCGAAT	GAAACACCGGTTTACTTAGCTAACTTGTGGGGTTAGAGCTAGAAATAGCA	1	bc
CAACCCATTT	GAAACACCGGTTTTGTCTGTTGGGAAAGTGGGGTTAGAGCTGGAAATACC	1	bc
ACTTTCAGAT	GAAACTCGCAATAGCAAGTTGACCTAAGGCTAGTCCGTTACCAACTTGTA	1	bc
