AAATTATGCC	GAAACACCGGTGCCCTTTATGGGACCGTGGGGTTAGAGCTAGAAATAGCA	1	bc
AGGACATCCG	GAAACACCGGTGCTAGAAGCACGGTTTTGGGGGTTAAACTTAGAATTACC	1	bc
AGGTGTTCAA	GAAACACCGTTAACAGGCGTCTTTTGTGGGGGTAGAGCTAGGAATTGCCA	1	bc
CGTTCAGCTT	GAAACACCGGTGATAATGGAATGTAGTGCTAGATATAGCTAGATAACGTA	1	bc
TCCCCCCACT	GAAACACCGGTTTACTTAGTCAACTCGAGGGGTTAGAGCTAGAAATAGCA	1	bc
GAATAAGCAA	GAAACACCGGTTTTAGTTACTTATGAGTGGGGTTAGAGCTAGAAATAGCA	1	bc
CCAACCCCAT	GAAACACCGGTTTCCTTAGTTAGCTGGTGGGGTTGGAGCTAGAAATAGCA	1	bc
AAGACCGCAA	GAAACACCGGTCCTAGAAGCTGCGTTTGTGGGGATAGAGCTAGATAAAGC	1	bc
CAATCTCACG	GAAACACCGGTGCCCTTTATGGGACCGTGGGGTTAGAGCTAGAAATAGCA	1	bc
TACTCCTTCA	GAAACACCGGTTCCAATTACTGCGTGGTTGGGGTTAGAATTAGAAAATTA	1	bc
AATTCATTAA	GAAACACCGGTACTAAACGTATGTCACTGGTTAGACATACGTGAGGATAG	1	bc
CTTTCGTAAA	GAAACACCGGTTGCAATTCGTTCTGAGTGGGGTTAGAGCTAGAAATAGCA	1	bc
GAACATGCCA	GAAACACCGGTACTAGTTACTTACGGGTGGGGTTAGAGCTAGAAATAGCA	1	bc
GGAAAGCACC	GAAACACCGGTTTCAGTCAGCCGCTTGTGGGGTTAGAGCTAGAAATAGCA	1	bc
AAATAAAAGA	CAAAACACCGGTGCGAAGAGATTGTGCGTGGGATTTGAACTAGAAATAGC	1	bc
TGCGCAAATT	GAAACACCGGTCTTCTCGATGCCGAGTGGTGTTAAAGCTAGAAATAGCTA	1	bc
GGGCAGATTG	GAAACACCGGTCTTCATGGAAGCTAGAGCTAGAAATAGCAAGATAACCAA	1	bc
GAGCGCTGGG	GAAACACCGGTGACACAAGTGTGGATGGATTGGCTGACGTGTGGGGTTAG	1	bc
ATGCTCTTCC	GAAACACCGGTTCCCGTTAGCTCGGGGTTAGAGCTAGAAATAGCAAGCTA	1	bc
GATTCCTTAA	GAAACACCGGTAAGCAATGGATGTTTTTGGGGTTAGAGCTAGAAATAGCA	1	bc
CAGTCGAACC	GAAACACCGGTTATCGCTACGGATTTGTTGGGTTTGAGGCTGAAATAGCA	1	bc
AGTCCGCCTC	GAAACACCGGTTAGCGGGACGGATGTGTGGGGTTTGAGCTAGGAATAGGA	1	bc
TACACGCACC	GAAACACCGGTTCAATCGGCGTCTTTTGTGGGGTTAGTGCGAGAAATAGC	1	bc
CTAATTAATT	GAAACACCGGTTGAGATAATCAAAAAGTGGGGTAGAGCTAGAAATAGCAA	1	bc
TTATCGTTCA	GAAACACCGGTGGGTAGCTGGGTGCCCTACTGACCTAATTGTGGGGTTAG	1	bc
GAAAATGCCT	GAAACACCGGTTTTAGGAAATGGTGTGTGGGGTTAGAGATAGCAATAGCA	1	bc
GAATTGAAGG	GAAACACCGGTGCCAGTAGCTAGCTCGTGGGGTTAGAGCTAGAAATAGCA	1	bc
GACAACTAGC	GAAACACAGGTAGCAGGCAGCCACTTGTGGGGTTAGAGCTAGAAATAGCA	1	bc
TAATGCCCAT	GAAACACCGGTTTTGTTAGTTACCTAGTGGGGGTAGTGGTAGGATAAGCA	1	bc
CCTCCCATGA	GAAACACCGGTTTAGTCTGCTGGACAGTGGGGTTAGAGCTAGAAATAGCA	1	bc
AAAATACCAA	GAAACACCGGTTTTCGAATATAGGGCGTCGGGTTAGCGATAGAAATAGCA	1	bc
TCCTCTACCT	GAAACACCGGTTCCCGGCGCCTGCTGGATAGGTCTAGATATAGCAAGTAA	1	bc
TGAACTTTCA	GAAACACCGGTTTCGTTTGGCGGGAAGTGGGGTTAGTGCTAGTAATAGTA	1	bc
GGTTAATCAC	GAAACACCGGTAAGCAAAGAACGCTTTTGGGGTTAGAGCTAGAAATAGCA	1	bc
GCGAACTCCG	GAAACACCGGTCAGTCAGTCTACTGGGGGGCTATGGTGAGATTAGAGATA	1	bc
TGTAGTTTTT	GAAACACCGGTAGTCGTTCTTATGGCGTGGGGTTAGAGCTAGAAAGAGCA	1	bc
GACAGAGCCC	GAAACACCGGTAATCTAAAGATCCTCGTGGGGATAGAGCTAGAAATAGCA	1	bc
GTACTATAGA	GAAACACCGGTTTAGAATATAAGGAAGTGAGGTAAGAGCTAGAAAGAGCG	1	bc
ATTTTTGAGA	GAAACACCGGTTAGATGCAAGTTAACCTAAGGCTAGTCCTTTATCAACTT	1	bc
GTCAACGTCG	GAAACACCGGTACTAGAAACTGAGGTGTGGGGTTAGAGCTAGAAATAGCA	1	bc
CACTCTCAAG	GAAACACCGGTGCTCTCGGATCATCAGTGGGGTTAGAGCTAGAAATAGCA	1	bc
TCGGCGGGAT	GAAACACCGGTCGTCGTTCGTAGGGCGTGTGGTTAGAGCTAGAAATAGAA	1	bc
GGTAAATAAG	GAAACACCGGTGGCAGCCCGACACTTGTGGGGTTAGAGCTAGAAATAGCA	1	bc
TCACCAGAAT	GAAACACCGGTGTGCTTAGAGCTTGCGATAGCAAGTTCACCTAAGACTAG	1	bc
TCCGCCACCC	GAAACACCGGTGGGGTTAGAGCTAGAAATAGCAAGTTAACCTAAGGCTAG	1	bc
GCCTTCAAAC	GAAACACCGGTTCTAATAGTTAGCTCGTGGGGTTAGAGCTAGAAATAGCA	1	bc
GGCCCAGTCC	GAAACACCGGTGTTGCTGGAATCCAGACCTTGGAATAGCAAGGGAGTTAA	1	bc
CCATTATTCA	GAAACACCGGTACATCGGAAGGTCAAGGGGGGAGAGAGAGAGATATAGAA	1	bc
CTGCAACCGC	GAAACACCGGTTTACGATACGTATATGTCGGGGGAGAGCTAGATATAGCA	1	bc
ACCCTAGCAC	GAAACACCGGTTCAACCGGCGTCTTTTGTGGGGTTAGATCTAGAAATAGC	1	bc
CGCACATCCC	GAAACACCGGTCCCCGTTAGATCGGGGTTAGGTCAAAAAAAAGAATGTCA	1	bc
CCCTTCCAGC	GAAACACCGGTTGCAGCCAGCCACTTGGGGGGGTAGTACAAGTAACAACA	1	bc
ATTTCAGCGA	GAAACATCGGTTTGGGAGAAGGCGCCCTGGGTGGAATAGCGAGTGGATCT	1	bc
TATACACATG	GAAACACCGGTTTAGTATGGAGGGAAGTAGGGTTAGAGCTAGAAATAGCA	1	bc
TTGCACTGCC	GAAACACCGGTTCCCGTTAGCGCGGGGTTAGAGCTAGAAATAGCAAGTTA	1	bc
CGTTTAAAAA	GAAACACCGGTGGCAATTCGATCTGAGTGGGGTTAGAGCTAGAAATAGCA	1	bc
CATCTATTAT	GAAACACCGGTCACAAACGTAGGTCACCGGTTAGACATACGTGTGGTTAT	1	bc
GTGTCACGGG	GAAACACCGGTGAGCGGTACTTATTTGTGGGGATAGAGCAAGAAATTGCG	1	bc
AATCAGGCAC	GAAACACCGGTGTTCTTTGCTTGAGGGTGGGGTTAGAGCTAGAAATAGCA	1	bc
GAACCAACTT	GAAACACCGGTGCTAGGATATGGTGAGCGGGGGGAGAGATAGATATAGCT	1	bc
CTCCGACGCT	GAAACACCGGTAGTATGGGTCCGCGGGTGGGGTTAGAGCTAGAAATAGCA	1	bc
GTCTTTAGAT	GAAACACCGGTTCTAATAGTGAGCTCGTGGGGGTAGAGTTAGAGGTAGCA	1	bc
CGACCATAAA	GGAACACCGGTGAGAACGGAACGTAATTGAGGTTAGAGAAAGAAATCTAA	1	bc
GTCTCACGCG	GAAACACCGGTTCTAGTTACGGAGTGTGGGGTTAGGGCAAGGAATAGCAA	1	bc
TAAGTACATT	GAAACACCGGTTAACTTAGTGCGGTGGGGGGGTAAAGGCAAGAAATACCA	1	bc
TAATGCGCCC	GAAACACCGGTCGTGAAAATGTGGGGTTAGAGCTAGAGATAGAAAGATAA	1	bc
AAAACCTAAC	GAAACACCGGTTACAATAGTTAACTAGTGGGGATAGAGCTAGAAATAGAG	1	bc
GCCTCTGTCA	GAAACACCGGTACTAGTTACTTACGGGTGGGGTTAGAGCTAGAAATAGCA	1	bc
AGTTCATCGT	GAAACACCGGTGAGAACAGAACGTTTTTGGGGTTAGAGCTAGAAACAGCA	1	bc
GCACCCAACA	GAAACACCGGTTAATTTAGTTAACGAGTGGGGCGAGAGCTAGAAATAGCA	1	bc
GACTCCCAAT	GAAACACCGGTTTACGTGGCTTACTGGTGGGGTTAGAGCTAGAAATAGCA	1	bc
TGTTCAGCTA	GAAACACCGGTGTGCGCAGAACGTTTTTGGGGTTAGAGCTGGAATTAGCA	1	bc
AGACAATGTA	GAAACACCGGTACTAGCTTCCTCCGGGCGGGGGTAGATATAGCTATAGCT	1	bc
GTTTTTTTAA	GAAACACCGGTGAGAACAGAACGTTTTTGGGGTTAGAGCTAGAAATAGCA	1	bc
TCCCCCCACA	GAAACACCGGTGGAATGGAACCACGGGAGGGGATAGTGATAGAAATAGCA	1	bc
CGGCGATTTA	GAAACACCGGTCGTCGTTCGAGGGGCGTGGGGTTAGCGCTAGACATAGCA	1	bc
AATGCTTTGT	GAAACACCGGGTACAAACGTATGTCACCGGTTGGTCATACGTGGGATTAG	1	bc
CGGTTTACCC	GAAACACCGGTTGGCGTTACTCCTGTGTTAGGTCAACGAATTGCAACTCA	1	bc
AACCCATGCC	GAAACACCGGTTTAGTATGGTGGGAAGTGGGGTTAGAGCTAGAAATAGCA	1	bc
GGCGACCGCA	GAAACACCGGTCCCGGGAGAGCACAAGGCTGAGGGGTTGGAGCAGGAAAT	1	bc
GGCGATTTCT	GAAACACCGGTTGCAGCGAGCCCCTTGTGGGGTTAGAGCTAGAAATAGCA	1	bc
TACCCCCCAT	GAAACACCGGTTTACTTAGTTAACTAGCGGGGTTAGAGCTAGAAATAGCA	1	bc
TGCCGGGCTG	GAAACACCGGTCGTCGTTCGTAGGGCGTGGGGTTAGAGCTAGAAATTGCA	1	bc
GAAATAATAT	GAAACACCGGTGCCAATAGATTGGTTGAGGGGGTAGAGATAGAAATAGCA	1	bc
TGGTCATCAC	GAAACACCGGTTAGCACAGTACGTTGTTGGGGTAAGAGCTGGAATTAGCG	1	bc
CGTACTTCCA	GAAACACCGGTTCCCGTTAGCTCGGGGTTAGATCTAGAAATAGCAAGTAA	1	bc
TGGCAACTAA	GAAACACCGGTGGCAGCCAGCCACTTGTGGGGTTAGAGCTAGAAATAGCA	1	bc
AACAACGACG	GAAACACCGGTGGCAGCCAGCCACTTGTGGGGTTAGAGCTAGAAATAGCA	1	bc
CAACCCCTGC	GAAACACCGGTTTAGTGTGGCAGGAAGAAGGGTTAGAGCTAGAAATAGCA	1	bc
CAATCCTAAT	GAAACACCGGTTTGCACAGTTCGTTTTTGGGGTTAGAGCTAGAAATAGCA	1	bc
GTATCATCTG	GAAACACCGGTGTTAGGAAATGGTGAGTGGGGTTAGAGCTAGAAATAGAA	1	bc
AGCAAGCCCC	GAAACACCGGTGCTCGTTAGCTCGGGGTTAGGTCTAGAAATAACAAGGCA	1	bc
GTCCACTACT	GAAACACCGGTTTCAGCCAGCCACGTGTGGGGTTAGAGCTAGAAATAGCA	1	bc
TGCTCGCACT	GAAACACCGGTCCTACCGGCGTCCTTTGTGGGGTTAGATCTAGAAAGAAC	1	bc
AAATCATCAA	GAAACACCGGTGACAAACGTATGTCACCGGTTAGACATACGTGGGGTTAG	1	bc
GACACCTACT	GAAACACCGGTTTCCGCAAGCCACTTGTGGGGTTAGAGCTAGAAATAGCA	1	bc
ATTATCCATC	GAAACACCGGTGAGAAGCGTATGCCACCGGTTAGACATTGGTGGGGTTGG	1	bc
TTGTAGACAC	GAAACACCGGTTGTCTTTATTCCTTTGTGGGGTTAGAGCTATAAATAGCA	1	bc
AAATCATCGG	GAAACACCGGTTTTAGTAAATGGTGCGTGGGGTTAAAGCTAGAAATAGCA	1	bc
TAAGCCAAAC	GAAACACCGGTGGACTTAGTTATCTAGAGAGGCTAGAGTTAGAAATAGCA	1	bc
GCCGACGATG	GAAACACCGGTGACACCTGGCTAGTTGTGGGGTTAGAGCTAGAAATAGCA	1	bc
GGGCCGGATA	GAAACACCGGTCGTCGTTCGGAGGGGGGGGGTGGAGATAGAGAAAGAGCA	1	bc
ATACACACGA	GAAACACCGGTTTAGTATGTAGGTGCGTGGGAATTGAGCTGGAAGTAACA	1	bc
GCCACCACCC	GAAACACCGGTGGCAGCCAGCCACTTGTGGGGTTAGAGCTAGAAATAGCA	1	bc
GGATCATAAA	GAAACACCGGTGAGAACAGAACGTTTTTGGGGTTAGAGCTAGAAATAGAA	1	bc
GAGCGGGATG	GAAACACCGGTCGTCGTTCGTAGGGCGTGGGGTTAGAGCTAGAAATAGCA	1	bc
TCCCCCCCAC	GAAACACCGGTTCAACCGGCGGCTTTTGGGGGGTTAGAGTTAGAAATAGC	1	bc
TTGCTCAGAT	GAAACACCGGTCTTCCTGGAATCTAGAGCTAGAAATAGCAAGGGAACCAA	1	bc
AAATCGCGCG	GAAACACCGGTTATCGTTGCGGGTTTGTGGGGTTAGAGCTAGAAATAGCA	1	bc
TGCCCTGAGT	GAAACACCGGTCGTCCTGGAAGCTCGCGTTAGGAATGGTAAGAGAACCAA	1	bc
AATTGCGCCC	GAAACACCGGTTGTCTGGAACTCGGCGTGGGAGTAATACCAAGTTAACCT	1	bc
